State/Area,Year,Month,Total Civilian Labor Force in State/Area,Percent (%) of State/Area's Population,Total Employment in State/Area,Percent (%) of Labor Force Employed in State/Area,Total Unemployment in State/Area,Percent (%) of Labor Force Unemployed in State/Area
Alabama,1976,1,1484555,57.0,1386023,53.2,98532,6.6
Alaska,1976,1,160183,69.0,148820,64.1,11363,7.1
Arizona,1976,1,964120,59.5,865871,53.4,98249,10.2
Arkansas,1976,1,889044,57.9,824395,53.7,64649,7.3
California,1976,1,9774280,62.6,8875685,56.8,898595,9.2
Los Angeles County,1976,1,3381856,64.1,3081806,58.4,300050,8.9
Colorado,1976,1,1230966,67.2,1160104,63.3,70862,5.8
Connecticut,1976,1,1442847,64.2,1301974,57.9,140873,9.8
Delaware,1976,1,261418,62.7,240543,57.7,20875,8.0
District of Columbia,1976,1,334691,64.4,305677,58.8,29014,8.7
Florida,1976,1,3584876,55.8,3238460,50.4,346416,9.7
Georgia,1976,1,2244770,63.7,2056467,58.4,188303,8.4
Hawaii,1976,1,407457,69.9,367586,63.1,39871,9.8
Idaho,1976,1,365606,63.0,345182,59.5,20424,5.6
Illinois,1976,1,5123609,63.0,4786415,58.9,337194,6.6
Indiana,1976,1,2425346,64.0,2265849,59.8,159497,6.6
Iowa,1976,1,1329798,64.4,1272281,61.6,57517,4.3
Kansas,1976,1,1065059,65.1,1020396,62.4,44663,4.2
Kentucky,1976,1,1486550,60.5,1402625,57.0,83925,5.6
Louisiana,1976,1,1517348,56.8,1421440,53.2,95908,6.3
Maine,1976,1,474371,62.1,433260,56.7,41111,8.7
Maryland,1976,1,1899337,64.3,1777055,60.2,122282,6.4
Massachusetts,1976,1,2717096,64.8,2432377,58.0,284719,10.5
Michigan,1976,1,3952851,61.6,3562759,55.5,390092,9.9
Minnesota,1976,1,1829382,65.6,1719817,61.7,109565,6.0
Mississippi,1976,1,963611,58.8,899280,54.8,64331,6.7
Missouri,1976,1,2094063,60.5,1969511,56.9,124552,5.9
Montana,1976,1,332790,62.7,313402,59.0,19388,5.8
Nebraska,1976,1,711096,64.9,687431,62.8,23665,3.3
Nevada,1976,1,321579,71.3,291933,64.7,29646,9.2
New Hampshire,1976,1,390934,65.9,365509,61.6,25425,6.5
New Jersey,1976,1,3294120,61.5,2954259,55.1,339861,10.3
New Mexico,1976,1,481330,60.8,439744,55.5,41586,8.6
New York,1976,1,7658970,58.0,6872159,52.1,786811,10.3
New York city,1976,1,3066605,53.9,2723016,47.8,343589,11.2
North Carolina,1976,1,2590713,66.5,2424106,62.2,166607,6.4
North Dakota,1976,1,276793,62.6,267268,60.5,9525,3.4
Ohio,1976,1,4754858,61.7,4368782,56.7,386076,8.1
Oklahoma,1976,1,1186198,59.3,1116824,55.9,69374,5.8
Oregon,1976,1,1078645,62.9,976450,56.9,102195,9.5
Pennsylvania,1976,1,5122733,58.4,4710510,53.7,412223,8.0
Rhode Island,1976,1,440979,63.8,406706,58.9,34273,7.8
South Carolina,1976,1,1295867,65.3,1200437,60.5,95430,7.4
South Dakota,1976,1,308031,64.6,297972,62.5,10059,3.3
Tennessee,1976,1,1834194,59.6,1723616,56.0,110578,6.0
Texas,1976,1,5623303,63.8,5294695,60.0,328608,5.8
Utah,1976,1,517325,62.8,487063,59.1,30262,5.8
Vermont,1976,1,215575,63.6,196968,58.1,18607,8.6
Virginia,1976,1,2330159,65.9,2187531,61.9,142628,6.1
Washington,1976,1,1583070,60.9,1448543,55.8,134527,8.5
West Virginia,1976,1,710144,52.5,657179,48.6,52965,7.5
Wisconsin,1976,1,2128893,65.6,2005997,61.8,122896,5.8
Wyoming,1976,1,176214,65.3,169014,62.6,7200,4.1
Alabama,1976,2,1483950,56.9,1385675,53.1,98275,6.6
Alaska,1976,2,160022,68.4,148718,63.6,11304,7.1
Arizona,1976,2,963394,59.2,865215,53.2,98179,10.2
Arkansas,1976,2,888771,57.8,824008,53.6,64763,7.3
California,1976,2,9768885,62.4,8871553,56.7,897332,9.2
Los Angeles County,1976,2,3381218,64.0,3081497,58.3,299721,8.9
Colorado,1976,2,1230680,67.0,1160001,63.1,70679,5.7
Connecticut,1976,2,1442118,64.1,1301107,57.8,141011,9.8
Delaware,1976,2,261325,62.5,240545,57.5,20780,8.0
District of Columbia,1976,2,334767,64.5,305759,58.9,29008,8.7
Florida,1976,2,3583970,55.7,3237372,50.3,346598,9.7
Georgia,1976,2,2243779,63.6,2055366,58.3,188413,8.4
Hawaii,1976,2,407385,69.6,367403,62.8,39982,9.8
Idaho,1976,2,365295,62.8,344916,59.3,20379,5.6
Illinois,1976,2,5122237,63.0,4785460,58.8,336777,6.6
Indiana,1976,2,2424387,63.9,2264552,59.7,159835,6.6
Iowa,1976,2,1329511,64.3,1271866,61.5,57645,4.3
Kansas,1976,2,1064471,65.0,1019842,62.3,44629,4.2
Kentucky,1976,2,1486110,60.3,1402206,56.9,83904,5.6
Louisiana,1976,2,1516595,56.6,1421064,53.1,95531,6.3
Maine,1976,2,474272,61.9,433173,56.6,41099,8.7
Maryland,1976,2,1898511,64.2,1776509,60.1,122002,6.4
Massachusetts,1976,2,2716261,64.7,2431016,57.9,285245,10.5
Michigan,1976,2,3951549,61.5,3560591,55.4,390958,9.9
Minnesota,1976,2,1828517,65.5,1719004,61.5,109513,6.0
Mississippi,1976,2,963333,58.6,899114,54.7,64219,6.7
Missouri,1976,2,2092849,60.3,1968522,56.7,124327,5.9
Montana,1976,2,332686,62.5,313365,58.9,19321,5.8
Nebraska,1976,2,710770,64.9,687121,62.7,23649,3.3
Nevada,1976,2,321323,70.8,291651,64.2,29672,9.2
New Hampshire,1976,2,390586,65.6,365177,61.4,25409,6.5
New Jersey,1976,2,3293155,61.4,2953668,55.1,339487,10.3
New Mexico,1976,2,481103,60.5,439486,55.3,41617,8.7
New York,1976,2,7656709,58.0,6871169,52.0,785540,10.3
New York city,1976,2,3065430,53.9,2722421,47.8,343009,11.2
North Carolina,1976,2,2589914,66.3,2422974,62.0,166940,6.4
North Dakota,1976,2,276615,62.4,267143,60.3,9472,3.4
Ohio,1976,2,4754964,61.7,4368157,56.7,386807,8.1
Oklahoma,1976,2,1185846,59.2,1116531,55.7,69315,5.8
Oregon,1976,2,1077762,62.7,975742,56.7,102020,9.5
Pennsylvania,1976,2,5122163,58.3,4709350,53.6,412813,8.1
Rhode Island,1976,2,440950,63.7,406719,58.8,34231,7.8
South Carolina,1976,2,1295652,65.2,1200235,60.4,95417,7.4
South Dakota,1976,2,307916,64.4,297878,62.3,10038,3.3
Tennessee,1976,2,1832969,59.4,1722558,55.9,110411,6.0
Texas,1976,2,5619825,63.5,5291252,59.8,328573,5.8
Utah,1976,2,516978,62.6,486695,58.9,30283,5.9
Vermont,1976,2,215467,63.4,196846,57.9,18621,8.6
Virginia,1976,2,2329603,65.8,2187080,61.7,142523,6.1
Washington,1976,2,1581641,60.7,1447552,55.6,134089,8.5
West Virginia,1976,2,710252,52.4,657268,48.5,52984,7.5
Wisconsin,1976,2,2128026,65.5,2005096,61.7,122930,5.8
Wyoming,1976,2,176014,64.9,168813,62.3,7201,4.1
Alabama,1976,3,1484241,56.8,1386793,53.0,97448,6.6
Alaska,1976,3,160124,67.8,148935,63.1,11189,7.0
Arizona,1976,3,963556,59.1,865905,53.1,97651,10.1
Arkansas,1976,3,888557,57.7,823855,53.5,64702,7.3
California,1976,3,9768531,62.2,8875700,56.6,892831,9.1
Los Angeles County,1976,3,3381679,63.9,3083346,58.3,298333,8.8
Colorado,1976,3,1229907,66.8,1159916,63.0,69991,5.7
Connecticut,1976,3,1442585,64.0,1301919,57.8,140666,9.8
Delaware,1976,3,261306,62.5,240523,57.5,20783,8.0
District of Columbia,1976,3,334769,64.5,305939,58.9,28830,8.6
Florida,1976,3,3583894,55.5,3238803,50.2,345091,9.6
Georgia,1976,3,2244320,63.5,2056476,58.2,187844,8.4
Hawaii,1976,3,407576,69.6,367608,62.7,39968,9.8
Idaho,1976,3,365320,62.7,344962,59.2,20358,5.6
Illinois,1976,3,5123914,62.9,4787596,58.8,336318,6.6
Indiana,1976,3,2424005,63.8,2265615,59.7,158390,6.5
Iowa,1976,3,1329559,64.2,1272124,61.4,57435,4.3
Kansas,1976,3,1064641,64.9,1020044,62.2,44597,4.2
Kentucky,1976,3,1486259,60.2,1402586,56.8,83673,5.6
Louisiana,1976,3,1516489,56.5,1420882,52.9,95607,6.3
Maine,1976,3,474440,61.9,433462,56.5,40978,8.6
Maryland,1976,3,1898022,64.1,1776482,60.0,121540,6.4
Massachusetts,1976,3,2715115,64.6,2430783,57.9,284332,10.5
Michigan,1976,3,3953694,61.5,3562811,55.4,390883,9.9
Minnesota,1976,3,1828605,65.4,1720108,61.5,108497,5.9
Mississippi,1976,3,963510,58.5,900093,54.7,63417,6.6
Missouri,1976,3,2093314,60.3,1969025,56.7,124289,5.9
Montana,1976,3,332560,62.4,313352,58.8,19208,5.8
Nebraska,1976,3,710627,64.8,687236,62.6,23391,3.3
Nevada,1976,3,321400,70.5,291820,64.0,29580,9.2
New Hampshire,1976,3,390816,65.6,365391,61.3,25425,6.5
New Jersey,1976,3,3294615,61.4,2955302,55.1,339313,10.3
New Mexico,1976,3,481308,60.3,439624,55.1,41684,8.7
New York,1976,3,7657019,58.0,6874360,52.1,782659,10.2
New York city,1976,3,3064867,53.9,2722931,47.9,341936,11.2
North Carolina,1976,3,2591051,66.2,2424774,62.0,166277,6.4
North Dakota,1976,3,276633,62.3,267177,60.2,9456,3.4
Ohio,1976,3,4755734,61.7,4369756,56.7,385978,8.1
Oklahoma,1976,3,1185640,59.1,1116631,55.6,69009,5.8
Oregon,1976,3,1076843,62.5,975675,56.6,101168,9.4
Pennsylvania,1976,3,5123224,58.3,4708719,53.6,414505,8.1
Rhode Island,1976,3,441054,63.6,406950,58.7,34104,7.7
South Carolina,1976,3,1295432,65.0,1200705,60.3,94727,7.3
South Dakota,1976,3,307864,64.4,297968,62.3,9896,3.2
Tennessee,1976,3,1832485,59.3,1722558,55.7,109927,6.0
Texas,1976,3,5623418,63.4,5293477,59.7,329941,5.9
Utah,1976,3,517186,62.5,486955,58.8,30231,5.8
Vermont,1976,3,215624,63.2,196979,57.8,18645,8.6
Virginia,1976,3,2329408,65.6,2187833,61.6,141575,6.1
Washington,1976,3,1581050,60.6,1447484,55.4,133566,8.4
West Virginia,1976,3,710795,52.3,657702,48.4,53093,7.5
Wisconsin,1976,3,2127839,65.4,2005801,61.7,122038,5.7
Wyoming,1976,3,176105,64.7,168932,62.1,7173,4.1
Alabama,1976,4,1487233,56.8,1390787,53.1,96446,6.5
Alaska,1976,4,161033,67.9,149867,63.2,11166,6.9
Arizona,1976,4,966567,59.1,870141,53.2,96426,10.0
Arkansas,1976,4,888945,57.7,825015,53.5,63930,7.2
California,1976,4,9789023,62.2,8902662,56.6,886361,9.1
Los Angeles County,1976,4,3385126,63.8,3089190,58.3,295936,8.7
Colorado,1976,4,1229301,66.6,1160052,62.8,69249,5.6
Connecticut,1976,4,1446319,64.1,1307272,58.0,139047,9.6
Delaware,1976,4,261570,62.4,240379,57.4,21191,8.1
District of Columbia,1976,4,334217,64.5,305824,59.0,28393,8.5
Florida,1976,4,3586526,55.5,3246473,50.2,340053,9.5
Georgia,1976,4,2249492,63.5,2063590,58.3,185902,8.3
Hawaii,1976,4,408192,69.4,368776,62.7,39416,9.7
Idaho,1976,4,366582,62.7,346124,59.2,20458,5.6
Illinois,1976,4,5131695,62.9,4795335,58.8,336360,6.6
Indiana,1976,4,2426376,63.8,2273481,59.8,152895,6.3
Iowa,1976,4,1330950,64.1,1274556,61.4,56394,4.2
Kansas,1976,4,1067139,65.0,1022562,62.3,44577,4.2
Kentucky,1976,4,1488051,60.1,1404930,56.8,83121,5.6
Louisiana,1976,4,1519054,56.4,1422019,52.8,97035,6.4
Maine,1976,4,475164,61.8,434471,56.5,40693,8.6
Maryland,1976,4,1900112,64.1,1778204,60.0,121908,6.4
Massachusetts,1976,4,2715481,64.6,2436049,57.9,279432,10.3
Michigan,1976,4,3963423,61.6,3576236,55.6,387187,9.8
Minnesota,1976,4,1832231,65.4,1726077,61.6,106154,5.8
Mississippi,1976,4,964902,58.5,903082,54.7,61820,6.4
Missouri,1976,4,2099444,60.4,1973947,56.8,125497,6.0
Montana,1976,4,332503,62.3,313343,58.7,19160,5.8
Nebraska,1976,4,711432,64.8,688636,62.7,22796,3.2
Nevada,1976,4,322625,70.4,293430,64.1,29195,9.0
New Hampshire,1976,4,392772,65.7,367257,61.4,25515,6.5
New Jersey,1976,4,3301383,61.5,2961197,55.1,340186,10.3
New Mexico,1976,4,482739,60.3,441037,55.1,41702,8.6
New York,1976,4,7664202,58.0,6884805,52.1,779397,10.2
New York city,1976,4,3067313,53.9,2726299,47.9,341014,11.1
North Carolina,1976,4,2595746,66.2,2432742,62.1,163004,6.3
North Dakota,1976,4,277360,62.5,267713,60.3,9647,3.5
Ohio,1976,4,4755492,61.6,4375662,56.7,379830,8.0
Oklahoma,1976,4,1186430,59.0,1118154,55.6,68276,5.8
Oregon,1976,4,1078204,62.4,978506,56.6,99698,9.2
Pennsylvania,1976,4,5126833,58.3,4710603,53.6,416230,8.1
Rhode Island,1976,4,441240,63.7,407314,58.8,33926,7.7
South Carolina,1976,4,1295324,64.9,1202589,60.2,92735,7.2
South Dakota,1976,4,308191,64.3,298513,62.3,9678,3.1
Tennessee,1976,4,1835764,59.3,1726382,55.7,109382,6.0
Texas,1976,4,5646313,63.5,5312877,59.7,333436,5.9
Utah,1976,4,519054,62.5,489107,58.9,29947,5.8
Vermont,1976,4,216413,63.5,197785,58.0,18628,8.6
Virginia,1976,4,2330733,65.5,2191295,61.6,139438,6.0
Washington,1976,4,1585515,60.6,1451387,55.5,134128,8.5
West Virginia,1976,4,711428,52.3,658257,48.4,53171,7.5
Wisconsin,1976,4,2130436,65.4,2011006,61.8,119430,5.6
Wyoming,1976,4,177119,64.9,170037,62.3,7082,4.0
Alabama,1976,5,1491392,56.8,1395320,53.1,96072,6.4
Alaska,1976,5,162338,67.9,151056,63.2,11282,6.9
Arizona,1976,5,971080,59.1,875687,53.3,95393,9.8
Arkansas,1976,5,889913,57.7,827062,53.6,62851,7.1
California,1976,5,9821255,62.3,8938559,56.7,882696,9.0
Los Angeles County,1976,5,3389808,63.8,3095552,58.3,294256,8.7
Colorado,1976,5,1229470,66.5,1160471,62.7,68999,5.6
Connecticut,1976,5,1451616,64.3,1314537,58.2,137079,9.4
Delaware,1976,5,262016,62.4,240214,57.2,21802,8.3
District of Columbia,1976,5,333396,64.4,305434,59.0,27962,8.4
Florida,1976,5,3591097,55.4,3256638,50.2,334459,9.3
Georgia,1976,5,2256660,63.6,2073036,58.4,183624,8.1
Hawaii,1976,5,408933,69.3,370291,62.8,38642,9.4
Idaho,1976,5,368506,62.8,347899,59.3,20607,5.6
Illinois,1976,5,5141790,63.0,4804374,58.8,337416,6.6
Indiana,1976,5,2431160,63.9,2284630,60.0,146530,6.0
Iowa,1976,5,1332994,64.1,1277930,61.5,55064,4.1
Kansas,1976,5,1070872,65.1,1026320,62.4,44552,4.2
Kentucky,1976,5,1490599,60.1,1408137,56.8,82462,5.5
Louisiana,1976,5,1523344,56.4,1424086,52.8,99258,6.5
Maine,1976,5,476012,61.7,435612,56.5,40400,8.5
Maryland,1976,5,1904080,64.1,1781196,60.0,122884,6.5
Massachusetts,1976,5,2718111,64.6,2444886,58.1,273225,10.1
Michigan,1976,5,3975642,61.7,3594264,55.8,381378,9.6
Minnesota,1976,5,1837908,65.5,1733886,61.8,104022,5.7
Mississippi,1976,5,966754,58.5,906282,54.8,60472,6.3
Missouri,1976,5,2108332,60.6,1981037,56.9,127295,6.0
Montana,1976,5,332602,62.2,313383,58.6,19219,5.8
Nebraska,1976,5,712943,64.8,690704,62.8,22239,3.1
Nevada,1976,5,324425,70.5,295681,64.3,28744,8.9
New Hampshire,1976,5,395493,66.0,369866,61.7,25627,6.5
New Jersey,1976,5,3309870,61.6,2968185,55.2,341685,10.3
New Mexico,1976,5,484676,60.3,443026,55.1,41650,8.6
New York,1976,5,7675792,58.1,6896958,52.2,778834,10.1
New York city,1976,5,3071973,54.0,2730681,48.0,341292,11.1
North Carolina,1976,5,2601868,66.3,2442874,62.2,158994,6.1
North Dakota,1976,5,278481,62.6,268524,60.3,9957,3.6
Ohio,1976,5,4754562,61.6,4382938,56.8,371624,7.8
Oklahoma,1976,5,1187895,59.0,1120284,55.6,67611,5.7
Oregon,1976,5,1081658,62.5,983065,56.8,98593,9.1
Pennsylvania,1976,5,5130966,58.3,4715133,53.6,415833,8.1
Rhode Island,1976,5,441388,63.6,407576,58.7,33812,7.7
South Carolina,1976,5,1295580,64.7,1204846,60.2,90734,7.0
South Dakota,1976,5,308798,64.3,299264,62.3,9534,3.1
Tennessee,1976,5,1841933,59.4,1732735,55.8,109198,5.9
Texas,1976,5,5676963,63.6,5339976,59.9,336987,5.9
Utah,1976,5,521698,62.6,492102,59.1,29596,5.7
Vermont,1976,5,217411,63.6,198845,58.1,18566,8.5
Virginia,1976,5,2333352,65.4,2195739,61.6,137613,5.9
Washington,1976,5,1593274,60.7,1457626,55.6,135648,8.5
West Virginia,1976,5,711509,52.2,658512,48.3,52997,7.4
Wisconsin,1976,5,2134954,65.5,2018302,61.9,116652,5.5
Wyoming,1976,5,178560,65.2,171583,62.6,6977,3.9
Alabama,1976,6,1496160,56.9,1399430,53.2,96730,6.5
Alaska,1976,6,163908,68.3,152324,63.5,11584,7.1
Arizona,1976,6,976461,59.3,881602,53.5,94859,9.7
Arkansas,1976,6,891434,57.7,829833,53.7,61601,6.9
California,1976,6,9861887,62.4,8977255,56.8,884632,9.0
Los Angeles County,1976,6,3394977,63.8,3100801,58.3,294176,8.7
Colorado,1976,6,1231223,66.4,1161704,62.6,69519,5.6
Connecticut,1976,6,1457006,64.5,1322011,58.5,134995,9.3
Delaware,1976,6,262640,62.5,240155,57.2,22485,8.6
District of Columbia,1976,6,332440,64.3,304715,58.9,27725,8.3
Florida,1976,6,3597210,55.4,3267451,50.3,329759,9.2
Georgia,1976,6,2265027,63.7,2083290,58.6,181737,8.0
Hawaii,1976,6,409662,69.3,371836,62.9,37826,9.2
Idaho,1976,6,370833,63.1,350070,59.5,20763,5.6
Illinois,1976,6,5151113,63.0,4812220,58.9,338893,6.6
Indiana,1976,6,2438240,64.0,2296745,60.3,141495,5.8
Iowa,1976,6,1335252,64.2,1281456,61.6,53796,4.0
Kansas,1976,6,1075261,65.3,1030858,62.6,44403,4.1
Kentucky,1976,6,1493134,60.1,1411443,56.8,81691,5.5
Louisiana,1976,6,1528892,56.5,1427096,52.8,101796,6.7
Maine,1976,6,476725,61.8,436500,56.5,40225,8.4
Maryland,1976,6,1909635,64.2,1785402,60.0,124233,6.5
Massachusetts,1976,6,2723768,64.7,2456971,58.4,266797,9.8
Michigan,1976,6,3987683,61.8,3613034,56.0,374649,9.4
Minnesota,1976,6,1845509,65.7,1742473,62.0,103036,5.6
Mississippi,1976,6,968797,58.5,908939,54.9,59858,6.2
Missouri,1976,6,2118778,60.8,1989320,57.1,129458,6.1
Montana,1976,6,333040,62.1,313675,58.5,19365,5.8
Nebraska,1976,6,715081,64.9,693197,63.0,21884,3.1
Nevada,1976,6,326591,70.7,298204,64.5,28387,8.7
New Hampshire,1976,6,398473,66.3,372765,62.0,25708,6.5
New Jersey,1976,6,3318612,61.7,2975187,55.3,343425,10.3
New Mexico,1976,6,487022,60.3,445278,55.2,41744,8.6
New York,1976,6,7688483,58.1,6907840,52.2,780643,10.2
New York city,1976,6,3077212,54.1,2735049,48.1,342163,11.1
North Carolina,1976,6,2608026,66.3,2452391,62.4,155635,6.0
North Dakota,1976,6,279841,62.7,269504,60.4,10337,3.7
Ohio,1976,6,4753211,61.5,4389731,56.8,363480,7.6
Oklahoma,1976,6,1189831,58.9,1122849,55.6,66982,5.6
Oregon,1976,6,1087580,62.6,989181,57.0,98399,9.0
Pennsylvania,1976,6,5135162,58.3,4722519,53.6,412643,8.0
Rhode Island,1976,6,441442,63.5,407522,58.6,33920,7.7
South Carolina,1976,6,1296350,64.7,1207151,60.2,89199,6.9
South Dakota,1976,6,309715,64.5,300120,62.5,9595,3.1
Tennessee,1976,6,1850737,59.5,1740968,56.0,109769,5.9
Texas,1976,6,5708574,63.8,5369891,60.0,338683,5.9
Utah,1976,6,524656,62.8,495414,59.3,29242,5.6
Vermont,1976,6,218340,63.8,199914,58.5,18426,8.4
Virginia,1976,6,2337293,65.4,2200717,61.6,136576,5.8
Washington,1976,6,1604380,61.0,1466236,55.8,138144,8.6
West Virginia,1976,6,710644,52.0,658327,48.2,52317,7.4
Wisconsin,1976,6,2141170,65.6,2026605,62.1,114565,5.4
Wyoming,1976,6,180143,65.5,173267,63.0,6876,3.8
Alabama,1976,7,1500730,56.9,1402364,53.2,98366,6.6
Alaska,1976,7,165368,68.3,153282,63.3,12086,7.3
Arizona,1976,7,981975,59.4,887162,53.7,94813,9.7
Arkansas,1976,7,893053,57.8,832622,53.9,60431,6.8
California,1976,7,9903604,62.5,9010377,56.9,893227,9.0
Los Angeles County,1976,7,3399094,63.8,3103079,58.2,296015,8.7
Colorado,1976,7,1234684,66.4,1163541,62.6,71143,5.8
Connecticut,1976,7,1460635,64.6,1327624,58.7,133011,9.1
Delaware,1976,7,263315,62.5,240211,57.1,23104,8.8
District of Columbia,1976,7,331507,64.1,303684,58.7,27823,8.4
Florida,1976,7,3602782,55.3,3275577,50.3,327205,9.1
Georgia,1976,7,2273239,63.9,2092242,58.8,180997,8.0
Hawaii,1976,7,410102,69.2,373058,62.9,37044,9.0
Idaho,1976,7,373107,63.2,352181,59.7,20926,5.6
Illinois,1976,7,5156594,63.0,4816599,58.9,339995,6.6
Indiana,1976,7,2445243,64.1,2306108,60.5,139135,5.7
Iowa,1976,7,1337276,64.2,1284353,61.6,52923,4.0
Kansas,1976,7,1079247,65.4,1035054,62.8,44193,4.1
Kentucky,1976,7,1494780,60.0,1413722,56.8,81058,5.4
Louisiana,1976,7,1534267,56.6,1430273,52.7,103994,6.8
Maine,1976,7,477095,61.6,436790,56.4,40305,8.4
Maryland,1976,7,1915202,64.3,1789408,60.1,125794,6.6
Massachusetts,1976,7,2730674,64.8,2469470,58.6,261204,9.6
Michigan,1976,7,3996327,61.9,3627749,56.2,368578,9.2
Minnesota,1976,7,1853413,65.8,1749799,62.2,103614,5.6
Mississippi,1976,7,970764,58.5,910473,54.9,60291,6.2
Missouri,1976,7,2128622,61.0,1996806,57.2,131816,6.2
Montana,1976,7,333822,62.2,314232,58.5,19590,5.9
Nebraska,1976,7,717323,65.1,695483,63.1,21840,3.0
Nevada,1976,7,328735,70.8,300492,64.8,28243,8.6
New Hampshire,1976,7,401028,66.6,375302,62.3,25726,6.4
New Jersey,1976,7,3325758,61.8,2980510,55.3,345248,10.4
New Mexico,1976,7,489256,60.4,447267,55.2,41989,8.6
New York,1976,7,7696362,58.2,6912373,52.2,783989,10.2
New York city,1976,7,3081073,54.2,2737981,48.2,343092,11.1
North Carolina,1976,7,2612384,66.3,2458363,62.4,154021,5.9
North Dakota,1976,7,281143,62.9,270419,60.5,10724,3.8
Ohio,1976,7,4750580,61.4,4392879,56.8,357701,7.5
Oklahoma,1976,7,1191650,58.9,1125315,55.6,66335,5.6
Oregon,1976,7,1094956,62.9,995571,57.2,99385,9.1
Pennsylvania,1976,7,5138310,58.3,4729977,53.7,408333,7.9
Rhode Island,1976,7,441304,63.4,406937,58.5,34367,7.8
South Carolina,1976,7,1297400,64.6,1208997,60.2,88403,6.8
South Dakota,1976,7,310718,64.6,300829,62.5,9889,3.2
Tennessee,1976,7,1860137,59.7,1748920,56.1,111217,6.0
Texas,1976,7,5732915,63.9,5395557,60.1,337358,5.9
Utah,1976,7,527210,63.0,498273,59.5,28937,5.5
Vermont,1976,7,218925,63.8,200721,58.5,18204,8.3
Virginia,1976,7,2341316,65.3,2205025,61.5,136291,5.8
Washington,1976,7,1617348,61.4,1475933,56.0,141415,8.7
West Virginia,1976,7,708875,51.8,657571,48.0,51304,7.2
Wisconsin,1976,7,2147574,65.7,2033622,62.2,113952,5.3
Wyoming,1976,7,181523,65.8,174732,63.3,6791,3.7
Alabama,1976,8,1505121,57.0,1404636,53.2,100485,6.7
Alaska,1976,8,166416,68.5,153715,63.3,12701,7.6
Arizona,1976,8,987541,59.6,892485,53.8,95056,9.6
Arkansas,1976,8,894755,57.8,835190,54.0,59565,6.7
California,1976,8,9943383,62.6,9037097,56.9,906286,9.1
Los Angeles County,1976,8,3402483,63.8,3103316,58.2,299167,8.8
Colorado,1976,8,1239866,66.5,1166313,62.5,73553,5.9
Connecticut,1976,8,1461961,64.6,1330847,58.8,131114,9.0
Delaware,1976,8,263947,62.5,240436,57.0,23511,8.9
District of Columbia,1976,8,330756,64.0,302555,58.5,28201,8.5
Florida,1976,8,3607644,55.2,3280710,50.2,326934,9.1
Georgia,1976,8,2280846,63.9,2099313,58.9,181533,8.0
Hawaii,1976,8,410357,69.1,373926,63.0,36431,8.9
Idaho,1976,8,375109,63.4,354023,59.8,21086,5.6
Illinois,1976,8,5158806,63.0,4818730,58.8,340076,6.6
Indiana,1976,8,2450242,64.2,2311280,60.5,138962,5.7
Iowa,1976,8,1339651,64.2,1287034,61.7,52617,3.9
Kansas,1976,8,1082510,65.6,1038432,62.9,44078,4.1
Kentucky,1976,8,1495671,60.0,1415395,56.8,80276,5.4
Louisiana,1976,8,1538687,56.6,1433303,52.7,105384,6.8
Maine,1976,8,477210,61.6,436562,56.3,40648,8.5
Maryland,1976,8,1919926,64.3,1792801,60.1,127125,6.6
Massachusetts,1976,8,2736966,64.9,2480126,58.8,256840,9.4
Michigan,1976,8,4001428,61.9,3637189,56.3,364239,9.1
Minnesota,1976,8,1860447,66.0,1755105,62.3,105342,5.7
Mississippi,1976,8,972756,58.5,911266,54.8,61490,6.3
Missouri,1976,8,2137004,61.2,2002746,57.3,134258,6.3
Montana,1976,8,334898,62.2,315090,58.6,19808,5.9
Nebraska,1976,8,719393,65.2,697327,63.2,22066,3.1
Nevada,1976,8,330696,71.0,302339,64.9,28357,8.6
New Hampshire,1976,8,402883,66.7,377207,62.5,25676,6.4
New Jersey,1976,8,3331284,61.8,2984381,55.4,346903,10.4
New Mexico,1976,8,491177,60.4,448792,55.2,42385,8.6
New York,1976,8,7697049,58.2,6910069,52.2,786980,10.2
New York city,1976,8,3082731,54.3,2739158,48.3,343573,11.1
North Carolina,1976,8,2615329,66.2,2460401,62.3,154928,5.9
North Dakota,1976,8,282200,63.0,271148,60.5,11052,3.9
Ohio,1976,8,4748526,61.4,4393870,56.8,354656,7.5
Oklahoma,1976,8,1193335,58.9,1127599,55.6,65736,5.5
Oregon,1976,8,1102501,63.2,1001472,57.4,101029,9.2
Pennsylvania,1976,8,5141829,58.3,4736852,53.7,404977,7.9
Rhode Island,1976,8,441117,63.3,406023,58.3,35094,8.0
South Carolina,1976,8,1298899,64.5,1210629,60.1,88270,6.8
South Dakota,1976,8,311636,64.7,301341,62.5,10295,3.3
Tennessee,1976,8,1869160,59.9,1755915,56.2,113245,6.1
Texas,1976,8,5748413,63.9,5414486,60.2,333927,5.8
Utah,1976,8,529123,63.0,500375,59.6,28748,5.4
Vermont,1976,8,219150,63.7,201245,58.5,17905,8.2
Virginia,1976,8,2345276,65.3,2208979,61.5,136297,5.8
Washington,1976,8,1630362,61.7,1485599,56.2,144763,8.9
West Virginia,1976,8,706460,51.5,656636,47.9,49824,7.1
Wisconsin,1976,8,2153381,65.8,2038648,62.3,114733,5.3
Wyoming,1976,8,182561,65.9,175824,63.5,6737,3.7
Alabama,1976,9,1509649,57.1,1407083,53.2,102566,6.8
Alaska,1976,9,167180,68.8,153851,63.3,13329,8.0
Arizona,1976,9,993413,59.7,898289,54.0,95124,9.6
Arkansas,1976,9,896624,57.8,837593,54.0,59031,6.6
California,1976,9,9982133,62.7,9062648,56.9,919485,9.2
Los Angeles County,1976,9,3405877,63.8,3103689,58.1,302188,8.9
Colorado,1976,9,1246348,66.6,1170214,62.6,76134,6.1
Connecticut,1976,9,1461610,64.5,1332667,58.8,128943,8.8
Delaware,1976,9,264516,62.7,240732,57.0,23784,9.0
District of Columbia,1976,9,330093,64.0,301461,58.4,28632,8.7
Florida,1976,9,3611679,55.1,3284182,50.1,327497,9.1
Georgia,1976,9,2288373,64.0,2105436,58.9,182937,8.0
Hawaii,1976,9,410704,68.9,374686,62.9,36018,8.8
Idaho,1976,9,376968,63.5,355686,59.9,21282,5.6
Illinois,1976,9,5159507,62.9,4821126,58.8,338381,6.6
Indiana,1976,9,2452705,64.2,2312824,60.5,139881,5.7
Iowa,1976,9,1342976,64.3,1290218,61.8,52758,3.9
Kansas,1976,9,1085274,65.7,1041128,63.0,44146,4.1
Kentucky,1976,9,1496361,59.9,1417188,56.7,79173,5.3
Louisiana,1976,9,1542014,56.6,1436017,52.7,105997,6.9
Maine,1976,9,477240,61.4,436065,56.1,41175,8.6
Maryland,1976,9,1923870,64.4,1795726,60.1,128144,6.7
Massachusetts,1976,9,2740809,64.9,2487985,59.0,252824,9.2
Michigan,1976,9,4005290,61.9,3643758,56.3,361532,9.0
Minnesota,1976,9,1866528,66.1,1759271,62.3,107257,5.7
Mississippi,1976,9,974831,58.5,912030,54.8,62801,6.4
Missouri,1976,9,2144329,61.3,2007558,57.4,136771,6.4
Montana,1976,9,336167,62.4,316209,58.7,19958,5.9
Nebraska,1976,9,721181,65.3,698890,63.3,22291,3.1
Nevada,1976,9,332594,70.9,303985,64.8,28609,8.6
New Hampshire,1976,9,404352,66.7,378725,62.5,25627,6.3
New Jersey,1976,9,3336447,61.9,2987935,55.4,348512,10.4
New Mexico,1976,9,493080,60.5,450077,55.2,43003,8.7
New York,1976,9,7691659,58.1,6903919,52.2,787740,10.2
New York city,1976,9,3081830,54.3,2739239,48.3,342591,11.1
North Carolina,1976,9,2617712,66.2,2460023,62.2,157689,6.0
North Dakota,1976,9,282985,63.2,271679,60.6,11306,4.0
Ohio,1976,9,4748258,61.3,4394507,56.7,353751,7.5
Oklahoma,1976,9,1195031,58.9,1129978,55.7,65053,5.4
Oregon,1976,9,1109625,63.4,1007029,57.5,102596,9.2
Pennsylvania,1976,9,5145831,58.3,4741596,53.7,404235,7.9
Rhode Island,1976,9,441067,63.2,405075,58.0,35992,8.2
South Carolina,1976,9,1300801,64.5,1212463,60.1,88338,6.8
South Dakota,1976,9,312405,64.8,301733,62.6,10672,3.4
Tennessee,1976,9,1877764,60.0,1762321,56.3,115443,6.1
Texas,1976,9,5760462,63.9,5429512,60.2,330950,5.7
Utah,1976,9,530674,63.0,501982,59.6,28692,5.4
Vermont,1976,9,219230,63.5,201667,58.5,17563,8.0
Virginia,1976,9,2349043,65.3,2213245,61.5,135798,5.8
Washington,1976,9,1642767,62.0,1494839,56.4,147928,9.0
West Virginia,1976,9,704288,51.3,655887,47.7,48401,6.9
Wisconsin,1976,9,2157929,65.9,2042335,62.3,115594,5.4
Wyoming,1976,9,183449,66.0,176702,63.6,6747,3.7
Alabama,1976,10,1514447,57.1,1409795,53.2,104652,6.9
Alaska,1976,10,167790,68.8,153868,63.1,13922,8.3
Arizona,1976,10,999463,59.8,904453,54.1,95010,9.5
Arkansas,1976,10,898793,57.8,839863,54.0,58930,6.6
California,1976,10,10020044,62.8,9089492,57.0,930552,9.3
Los Angeles County,1976,10,3409972,63.8,3105661,58.1,304311,8.9
Colorado,1976,10,1253820,66.8,1175284,62.6,78536,6.3
Connecticut,1976,10,1460490,64.4,1333848,58.8,126642,8.7
Delaware,1976,10,265109,62.7,241053,57.0,24056,9.1
District of Columbia,1976,10,329502,63.9,300500,58.2,29002,8.8
Florida,1976,10,3615025,55.0,3286676,50.0,328349,9.1
Georgia,1976,10,2295743,64.1,2110772,58.9,184971,8.1
Hawaii,1976,10,411303,68.9,375500,62.9,35803,8.7
Idaho,1976,10,378803,63.7,357186,60.0,21617,5.7
Illinois,1976,10,5161172,62.9,4826180,58.8,334992,6.5
Indiana,1976,10,2452800,64.1,2311115,60.4,141685,5.8
Iowa,1976,10,1347410,64.4,1294102,61.9,53308,4.0
Kansas,1976,10,1087745,65.7,1043241,63.0,44504,4.1
Kentucky,1976,10,1497599,59.8,1419389,56.7,78210,5.2
Louisiana,1976,10,1544486,56.6,1438250,52.7,106236,6.9
Maine,1976,10,477449,61.4,435542,56.0,41907,8.8
Maryland,1976,10,1927709,64.4,1798458,60.1,129251,6.7
Massachusetts,1976,10,2741315,64.9,2492084,59.0,249231,9.1
Michigan,1976,10,4010071,61.9,3649206,56.3,360865,9.0
Minnesota,1976,10,1871691,66.2,1762742,62.4,108949,5.8
Mississippi,1976,10,976863,58.6,912806,54.8,64057,6.6
Missouri,1976,10,2150638,61.4,2011493,57.5,139145,6.5
Montana,1976,10,337644,62.5,317497,58.8,20147,6.0
Nebraska,1976,10,722709,65.4,700287,63.4,22422,3.1
Nevada,1976,10,334508,71.0,305580,64.9,28928,8.6
New Hampshire,1976,10,405650,66.7,379970,62.5,25680,6.3
New Jersey,1976,10,3341949,61.9,2991372,55.4,350577,10.5
New Mexico,1976,10,495215,60.5,451379,55.2,43836,8.9
New York,1976,10,7684134,58.1,6897272,52.1,786862,10.2
New York city,1976,10,3079423,54.3,2738977,48.3,340446,11.1
North Carolina,1976,10,2619883,66.1,2458321,62.0,161562,6.2
North Dakota,1976,10,283528,63.1,272003,60.6,11525,4.1
Ohio,1976,10,4750895,61.3,4395543,56.7,355352,7.5
Oklahoma,1976,10,1197318,58.9,1132849,55.7,64469,5.4
Oregon,1976,10,1116143,63.6,1012091,57.6,104052,9.3
Pennsylvania,1976,10,5150807,58.3,4743684,53.7,407123,7.9
Rhode Island,1976,10,441421,63.2,404409,57.9,37012,8.4
South Carolina,1976,10,1303240,64.4,1214447,60.0,88793,6.8
South Dakota,1976,10,313053,64.8,302045,62.5,11008,3.5
Tennessee,1976,10,1885881,60.2,1768008,56.4,117873,6.3
Texas,1976,10,5772866,63.8,5442664,60.2,330202,5.7
Utah,1976,10,532107,63.0,503267,59.6,28840,5.4
Vermont,1976,10,219366,63.6,202110,58.6,17256,7.9
Virginia,1976,10,2352889,65.3,2217915,61.5,134974,5.7
Washington,1976,10,1653777,62.2,1502690,56.6,151087,9.1
West Virginia,1976,10,703408,51.1,655510,47.6,47898,6.8
Wisconsin,1976,10,2161240,65.9,2044855,62.3,116385,5.4
Wyoming,1976,10,184315,66.1,177487,63.6,6828,3.7
Alabama,1976,11,1519811,57.3,1412921,53.2,106890,7.0
Alaska,1976,11,168258,69.0,153794,63.0,14464,8.6
Arizona,1976,11,1005364,59.9,910597,54.3,94767,9.4
Arkansas,1976,11,901341,57.9,842135,54.1,59206,6.6
California,1976,11,10057937,62.9,9120389,57.0,937548,9.3
Los Angeles County,1976,11,3414552,63.8,3109521,58.1,305031,8.9
Colorado,1976,11,1261349,67.1,1180591,62.8,80758,6.4
Connecticut,1976,11,1459621,64.3,1335330,58.8,124291,8.5
Delaware,1976,11,265836,62.7,241509,57.0,24327,9.2
District of Columbia,1976,11,328979,63.9,299729,58.2,29250,8.9
Florida,1976,11,3618451,55.0,3289366,50.0,329085,9.1
Georgia,1976,11,2302597,64.1,2115728,58.9,186869,8.1
Hawaii,1976,11,412145,68.8,376474,62.9,35671,8.7
Idaho,1976,11,380682,63.8,358606,60.1,22076,5.8
Illinois,1976,11,5166453,62.9,4835787,58.8,330666,6.4
Indiana,1976,11,2451136,63.9,2307957,60.2,143179,5.8
Iowa,1976,11,1352912,64.6,1298854,62.1,54058,4.0
Kansas,1976,11,1090148,65.8,1045111,63.0,45037,4.1
Kentucky,1976,11,1500135,59.8,1422507,56.7,77628,5.2
Louisiana,1976,11,1546793,56.6,1440358,52.7,106435,6.9
Maine,1976,11,477981,61.3,435208,55.8,42773,8.9
Maryland,1976,11,1931829,64.5,1801646,60.1,130183,6.7
Massachusetts,1976,11,2738644,64.8,2492649,59.0,245995,9.0
Michigan,1976,11,4017008,61.9,3655726,56.4,361282,9.0
Minnesota,1976,11,1876237,66.3,1766050,62.4,110187,5.9
Mississippi,1976,11,978822,58.6,913557,54.7,65265,6.7
Missouri,1976,11,2155782,61.5,2015230,57.5,140552,6.5
Montana,1976,11,339163,62.6,318803,58.8,20360,6.0
Nebraska,1976,11,724199,65.5,701693,63.4,22506,3.1
Nevada,1976,11,336491,71.0,307303,64.8,29188,8.7
New Hampshire,1976,11,406994,66.7,381158,62.5,25836,6.3
New Jersey,1976,11,3348160,62.0,2995183,55.4,352977,10.5
New Mexico,1976,11,497601,60.7,452921,55.2,44680,9.0
New York,1976,11,7678510,58.0,6893843,52.1,784667,10.2
New York city,1976,11,3076833,54.4,2739097,48.4,337736,11.0
North Carolina,1976,11,2622472,66.0,2456782,61.9,165690,6.3
North Dakota,1976,11,283975,63.2,272196,60.6,11779,4.1
Ohio,1976,11,4756815,61.3,4399284,56.7,357531,7.5
Oklahoma,1976,11,1200617,58.9,1136665,55.8,63952,5.3
Oregon,1976,11,1121842,63.7,1016783,57.7,105059,9.4
Pennsylvania,1976,11,5157677,58.4,4744837,53.7,412840,8.0
Rhode Island,1976,11,442229,63.2,404217,57.7,38012,8.6
South Carolina,1976,11,1306377,64.4,1216485,60.0,89892,6.9
South Dakota,1976,11,313656,64.9,302342,62.6,11314,3.6
Tennessee,1976,11,1894081,60.3,1773459,56.4,120622,6.4
Texas,1976,11,5788621,63.8,5456390,60.2,332231,5.7
Utah,1976,11,533597,63.0,504477,59.6,29120,5.5
Vermont,1976,11,219725,63.5,202700,58.6,17025,7.7
Virginia,1976,11,2357368,65.3,2223244,61.6,134124,5.7
Washington,1976,11,1662926,62.4,1508919,56.6,154007,9.3
West Virginia,1976,11,704057,51.1,655743,47.6,48314,6.9
Wisconsin,1976,11,2164150,65.9,2046725,62.3,117425,5.4
Wyoming,1976,11,185232,66.2,178305,63.7,6927,3.7
Alabama,1976,12,1525827,57.4,1416558,53.3,109269,7.2
Alaska,1976,12,168729,68.9,153764,62.8,14965,8.9
Arizona,1976,12,1010968,60.0,916504,54.4,94464,9.3
Arkansas,1976,12,904128,57.9,844483,54.1,59645,6.6
California,1976,12,10096320,63.0,9157978,57.1,938342,9.3
Los Angeles County,1976,12,3419226,63.8,3115416,58.2,303810,8.9
Colorado,1976,12,1267965,67.2,1185243,62.8,82722,6.5
Connecticut,1976,12,1460013,64.3,1338214,58.9,121799,8.3
Delaware,1976,12,266789,62.9,242278,57.1,24511,9.2
District of Columbia,1976,12,328590,63.8,299282,58.1,29308,8.9
Florida,1976,12,3623116,54.9,3294008,49.9,329108,9.1
Georgia,1976,12,2308443,64.2,2120947,59.0,187496,8.1
Hawaii,1976,12,413102,68.9,377652,62.9,35450,8.6
Idaho,1976,12,382595,63.9,360070,60.1,22525,5.9
Illinois,1976,12,5176898,62.9,4851125,59.0,325773,6.3
Indiana,1976,12,2449493,63.8,2305881,60.1,143612,5.9
Iowa,1976,12,1359146,64.9,1304426,62.3,54720,4.0
Kansas,1976,12,1092638,65.8,1047167,63.1,45471,4.2
Kentucky,1976,12,1504306,59.9,1427009,56.8,77297,5.1
Louisiana,1976,12,1549828,56.6,1443275,52.7,106553,6.9
Maine,1976,12,478753,61.3,435270,55.7,43483,9.1
Maryland,1976,12,1936427,64.5,1806057,60.2,130370,6.7
Massachusetts,1976,12,2734512,64.6,2491762,58.9,242750,8.9
Michigan,1976,12,4025914,62.0,3665132,56.4,360782,9.0
Minnesota,1976,12,1880772,66.3,1769888,62.4,110884,5.9
Mississippi,1976,12,980708,58.6,914229,54.6,66479,6.8
Missouri,1976,12,2159928,61.6,2019695,57.6,140233,6.5
Montana,1976,12,340542,62.7,320032,58.9,20510,6.0
Nebraska,1976,12,725854,65.6,703293,63.5,22561,3.1
Nevada,1976,12,338492,71.1,309309,65.0,29183,8.6
New Hampshire,1976,12,408535,66.8,382533,62.5,26002,6.4
New Jersey,1976,12,3354816,62.0,3000486,55.5,354330,10.6
New Mexico,1976,12,500021,60.8,454863,55.3,45158,9.0
New York,1976,12,7677887,58.0,6896742,52.1,781145,10.2
New York city,1976,12,3074891,54.4,2740292,48.5,334599,10.9
North Carolina,1976,12,2626102,66.0,2457392,61.8,168710,6.4
North Dakota,1976,12,284456,63.2,272406,60.5,12050,4.2
Ohio,1976,12,4765878,61.4,4408359,56.8,357519,7.5
Oklahoma,1976,12,1205019,59.0,1141451,55.9,63568,5.3
Oregon,1976,12,1126674,63.8,1021476,57.8,105198,9.3
Pennsylvania,1976,12,5165781,58.4,4747630,53.7,418151,8.1
Rhode Island,1976,12,443359,63.2,404581,57.7,38778,8.7
South Carolina,1976,12,1309983,64.5,1218598,60.0,91385,7.0
South Dakota,1976,12,314251,64.9,302710,62.5,11541,3.7
Tennessee,1976,12,1902750,60.4,1779576,56.5,123174,6.5
Texas,1976,12,5808871,63.9,5473400,60.2,335471,5.8
Utah,1976,12,535252,63.0,505850,59.5,29402,5.5
Vermont,1976,12,220391,63.5,203518,58.7,16873,7.7
Virginia,1976,12,2362512,65.3,2229219,61.6,133293,5.6
Washington,1976,12,1670136,62.5,1513953,56.7,156183,9.4
West Virginia,1976,12,705922,51.1,656747,47.6,49175,7.0
Wisconsin,1976,12,2167060,65.9,2048919,62.3,118141,5.5
Wyoming,1976,12,186275,66.3,179265,63.8,7010,3.8
Alabama,1977,1,1532500,57.5,1420756,53.4,111744,7.3
Alaska,1977,1,169309,69.1,153861,62.8,15448,9.1
Arizona,1977,1,1016746,60.2,922388,54.6,94358,9.3
Arkansas,1977,1,907157,58.0,847017,54.1,60140,6.6
California,1977,1,10137699,63.1,9204162,57.3,933537,9.2
Los Angeles County,1977,1,3425617,63.9,3124784,58.3,300833,8.8
Colorado,1977,1,1273628,67.3,1189423,62.9,84205,6.6
Connecticut,1977,1,1462469,64.3,1343245,59.1,119224,8.2
Delaware,1977,1,268020,63.1,243447,57.3,24573,9.2
District of Columbia,1977,1,328434,63.8,299236,58.1,29198,8.9
Florida,1977,1,3630976,54.9,3302385,49.9,328591,9.0
Georgia,1977,1,2313375,64.2,2127069,59.0,186306,8.1
Hawaii,1977,1,414171,68.9,379072,63.1,35099,8.5
Idaho,1977,1,384586,64.0,361733,60.2,22853,5.9
Illinois,1977,1,5193912,63.1,4872374,59.2,321538,6.2
Indiana,1977,1,2450491,63.8,2307252,60.1,143239,5.8
Iowa,1977,1,1365628,65.1,1310500,62.5,55128,4.0
Kansas,1977,1,1095411,65.9,1049736,63.2,45675,4.2
Kentucky,1977,1,1510207,60.0,1433142,57.0,77065,5.1
Louisiana,1977,1,1554869,56.6,1448136,52.8,106733,6.9
Maine,1977,1,479593,61.3,435759,55.7,43834,9.1
Maryland,1977,1,1942032,64.6,1812177,60.3,129855,6.7
Massachusetts,1977,1,2732019,64.5,2492531,58.9,239488,8.8
Michigan,1977,1,4037088,62.1,3678582,56.6,358506,8.9
Minnesota,1977,1,1886443,66.4,1775327,62.5,111116,5.9
Mississippi,1977,1,982678,58.6,914855,54.6,67823,6.9
Missouri,1977,1,2164323,61.6,2025636,57.7,138687,6.4
Montana,1977,1,341955,62.9,321329,59.1,20626,6.0
Nebraska,1977,1,727894,65.7,705244,63.7,22650,3.1
Nevada,1977,1,340562,71.2,311692,65.2,28870,8.5
New Hampshire,1977,1,410360,66.8,384242,62.6,26118,6.4
New Jersey,1977,1,3362453,62.1,3008717,55.6,353736,10.5
New Mexico,1977,1,502346,60.9,457333,55.4,45013,9.0
New York,1977,1,7684683,58.1,6907949,52.2,776734,10.1
New York city,1977,1,3074060,54.4,2742616,48.6,331444,10.8
North Carolina,1977,1,2631693,66.0,2461717,61.8,169976,6.5
North Dakota,1977,1,285094,63.4,272785,60.6,12309,4.3
Ohio,1977,1,4777884,61.5,4423399,56.9,354485,7.4
Oklahoma,1977,1,1210578,59.2,1146952,56.1,63626,5.3
Oregon,1977,1,1131002,63.8,1026636,57.9,104366,9.2
Pennsylvania,1977,1,5175278,58.5,4754499,53.7,420779,8.1
Rhode Island,1977,1,444572,63.4,405453,57.8,39119,8.8
South Carolina,1977,1,1314128,64.5,1221010,60.0,93118,7.1
South Dakota,1977,1,314893,65.1,303215,62.6,11678,3.7
Tennessee,1977,1,1911947,60.6,1786806,56.7,125141,6.5
Texas,1977,1,5833413,64.0,5495729,60.3,337684,5.8
Utah,1977,1,537210,63.1,507568,59.6,29642,5.5
Vermont,1977,1,221382,63.6,204595,58.8,16787,7.6
Virginia,1977,1,2368354,65.3,2235660,61.6,132694,5.6
Washington,1977,1,1676060,62.6,1518686,56.7,157374,9.4
West Virginia,1977,1,708669,51.2,658618,47.6,50051,7.1
Wisconsin,1977,1,2170776,65.9,2052500,62.3,118276,5.4
Wyoming,1977,1,187519,66.5,180462,64.0,7057,3.8
Alabama,1977,2,1539540,57.7,1425519,53.4,114021,7.4
Alaska,1977,2,170059,69.1,154151,62.7,15908,9.4
Arizona,1977,2,1022718,60.3,928545,54.7,94173,9.2
Arkansas,1977,2,910425,58.1,849927,54.2,60498,6.6
California,1977,2,10181250,63.2,9257576,57.5,923674,9.1
Los Angeles County,1977,2,3433862,64.0,3137571,58.5,296291,8.6
Colorado,1977,2,1278608,67.4,1193757,62.9,84851,6.6
Connecticut,1977,2,1466408,64.4,1350005,59.3,116403,7.9
Delaware,1977,2,269382,63.2,244907,57.5,24475,9.1
District of Columbia,1977,2,328371,63.9,299404,58.2,28967,8.8
Florida,1977,2,3642388,54.9,3315211,50.0,327177,9.0
Georgia,1977,2,2317034,64.1,2134005,59.1,183029,7.9
Hawaii,1977,2,415302,68.9,380690,63.1,34612,8.3
Idaho,1977,2,386665,64.1,363639,60.3,23026,6.0
Illinois,1977,2,5215337,63.3,4896698,59.4,318639,6.1
Indiana,1977,2,2455009,63.8,2312464,60.1,142545,5.8
Iowa,1977,2,1371494,65.3,1316273,62.7,55221,4.0
Kansas,1977,2,1098464,66.0,1052872,63.3,45592,4.2
Kentucky,1977,2,1516976,60.2,1440433,57.2,76543,5.0
Louisiana,1977,2,1562347,56.8,1455407,52.9,106940,6.8
Maine,1977,2,480268,61.3,436515,55.7,43753,9.1
Maryland,1977,2,1948097,64.7,1819543,60.4,128554,6.6
Massachusetts,1977,2,2732682,64.5,2496933,58.9,235749,8.6
Michigan,1977,2,4049764,62.2,3695690,56.8,354074,8.7
Minnesota,1977,2,1893882,66.6,1783150,62.7,110732,5.8
Mississippi,1977,2,984737,58.7,915568,54.6,69169,7.0
Missouri,1977,2,2169804,61.7,2033162,57.8,136642,6.3
Montana,1977,2,343335,63.0,322604,59.2,20731,6.0
Nebraska,1977,2,730301,65.8,707462,63.7,22839,3.1
Nevada,1977,2,342693,71.2,314431,65.4,28262,8.2
New Hampshire,1977,2,412311,66.8,386244,62.6,26067,6.3
New Jersey,1977,2,3370870,62.2,3020321,55.8,350549,10.4
New Mexico,1977,2,504635,60.9,460311,55.6,44324,8.8
New York,1977,2,7696320,58.1,6927449,52.3,768871,10.0
New York city,1977,2,3072906,54.5,2745433,48.7,327473,10.7
North Carolina,1977,2,2639061,66.1,2469743,61.8,169318,6.4
North Dakota,1977,2,285882,63.4,273346,60.6,12536,4.4
Ohio,1977,2,4791267,61.6,4442618,57.1,348649,7.3
Oklahoma,1977,2,1216872,59.4,1152915,56.3,63957,5.3
Oregon,1977,2,1135050,63.9,1032866,58.1,102184,9.0
Pennsylvania,1977,2,5185328,58.6,4765769,53.8,419559,8.1
Rhode Island,1977,2,445698,63.5,406682,57.9,39016,8.8
South Carolina,1977,2,1318327,64.6,1223694,60.0,94633,7.2
South Dakota,1977,2,315613,65.1,303874,62.7,11739,3.7
Tennessee,1977,2,1920544,60.8,1794397,56.8,126147,6.6
Texas,1977,2,5859779,64.1,5522799,60.4,336980,5.8
Utah,1977,2,539394,63.1,509639,59.6,29755,5.5
Vermont,1977,2,222546,64.0,205845,59.2,16701,7.5
Virginia,1977,2,2374567,65.3,2242210,61.7,132357,5.6
Washington,1977,2,1681207,62.6,1523951,56.8,157256,9.4
West Virginia,1977,2,711756,51.4,661197,47.7,50559,7.1
Wisconsin,1977,2,2174998,65.9,2057551,62.4,117447,5.4
Wyoming,1977,2,188943,66.5,181908,64.1,7035,3.7
Alabama,1977,3,1546469,57.9,1430705,53.5,115764,7.5
Alaska,1977,3,170890,69.5,154549,62.8,16341,9.6
Arizona,1977,3,1028518,60.4,934873,54.9,93645,9.1
Arkansas,1977,3,913766,58.2,853232,54.3,60534,6.6
California,1977,3,10224344,63.3,9314250,57.7,910094,8.9
Los Angeles County,1977,3,3442982,64.1,3152166,58.7,290816,8.4
Colorado,1977,3,1282540,67.4,1198006,62.9,84534,6.6
Connecticut,1977,3,1470575,64.6,1357309,59.6,113266,7.7
Delaware,1977,3,270672,63.5,246509,57.9,24163,8.9
District of Columbia,1977,3,328183,63.8,299474,58.3,28709,8.7
Florida,1977,3,3656369,54.9,3331918,50.1,324451,8.9
Georgia,1977,3,2319081,64.1,2141153,59.1,177928,7.7
Hawaii,1977,3,416181,68.9,382290,63.3,33891,8.1
Idaho,1977,3,388697,64.2,365573,60.4,23124,5.9
Illinois,1977,3,5236698,63.5,4919338,59.6,317360,6.1
Indiana,1977,3,2461767,63.9,2319985,60.2,141782,5.8
Iowa,1977,3,1375874,65.5,1320614,62.8,55260,4.0
Kansas,1977,3,1101440,66.1,1056231,63.4,45209,4.1
Kentucky,1977,3,1523209,60.3,1447618,57.4,75591,5.0
Louisiana,1977,3,1571507,57.0,1464623,53.1,106884,6.8
Maine,1977,3,480628,61.2,437337,55.7,43291,9.0
Maryland,1977,3,1953439,64.8,1826939,60.6,126500,6.5
Massachusetts,1977,3,2736364,64.5,2505037,59.1,231327,8.5
Michigan,1977,3,4062586,62.3,3714184,57.0,348402,8.6
Minnesota,1977,3,1902622,66.8,1792903,63.0,109719,5.8
Mississippi,1977,3,986812,58.7,916432,54.5,70380,7.1
Missouri,1977,3,2176482,61.8,2041608,58.0,134874,6.2
Montana,1977,3,344493,63.1,323681,59.3,20812,6.0
Nebraska,1977,3,732724,66.0,709613,63.9,23111,3.2
Nevada,1977,3,344696,71.4,317304,65.7,27392,7.9
New Hampshire,1977,3,414091,66.9,388330,62.7,25761,6.2
New Jersey,1977,3,3378105,62.3,3033741,56.0,344364,10.2
New Mexico,1977,3,506851,61.1,463479,55.8,43372,8.6
New York,1977,3,7707711,58.2,6951957,52.5,755754,9.8
New York city,1977,3,3070256,54.5,2748001,48.7,322255,10.5
North Carolina,1977,3,2647364,66.2,2480267,62.0,167097,6.3
North Dakota,1977,3,286647,63.4,273927,60.6,12720,4.4
Ohio,1977,3,4803584,61.7,4463552,57.3,340032,7.1
Oklahoma,1977,3,1223069,59.6,1158992,56.5,64077,5.2
Oregon,1977,3,1138751,63.9,1040124,58.4,98627,8.7
Pennsylvania,1977,3,5194346,58.6,4779019,53.9,415327,8.0
Rhode Island,1977,3,446606,63.5,408031,58.0,38575,8.6
South Carolina,1977,3,1321504,64.6,1226364,60.0,95140,7.2
South Dakota,1977,3,316279,65.2,304590,62.8,11689,3.7
Tennessee,1977,3,1926764,60.8,1800677,56.9,126087,6.5
Texas,1977,3,5883658,64.2,5551092,60.6,332566,5.7
Utah,1977,3,541441,63.2,511738,59.7,29703,5.5
Vermont,1977,3,223676,64.1,207118,59.3,16558,7.4
Virginia,1977,3,2380226,65.4,2248350,61.7,131876,5.5
Washington,1977,3,1685774,62.6,1529930,56.8,155844,9.2
West Virginia,1977,3,714534,51.5,663983,47.8,50551,7.1
Wisconsin,1977,3,2178663,65.9,2063288,62.4,115375,5.3
Wyoming,1977,3,190383,66.8,183468,64.4,6915,3.6
Alabama,1977,4,1553113,58.0,1436379,53.7,116734,7.5
Alaska,1977,4,171666,69.5,154963,62.7,16703,9.7
Arizona,1977,4,1034436,60.5,941652,55.1,92784,9.0
Arkansas,1977,4,917194,58.3,856933,54.4,60261,6.6
California,1977,4,10266363,63.5,9370903,57.9,895460,8.7
Los Angeles County,1977,4,3451823,64.2,3166301,58.9,285522,8.3
Colorado,1977,4,1285532,67.3,1202099,63.0,83433,6.5
Connecticut,1977,4,1474428,64.7,1364425,59.8,110003,7.5
Delaware,1977,4,271739,63.6,248093,58.1,23646,8.7
District of Columbia,1977,4,327826,63.9,299287,58.3,28539,8.7
Florida,1977,4,3672409,55.0,3351772,50.2,320637,8.7
Georgia,1977,4,2319954,63.9,2148119,59.2,171835,7.4
Hawaii,1977,4,416555,68.7,383686,63.3,32869,7.9
Idaho,1977,4,390737,64.5,367507,60.6,23230,5.9
Illinois,1977,4,5255900,63.6,4937963,59.8,317937,6.0
Indiana,1977,4,2469207,64.0,2327939,60.4,141268,5.7
Iowa,1977,4,1378683,65.5,1323236,62.9,55447,4.0
Kansas,1977,4,1104151,66.2,1059538,63.5,44613,4.0
Kentucky,1977,4,1528373,60.5,1453931,57.5,74442,4.9
Louisiana,1977,4,1581436,57.3,1474786,53.4,106650,6.7
Maine,1977,4,480700,61.1,438142,55.7,42558,8.9
Maryland,1977,4,1957357,64.8,1833610,60.7,123747,6.3
Massachusetts,1977,4,2742178,64.6,2515558,59.3,226620,8.3
Michigan,1977,4,4075317,62.5,3732059,57.2,343258,8.4
Minnesota,1977,4,1911524,67.0,1803405,63.2,108119,5.7
Mississippi,1977,4,989123,58.7,917666,54.5,71457,7.2
Missouri,1977,4,2184265,62.0,2050468,58.2,133797,6.1
Montana,1977,4,345729,63.2,324823,59.4,20906,6.0
Nebraska,1977,4,735037,66.1,711593,64.0,23444,3.2
Nevada,1977,4,346504,71.3,320144,65.9,26360,7.6
New Hampshire,1977,4,415612,66.9,390405,62.9,25207,6.1
New Jersey,1977,4,3383239,62.4,3047295,56.2,335944,9.9
New Mexico,1977,4,508830,61.1,466544,56.0,42286,8.3
New York,1977,4,7716524,58.3,6977815,52.7,738709,9.6
New York city,1977,4,3066318,54.5,2749662,48.8,316656,10.3
North Carolina,1977,4,2656658,66.3,2492422,62.2,164236,6.2
North Dakota,1977,4,287302,63.6,274447,60.7,12855,4.5
Ohio,1977,4,4813786,61.8,4484384,57.5,329402,6.8
Oklahoma,1977,4,1228874,59.8,1165110,56.7,63764,5.2
Oregon,1977,4,1142148,63.9,1047965,58.6,94183,8.2
Pennsylvania,1977,4,5201972,58.7,4791748,54.1,410224,7.9
Rhode Island,1977,4,447272,63.5,409341,58.1,37931,8.5
South Carolina,1977,4,1323419,64.6,1229025,60.0,94394,7.1
South Dakota,1977,4,316797,65.2,305293,62.8,11504,3.6
Tennessee,1977,4,1930531,60.8,1805495,56.9,125036,6.5
Texas,1977,4,5903231,64.3,5578003,60.7,325228,5.5
Utah,1977,4,543176,63.2,513643,59.7,29533,5.4
Vermont,1977,4,224714,64.2,208360,59.5,16354,7.3
Virginia,1977,4,2385076,65.4,2254172,61.8,130904,5.5
Washington,1977,4,1690618,62.6,1537243,57.0,153375,9.1
West Virginia,1977,4,716722,51.6,666586,48.0,50136,7.0
Wisconsin,1977,4,2181642,65.9,2068988,62.5,112654,5.2
Wyoming,1977,4,191769,67.1,185068,64.7,6701,3.5
Alabama,1977,5,1559061,58.1,1442398,53.8,116663,7.5
Alaska,1977,5,172323,69.8,155348,62.9,16975,9.9
Arizona,1977,5,1040390,60.6,948785,55.3,91605,8.8
Arkansas,1977,5,920623,58.3,860767,54.5,59856,6.5
California,1977,5,10307069,63.6,9425458,58.1,881611,8.6
Los Angeles County,1977,5,3459397,64.3,3178200,59.0,281197,8.1
Colorado,1977,5,1287908,67.3,1205911,63.0,81997,6.4
Connecticut,1977,5,1477942,64.7,1371085,60.1,106857,7.2
Delaware,1977,5,272407,63.6,249412,58.3,22995,8.4
District of Columbia,1977,5,327391,63.8,298915,58.3,28476,8.7
Florida,1977,5,3690082,55.2,3373835,50.4,316247,8.6
Georgia,1977,5,2320345,63.8,2154717,59.3,165628,7.1
Hawaii,1977,5,416495,68.6,384774,63.4,31721,7.6
Idaho,1977,5,392872,64.6,369495,60.8,23377,6.0
Illinois,1977,5,5272548,63.8,4952150,59.9,320398,6.1
Indiana,1977,5,2475611,64.1,2334498,60.5,141113,5.7
Iowa,1977,5,1380961,65.5,1325161,62.9,55800,4.0
Kansas,1977,5,1106593,66.2,1062605,63.6,43988,4.0
Kentucky,1977,5,1532490,60.5,1459179,57.6,73311,4.8
Louisiana,1977,5,1591139,57.5,1484511,53.6,106628,6.7
Maine,1977,5,480593,61.0,438931,55.7,41662,8.7
Maryland,1977,5,1960090,64.8,1839333,60.8,120757,6.2
Massachusetts,1977,5,2748364,64.7,2526345,59.5,222019,8.1
Michigan,1977,5,4088157,62.6,3748837,57.4,339320,8.3
Minnesota,1977,5,1919054,67.2,1812949,63.5,106105,5.5
Mississippi,1977,5,991558,58.8,919212,54.5,72346,7.3
Missouri,1977,5,2192597,62.1,2059251,58.4,133346,6.1
Montana,1977,5,347120,63.2,326055,59.4,21065,6.1
Nebraska,1977,5,737203,66.2,713338,64.1,23865,3.2
Nevada,1977,5,348097,71.3,322831,66.2,25266,7.3
New Hampshire,1977,5,416907,66.9,392415,63.0,24492,5.9
New Jersey,1977,5,3386108,62.4,3059508,56.4,326600,9.6
New Mexico,1977,5,510353,61.1,469244,56.2,41109,8.1
New York,1977,5,7722450,58.3,7001957,52.9,720493,9.3
New York city,1977,5,3061884,54.4,2750138,48.9,311746,10.2
North Carolina,1977,5,2666733,66.4,2505488,62.4,161245,6.0
North Dakota,1977,5,287861,63.5,274898,60.7,12963,4.5
Ohio,1977,5,4822173,61.8,4503693,57.7,318480,6.6
Oklahoma,1977,5,1234100,59.9,1171064,56.8,63036,5.1
Oregon,1977,5,1145299,63.9,1055777,58.9,89522,7.8
Pennsylvania,1977,5,5208228,58.7,4802426,54.1,405802,7.8
Rhode Island,1977,5,447839,63.5,410616,58.2,37223,8.3
South Carolina,1977,5,1324298,64.5,1231580,60.0,92718,7.0
South Dakota,1977,5,317113,65.2,305925,62.9,11188,3.5
Tennessee,1977,5,1932920,60.8,1809761,56.9,123159,6.4
Texas,1977,5,5920374,64.3,5602796,60.9,317578,5.4
Utah,1977,5,544493,63.2,515225,59.8,29268,5.4
Vermont,1977,5,225736,64.3,209609,59.7,16127,7.1
Virginia,1977,5,2389632,65.4,2259989,61.8,129643,5.4
Washington,1977,5,1696005,62.7,1545973,57.1,150032,8.8
West Virginia,1977,5,718206,51.6,668659,48.0,49547,6.9
Wisconsin,1977,5,2183858,65.9,2073669,62.6,110189,5.0
Wyoming,1977,5,193094,67.3,186652,65.0,6442,3.3
Alabama,1977,6,1564005,58.2,1448414,53.9,115591,7.4
Alaska,1977,6,172866,69.7,155694,62.8,17172,9.9
Arizona,1977,6,1045877,60.7,955723,55.5,90154,8.6
Arkansas,1977,6,924098,58.5,864595,54.7,59503,6.4
California,1977,6,10347934,63.7,9478129,58.3,869805,8.4
Los Angeles County,1977,6,3465957,64.3,3187840,59.2,278117,8.0
Colorado,1977,6,1290471,67.2,1209567,63.0,80904,6.3
Connecticut,1977,6,1481616,64.8,1377539,60.3,104077,7.0
Delaware,1977,6,272689,63.7,250353,58.5,22336,8.2
District of Columbia,1977,6,326947,63.9,298471,58.3,28476,8.7
Florida,1977,6,3709261,55.3,3397435,50.7,311826,8.4
Georgia,1977,6,2321264,63.7,2160930,59.3,160334,6.9
Hawaii,1977,6,416242,68.3,385472,63.3,30770,7.4
Idaho,1977,6,395170,64.8,371613,60.9,23557,6.0
Illinois,1977,6,5286840,63.9,4962047,59.9,324793,6.1
Indiana,1977,6,2480736,64.2,2339464,60.5,141272,5.7
Iowa,1977,6,1383988,65.6,1327693,63.0,56295,4.1
Kansas,1977,6,1108792,66.3,1065321,63.7,43471,3.9
Kentucky,1977,6,1536153,60.5,1463773,57.7,72380,4.7
Louisiana,1977,6,1599923,57.7,1492891,53.8,107032,6.7
Maine,1977,6,480498,60.8,439748,55.7,40750,8.5
Maryland,1977,6,1962771,64.8,1844443,60.9,118328,6.0
Massachusetts,1977,6,2753602,64.8,2535716,59.6,217886,7.9
Michigan,1977,6,4101573,62.7,3764233,57.6,337340,8.2
Minnesota,1977,6,1924225,67.3,1820361,63.6,103864,5.4
Mississippi,1977,6,993860,58.8,920837,54.5,73023,7.3
Missouri,1977,6,2201004,62.3,2067621,58.5,133383,6.1
Montana,1977,6,348478,63.4,327195,59.5,21283,6.1
Nebraska,1977,6,739247,66.4,714793,64.2,24454,3.3
Nevada,1977,6,349554,71.2,325371,66.3,24183,6.9
New Hampshire,1977,6,418089,66.9,394373,63.1,23716,5.7
New Jersey,1977,6,3386733,62.3,3069031,56.5,317702,9.4
New Mexico,1977,6,511473,61.0,471568,56.3,39905,7.8
New York,1977,6,7726627,58.3,7022113,53.0,704514,9.1
New York city,1977,6,3057869,54.4,2749330,48.9,308539,10.1
North Carolina,1977,6,2677091,66.5,2518347,62.6,158744,5.9
North Dakota,1977,6,288371,63.7,275316,60.8,13055,4.5
Ohio,1977,6,4830025,61.9,4521087,57.9,308938,6.4
Oklahoma,1977,6,1238796,60.0,1176898,57.0,61898,5.0
Oregon,1977,6,1148487,63.9,1063351,59.1,85136,7.4
Pennsylvania,1977,6,5213385,58.7,4810786,54.2,402599,7.7
Rhode Island,1977,6,448478,63.5,411942,58.3,36536,8.1
South Carolina,1977,6,1324773,64.3,1234043,59.9,90730,6.8
South Dakota,1977,6,317281,65.2,306467,62.9,10814,3.4
Tennessee,1977,6,1935169,60.7,1814204,56.9,120965,6.3
Texas,1977,6,5938639,64.3,5625881,60.9,312758,5.3
Utah,1977,6,545495,63.1,516537,59.7,28958,5.3
Vermont,1977,6,226863,64.6,210937,60.1,15926,7.0
Virginia,1977,6,2395066,65.4,2266334,61.9,128732,5.4
Washington,1977,6,1701658,62.7,1555195,57.3,146463,8.6
West Virginia,1977,6,719030,51.5,670029,48.0,49001,6.8
Wisconsin,1977,6,2185243,65.9,2076817,62.6,108426,5.0
Wyoming,1977,6,194364,67.5,188159,65.3,6205,3.2
Alabama,1977,7,1568040,58.3,1454342,54.0,113698,7.3
Alaska,1977,7,173415,69.9,156153,63.0,17262,10.0
Arizona,1977,7,1050508,60.8,961989,55.6,88519,8.4
Arkansas,1977,7,927649,58.6,868342,54.8,59307,6.4
California,1977,7,10390933,63.8,9531197,58.5,859736,8.3
Los Angeles County,1977,7,3471831,64.4,3195870,59.3,275961,7.9
Colorado,1977,7,1293655,67.2,1213549,63.0,80106,6.2
Connecticut,1977,7,1486025,65.0,1384345,60.5,101680,6.8
Delaware,1977,7,272803,63.6,251028,58.5,21775,8.0
District of Columbia,1977,7,326628,63.8,298172,58.2,28456,8.7
Florida,1977,7,3729918,55.5,3422425,50.9,307493,8.2
Georgia,1977,7,2323878,63.7,2167460,59.4,156418,6.7
Hawaii,1977,7,416163,68.2,385900,63.3,30263,7.3
Idaho,1977,7,397793,65.0,374058,61.1,23735,6.0
Illinois,1977,7,5299007,63.9,4969329,60.0,329678,6.2
Indiana,1977,7,2485585,64.2,2343587,60.6,141998,5.7
Iowa,1977,7,1387630,65.7,1330982,63.0,56648,4.1
Kansas,1977,7,1111025,66.3,1068008,63.8,43017,3.9
Kentucky,1977,7,1539883,60.6,1468088,57.8,71795,4.7
Louisiana,1977,7,1607658,57.9,1499479,54.0,108179,6.7
Maine,1977,7,480513,60.7,440598,55.7,39915,8.3
Maryland,1977,7,1966792,64.8,1850084,61.0,116708,5.9
Massachusetts,1977,7,2757404,64.8,2543243,59.8,214161,7.8
Michigan,1977,7,4115746,62.9,3778785,57.7,336961,8.2
Minnesota,1977,7,1927382,67.3,1825937,63.8,101445,5.3
Mississippi,1977,7,995889,58.9,922545,54.5,73344,7.4
Missouri,1977,7,2209179,62.5,2075998,58.7,133181,6.0
Montana,1977,7,349793,63.5,328229,59.6,21564,6.2
Nebraska,1977,7,741323,66.5,716212,64.2,25111,3.4
Nevada,1977,7,351062,71.2,327915,66.5,23147,6.6
New Hampshire,1977,7,419439,66.9,396476,63.2,22963,5.5
New Jersey,1977,7,3386161,62.3,3076371,56.6,309790,9.1
New Mexico,1977,7,512607,61.0,473724,56.4,38883,7.6
New York,1977,7,7731601,58.4,7039090,53.1,692511,9.0
New York city,1977,7,3054913,54.4,2747823,48.9,307090,10.1
North Carolina,1977,7,2687831,66.7,2531170,62.8,156661,5.8
North Dakota,1977,7,288884,63.6,275787,60.7,13097,4.5
Ohio,1977,7,4838588,61.9,4536628,58.0,301960,6.2
Oklahoma,1977,7,1243222,60.1,1182950,57.2,60272,4.8
Oregon,1977,7,1152320,63.9,1070796,59.4,81524,7.1
Pennsylvania,1977,7,5218043,58.7,4817772,54.2,400271,7.7
Rhode Island,1977,7,449368,63.6,413444,58.5,35924,8.0
South Carolina,1977,7,1325778,64.3,1236729,59.9,89049,6.7
South Dakota,1977,7,317448,65.2,306994,63.0,10454,3.3
Tennessee,1977,7,1938850,60.7,1819567,57.0,119283,6.2
Texas,1977,7,5961078,64.4,5649079,61.0,311999,5.2
Utah,1977,7,546531,63.0,517873,59.7,28658,5.2
Vermont,1977,7,228192,64.8,212406,60.3,15786,6.9
Virginia,1977,7,2402257,65.4,2273625,61.9,128632,5.4
Washington,1977,7,1707122,62.8,1564389,57.5,142733,8.4
West Virginia,1977,7,719611,51.5,670851,48.0,48760,6.8
Wisconsin,1977,7,2186348,65.8,2079045,62.6,107303,4.9
Wyoming,1977,7,195666,67.7,189613,65.6,6053,3.1
Alabama,1977,8,1571784,58.3,1460345,54.2,111439,7.1
Alaska,1977,8,174145,69.9,156805,63.0,17340,10.0
Arizona,1977,8,1053908,60.7,967428,55.7,86480,8.2
Arkansas,1977,8,931105,58.7,871730,54.9,59375,6.4
California,1977,8,10437515,63.9,9586963,58.7,850552,8.1
Los Angeles County,1977,8,3477544,64.4,3203438,59.3,274106,7.9
Colorado,1977,8,1297942,67.2,1217890,63.0,80052,6.2
Connecticut,1977,8,1491184,65.1,1391618,60.8,99566,6.7
Delaware,1977,8,272954,63.5,251623,58.5,21331,7.8
District of Columbia,1977,8,326684,63.8,298324,58.3,28360,8.7
Florida,1977,8,3751640,55.6,3448538,51.1,303102,8.1
Georgia,1977,8,2328901,63.7,2175258,59.5,153643,6.6
Hawaii,1977,8,416424,68.2,386240,63.2,30184,7.2
Idaho,1977,8,400617,65.2,376819,61.4,23798,5.9
Illinois,1977,8,5310874,64.0,4977120,60.0,333754,6.3
Indiana,1977,8,2491619,64.3,2348162,60.6,143457,5.8
Iowa,1977,8,1391639,65.9,1335019,63.2,56620,4.1
Kansas,1977,8,1113387,66.4,1070976,63.9,42411,3.8
Kentucky,1977,8,1543990,60.7,1472004,57.8,71986,4.7
Louisiana,1977,8,1615027,58.0,1504683,54.0,110344,6.8
Maine,1977,8,480626,60.7,441458,55.7,39168,8.1
Maryland,1977,8,1973027,65.0,1857159,61.2,115868,5.9
Massachusetts,1977,8,2760933,64.8,2550296,59.9,210637,7.6
Michigan,1977,8,4130542,63.0,3793723,57.9,336819,8.2
Minnesota,1977,8,1929732,67.3,1830733,63.8,98999,5.1
Mississippi,1977,8,997747,58.9,924346,54.5,73401,7.4
Missouri,1977,8,2216927,62.6,2084787,58.9,132140,6.0
Montana,1977,8,351098,63.6,329241,59.6,21857,6.2
Nebraska,1977,8,743540,66.6,717818,64.3,25722,3.5
Nevada,1977,8,352740,71.1,330606,66.7,22134,6.3
New Hampshire,1977,8,421041,66.9,398761,63.4,22280,5.3
New Jersey,1977,8,3386448,62.2,3083716,56.7,302732,8.9
New Mexico,1977,8,513950,61.0,475953,56.5,37997,7.4
New York,1977,8,7740387,58.4,7055788,53.3,684599,8.8
New York city,1977,8,3053950,54.4,2747108,49.0,306842,10.0
North Carolina,1977,8,2699489,66.8,2544500,63.0,154989,5.7
North Dakota,1977,8,289510,63.8,276413,60.9,13097,4.5
Ohio,1977,8,4847616,62.0,4550019,58.2,297597,6.1
Oklahoma,1977,8,1247472,60.2,1189503,57.4,57969,4.6
Oregon,1977,8,1157045,64.0,1078203,59.6,78842,6.8
Pennsylvania,1977,8,5222797,58.8,4824494,54.3,398303,7.6
Rhode Island,1977,8,450423,63.6,415074,58.6,35349,7.8
South Carolina,1977,8,1328000,64.2,1240060,60.0,87940,6.6
South Dakota,1977,8,317754,65.2,307555,63.2,10199,3.2
Tennessee,1977,8,1944229,60.8,1825667,57.1,118562,6.1
Texas,1977,8,5988974,64.6,5674441,61.2,314533,5.3
Utah,1977,8,547783,63.0,519495,59.7,28288,5.2
Vermont,1977,8,229695,65.1,213977,60.6,15718,6.8
Virginia,1977,8,2410982,65.5,2281680,62.0,129302,5.4
Washington,1977,8,1712699,62.8,1573857,57.7,138842,8.1
West Virginia,1977,8,720598,51.5,671545,48.0,49053,6.8
Wisconsin,1977,8,2188409,65.8,2081321,62.6,107088,4.9
Wyoming,1977,8,197016,67.9,191051,65.9,5965,3.0
Alabama,1977,9,1576145,58.4,1467013,54.3,109132,6.9
Alaska,1977,9,175120,70.3,157589,63.3,17531,10.0
Arizona,1977,9,1056149,60.6,972116,55.8,84033,8.0
Arkansas,1977,9,933994,58.7,874376,55.0,59618,6.4
California,1977,9,10486367,64.0,9645317,58.9,841050,8.0
Los Angeles County,1977,9,3482913,64.4,3210968,59.4,271945,7.8
Colorado,1977,9,1303046,67.2,1222319,63.1,80727,6.2
Connecticut,1977,9,1496356,65.3,1398935,61.0,97421,6.5
Delaware,1977,9,273216,63.5,252281,58.7,20935,7.7
District of Columbia,1977,9,327213,63.9,299049,58.4,28164,8.6
Florida,1977,9,3774005,55.8,3475764,51.4,298241,7.9
Georgia,1977,9,2335763,63.7,2184698,59.6,151065,6.5
Hawaii,1977,9,416900,68.1,386614,63.2,30286,7.3
Idaho,1977,9,403297,65.5,379667,61.6,23630,5.9
Illinois,1977,9,5324424,64.1,4987757,60.1,336667,6.3
Indiana,1977,9,2499543,64.4,2354777,60.7,144766,5.8
Iowa,1977,9,1395638,66.0,1339473,63.4,56165,4.0
Kansas,1977,9,1115774,66.5,1074193,64.0,41581,3.7
Kentucky,1977,9,1548742,60.8,1475727,57.9,73015,4.7
Louisiana,1977,9,1622764,58.2,1509317,54.1,113447,7.0
Maine,1977,9,480787,60.6,442397,55.7,38390,8.0
Maryland,1977,9,1980942,65.1,1865563,61.3,115379,5.8
Massachusetts,1977,9,2765044,64.9,2558216,60.0,206828,7.5
Michigan,1977,9,4144508,63.2,3809417,58.1,335091,8.1
Minnesota,1977,9,1932129,67.3,1835735,63.9,96394,5.0
Mississippi,1977,9,999702,58.9,926468,54.6,73234,7.3
Missouri,1977,9,2224195,62.7,2093817,59.1,130378,5.9
Montana,1977,9,352340,63.6,330260,59.6,22080,6.3
Nebraska,1977,9,745768,66.8,719509,64.4,26259,3.5
Nevada,1977,9,354609,71.1,333479,66.8,21130,6.0
New Hampshire,1977,9,422677,67.0,401053,63.6,21624,5.1
New Jersey,1977,9,3388528,62.2,3092735,56.8,295793,8.7
New Mexico,1977,9,515382,61.0,478359,56.6,37023,7.2
New York,1977,9,7751263,58.5,7072870,53.4,678393,8.8
New York city,1977,9,3054635,54.5,2747754,49.0,306881,10.0
North Carolina,1977,9,2712141,67.0,2558565,63.2,153576,5.7
North Dakota,1977,9,290287,63.8,277221,60.9,13066,4.5
Ohio,1977,9,4855454,62.0,4561572,58.3,293882,6.1
Oklahoma,1977,9,1251478,60.3,1196086,57.6,55392,4.4
Oregon,1977,9,1162221,64.1,1085607,59.9,76614,6.6
Pennsylvania,1977,9,5228259,58.8,4832146,54.3,396113,7.6
Rhode Island,1977,9,451340,63.7,416620,58.8,34720,7.7
South Carolina,1977,9,1331242,64.2,1244269,60.0,86973,6.5
South Dakota,1977,9,318176,65.2,308126,63.1,10050,3.2
Tennessee,1977,9,1949574,60.9,1831288,57.2,118286,6.1
Texas,1977,9,6020049,64.7,5701720,61.3,318329,5.3
Utah,1977,9,549286,63.0,521507,59.8,27779,5.1
Vermont,1977,9,231200,65.5,215539,61.1,15661,6.8
Virginia,1977,9,2420280,65.7,2289959,62.1,130321,5.4
Washington,1977,9,1718677,62.8,1584096,57.9,134581,7.8
West Virginia,1977,9,721931,51.6,672499,48.0,49432,6.8
Wisconsin,1977,9,2192177,65.8,2084487,62.6,107690,4.9
Wyoming,1977,9,198391,67.9,192487,65.9,5904,3.0
Alabama,1977,10,1581419,58.5,1474464,54.5,106955,6.8
Alaska,1977,10,176221,70.5,158336,63.3,17885,10.1
Arizona,1977,10,1056975,60.4,975843,55.8,81132,7.7
Arkansas,1977,10,935888,58.8,876021,55.0,59867,6.4
California,1977,10,10534456,64.2,9703565,59.1,830891,7.9
Los Angeles County,1977,10,3487972,64.4,3218708,59.4,269264,7.7
Colorado,1977,10,1308068,67.3,1226587,63.1,81481,6.2
Connecticut,1977,10,1500513,65.4,1405569,61.3,94944,6.3
Delaware,1977,10,273476,63.5,252930,58.7,20546,7.5
District of Columbia,1977,10,328075,64.2,300241,58.8,27834,8.5
Florida,1977,10,3796283,55.9,3503644,51.6,292639,7.7
Georgia,1977,10,2342992,63.8,2195220,59.8,147772,6.3
Hawaii,1977,10,417401,68.1,387011,63.1,30390,7.3
Idaho,1977,10,405489,65.7,382255,62.0,23234,5.7
Illinois,1977,10,5339074,64.3,5000783,60.2,338291,6.3
Indiana,1977,10,2508606,64.6,2363304,60.8,145302,5.8
Iowa,1977,10,1398887,66.1,1343411,63.5,55476,4.0
Kansas,1977,10,1117972,66.5,1077286,64.1,40686,3.6
Kentucky,1977,10,1554032,60.9,1479553,58.0,74479,4.8
Louisiana,1977,10,1631159,58.4,1514052,54.2,117107,7.2
Maine,1977,10,480822,60.5,443403,55.8,37419,7.8
Maryland,1977,10,1989485,65.3,1874329,61.6,115156,5.8
Massachusetts,1977,10,2769818,64.9,2567545,60.2,202273,7.3
Michigan,1977,10,4155230,63.2,3824989,58.2,330241,7.9
Minnesota,1977,10,1934783,67.3,1841485,64.1,93298,4.8
Mississippi,1977,10,1001705,58.9,928995,54.6,72710,7.3
Missouri,1977,10,2230818,62.9,2102362,59.2,128456,5.8
Montana,1977,10,353485,63.7,331261,59.7,22224,6.3
Nebraska,1977,10,747789,66.9,721021,64.5,26768,3.6
Nevada,1977,10,356553,71.0,336441,67.0,20112,5.6
New Hampshire,1977,10,424067,67.1,403137,63.8,20930,4.9
New Jersey,1977,10,3391462,62.2,3103493,56.9,287969,8.5
New Mexico,1977,10,516682,61.0,480850,56.8,35832,6.9
New York,1977,10,7759503,58.6,7088701,53.5,670802,8.6
New York city,1977,10,3055174,54.6,2749350,49.1,305824,10.0
North Carolina,1977,10,2724034,67.2,2572595,63.5,151439,5.6
North Dakota,1977,10,291055,64.0,278086,61.1,12969,4.5
Ohio,1977,10,4859809,62.0,4570806,58.3,289003,5.9
Oklahoma,1977,10,1255007,60.4,1201790,57.8,53217,4.2
Oregon,1977,10,1167335,64.2,1093045,60.1,74290,6.4
Pennsylvania,1977,10,5234321,58.8,4840769,54.4,393552,7.5
Rhode Island,1977,10,451753,63.7,417781,58.9,33972,7.5
South Carolina,1977,10,1334631,64.3,1249105,60.1,85526,6.4
South Dakota,1977,10,318557,65.3,308635,63.2,9922,3.1
Tennessee,1977,10,1952908,60.9,1835060,57.2,117848,6.0
Texas,1977,10,6050362,64.9,5728897,61.4,321465,5.3
Utah,1977,10,550972,63.0,523813,59.9,27159,4.9
Vermont,1977,10,232510,65.7,216962,61.3,15548,6.7
Virginia,1977,10,2428517,65.7,2297252,62.2,131265,5.4
Washington,1977,10,1725263,62.8,1595302,58.1,129961,7.5
West Virginia,1977,10,723443,51.6,673866,48.1,49577,6.9
Wisconsin,1977,10,2197460,65.9,2089121,62.7,108339,4.9
Wyoming,1977,10,199790,68.2,193906,66.2,5884,2.9
Alabama,1977,11,1587306,58.6,1482145,54.7,105161,6.6
Alaska,1977,11,177332,70.7,158943,63.3,18389,10.4
Arizona,1977,11,1056804,60.2,978885,55.7,77919,7.4
Arkansas,1977,11,936923,58.7,876942,55.0,59981,6.4
California,1977,11,10581258,64.3,9759799,59.3,821459,7.8
Los Angeles County,1977,11,3493820,64.4,3227373,59.5,266447,7.6
Colorado,1977,11,1313067,67.3,1231098,63.1,81969,6.2
Connecticut,1977,11,1502919,65.5,1410727,61.4,92192,6.1
Delaware,1977,11,273690,63.5,253473,58.8,20217,7.4
District of Columbia,1977,11,329110,64.4,301677,59.0,27433,8.3
Florida,1977,11,3817877,56.1,3531189,51.9,286688,7.5
Georgia,1977,11,2349801,63.9,2206064,60.0,143737,6.1
Hawaii,1977,11,417787,67.9,387400,63.0,30387,7.3
Idaho,1977,11,407144,65.8,384429,62.1,22715,5.6
Illinois,1977,11,5353609,64.4,5014697,60.3,338912,6.3
Indiana,1977,11,2518474,64.7,2372642,61.0,145832,5.8
Iowa,1977,11,1400861,66.1,1345838,63.5,55023,3.9
Kansas,1977,11,1119892,66.5,1080023,64.2,39869,3.6
Kentucky,1977,11,1559259,61.0,1483273,58.1,75986,4.9
Louisiana,1977,11,1640001,58.6,1519251,54.3,120750,7.4
Maine,1977,11,480614,60.4,444382,55.8,36232,7.5
Maryland,1977,11,1997911,65.5,1882607,61.7,115304,5.8
Massachusetts,1977,11,2775507,65.0,2578383,60.4,197124,7.1
Michigan,1977,11,4162300,63.3,3839810,58.4,322490,7.7
Minnesota,1977,11,1937923,67.3,1848243,64.2,89680,4.6
Mississippi,1977,11,1003627,58.9,931592,54.7,72035,7.2
Missouri,1977,11,2237042,63.0,2109927,59.4,127115,5.7
Montana,1977,11,354633,63.8,332320,59.8,22313,6.3
Nebraska,1977,11,749481,67.0,722182,64.5,27299,3.6
Nevada,1977,11,358473,71.0,339372,67.2,19101,5.3
New Hampshire,1977,11,425079,67.0,404887,63.9,20192,4.8
New Jersey,1977,11,3394599,62.2,3115244,57.1,279355,8.2
New Mexico,1977,11,517854,61.0,483363,56.9,34491,6.7
New York,1977,11,7764199,58.6,7103182,53.6,661017,8.5
New York city,1977,11,3054758,54.6,2751768,49.2,302990,9.9
North Carolina,1977,11,2733262,67.3,2585436,63.7,147826,5.4
North Dakota,1977,11,291687,64.0,278870,61.2,12817,4.4
Ohio,1977,11,4860487,62.0,4576604,58.4,283883,5.8
Oklahoma,1977,11,1257863,60.4,1206136,57.9,51727,4.1
Oregon,1977,11,1172334,64.3,1100479,60.3,71855,6.1
Pennsylvania,1977,11,5240358,58.9,4849324,54.5,391034,7.5
Rhode Island,1977,11,451501,63.6,418412,58.9,33089,7.3
South Carolina,1977,11,1337576,64.2,1254195,60.2,83381,6.2
South Dakota,1977,11,318841,65.3,309048,63.3,9793,3.1
Tennessee,1977,11,1953442,60.8,1836283,57.1,117159,6.0
Texas,1977,11,6077074,65.0,5754302,61.5,322772,5.3
Utah,1977,11,552802,63.0,526278,60.0,26524,4.8
Vermont,1977,11,233493,65.8,218143,61.4,15350,6.6
Virginia,1977,11,2435033,65.8,2303075,62.2,131958,5.4
Washington,1977,11,1732731,62.9,1607216,58.3,125515,7.2
West Virginia,1977,11,725206,51.7,675508,48.2,49698,6.9
Wisconsin,1977,11,2203714,66.0,2095181,62.8,108533,4.9
Wyoming,1977,11,201196,68.4,195319,66.4,5877,2.9
Alabama,1977,12,1593178,58.7,1489366,54.9,103812,6.5
Alaska,1977,12,178335,71.0,159372,63.5,18963,10.6
Arizona,1977,12,1056575,59.9,981858,55.7,74717,7.1
Arkansas,1977,12,937455,58.7,877620,54.9,59835,6.4
California,1977,12,10627337,64.4,9812886,59.5,814451,7.7
Los Angeles County,1977,12,3501463,64.4,3237287,59.6,264176,7.5
Colorado,1977,12,1318028,67.4,1236006,63.2,82022,6.2
Connecticut,1977,12,1503090,65.4,1413652,61.5,89438,6.0
Delaware,1977,12,273850,63.4,253892,58.8,19958,7.3
District of Columbia,1977,12,330064,64.6,302996,59.3,27068,8.2
Florida,1977,12,3838156,56.2,3557099,52.1,281057,7.3
Georgia,1977,12,2355973,63.9,2216406,60.1,139567,5.9
Hawaii,1977,12,417968,67.9,387725,62.9,30243,7.2
Idaho,1977,12,408347,65.8,386130,62.2,22217,5.4
Illinois,1977,12,5367032,64.5,5027450,60.4,339582,6.3
Indiana,1977,12,2528228,64.9,2381677,61.1,146551,5.8
Iowa,1977,12,1401483,66.1,1346396,63.5,55087,3.9
Kansas,1977,12,1121666,66.6,1082489,64.2,39177,3.5
Kentucky,1977,12,1563514,61.1,1486288,58.1,77226,4.9
Louisiana,1977,12,1648535,58.8,1524704,54.4,123831,7.5
Maine,1977,12,480174,60.2,445196,55.9,34978,7.3
Maryland,1977,12,2005674,65.7,1889956,61.9,115718,5.8
Massachusetts,1977,12,2781537,65.1,2589633,60.6,191904,6.9
Michigan,1977,12,4166986,63.3,3853518,58.5,313468,7.5
Minnesota,1977,12,1941683,67.3,1855715,64.4,85968,4.4
Mississippi,1977,12,1005225,59.0,933739,54.8,71486,7.1
Missouri,1977,12,2242850,63.1,2116444,59.5,126406,5.6
Montana,1977,12,355847,63.9,333523,59.9,22324,6.3
Nebraska,1977,12,750719,67.0,723036,64.6,27683,3.7
Nevada,1977,12,360338,70.9,342151,67.4,18187,5.0
New Hampshire,1977,12,425762,66.9,406303,63.9,19459,4.6
New Jersey,1977,12,3397725,62.2,3126825,57.2,270900,8.0
New Mexico,1977,12,519107,61.0,485758,57.1,33349,6.4
New York,1977,12,7766972,58.6,7116749,53.7,650223,8.4
New York city,1977,12,3053551,54.6,2754761,49.3,298790,9.8
North Carolina,1977,12,2739356,67.4,2596123,63.8,143233,5.2
North Dakota,1977,12,292125,64.1,279475,61.3,12650,4.3
Ohio,1977,12,4859590,61.9,4579781,58.3,279809,5.8
Oklahoma,1977,12,1259989,60.4,1209139,57.9,50850,4.0
Oregon,1977,12,1177161,64.4,1107507,60.6,69654,5.9
Pennsylvania,1977,12,5245827,58.9,4856853,54.5,388974,7.4
Rhode Island,1977,12,450684,63.5,418563,59.0,32121,7.1
South Carolina,1977,12,1339831,64.2,1259101,60.3,80730,6.0
South Dakota,1977,12,319028,65.4,309376,63.4,9652,3.0
Tennessee,1977,12,1951796,60.6,1835421,57.0,116375,6.0
Texas,1977,12,6098267,65.1,5776455,61.6,321812,5.3
Utah,1977,12,554702,63.0,528754,60.1,25948,4.7
Vermont,1977,12,234132,66.0,219062,61.7,15070,6.4
Virginia,1977,12,2440406,65.8,2307939,62.2,132467,5.4
Washington,1977,12,1741347,63.0,1619321,58.6,122026,7.0
West Virginia,1977,12,726699,51.8,677101,48.2,49598,6.8
Wisconsin,1977,12,2210293,66.2,2101771,62.9,108522,4.9
Wyoming,1977,12,202538,68.4,196708,66.5,5830,2.9
Alabama,1978,1,1598628,58.8,1495923,55.0,102705,6.4
Alaska,1978,1,179245,71.1,159746,63.4,19499,10.9
Arizona,1978,1,1056990,59.7,985414,55.7,71576,6.8
Arkansas,1978,1,937964,58.6,878647,54.9,59317,6.3
California,1978,1,10673813,64.5,9864666,59.6,809147,7.6
Los Angeles County,1978,1,3510977,64.5,3248508,59.7,262469,7.5
Colorado,1978,1,1323160,67.5,1241466,63.3,81694,6.2
Connecticut,1978,1,1501705,65.3,1414927,61.5,86778,5.8
Delaware,1978,1,273982,63.4,254265,58.9,19717,7.2
District of Columbia,1978,1,330733,64.7,303985,59.5,26748,8.1
Florida,1978,1,3857700,56.3,3581959,52.3,275741,7.1
Georgia,1978,1,2361935,64.0,2226250,60.3,135685,5.7
Hawaii,1978,1,417915,67.7,388005,62.9,29910,7.2
Idaho,1978,1,409286,65.7,387496,62.2,21790,5.3
Illinois,1978,1,5378828,64.6,5038963,60.5,339865,6.3
Indiana,1978,1,2536828,65.0,2389946,61.2,146882,5.8
Iowa,1978,1,1401720,66.1,1346260,63.5,55460,4.0
Kansas,1978,1,1123568,66.6,1085131,64.3,38437,3.4
Kentucky,1978,1,1566520,61.1,1488643,58.1,77877,5.0
Louisiana,1978,1,1655767,59.0,1530108,54.5,125659,7.6
Maine,1978,1,479688,60.0,445987,55.8,33701,7.0
Maryland,1978,1,2012589,65.9,1896862,62.1,115727,5.8
Massachusetts,1978,1,2787287,65.2,2600479,60.8,186808,6.7
Michigan,1978,1,4170914,63.3,3866733,58.6,304181,7.3
Minnesota,1978,1,1946032,67.4,1863538,64.5,82494,4.2
Mississippi,1978,1,1006366,58.9,935360,54.8,71006,7.1
Missouri,1978,1,2247827,63.1,2122559,59.6,125268,5.6
Montana,1978,1,357075,63.9,334914,59.9,22161,6.2
Nebraska,1978,1,751478,67.0,723859,64.6,27619,3.7
Nevada,1978,1,362135,70.9,344783,67.5,17352,4.8
New Hampshire,1978,1,426389,66.8,407655,63.9,18734,4.4
New Jersey,1978,1,3401169,62.2,3137878,57.4,263291,7.7
New Mexico,1978,1,520554,61.0,487990,57.1,32564,6.3
New York,1978,1,7770273,58.7,7131276,53.8,638997,8.2
New York city,1978,1,3052301,54.6,2758836,49.4,293465,9.6
North Carolina,1978,1,2742962,67.3,2604759,63.9,138203,5.0
North Dakota,1978,1,292435,64.1,279974,61.4,12461,4.3
Ohio,1978,1,4861374,61.9,4584851,58.4,276523,5.7
Oklahoma,1978,1,1261708,60.4,1211724,58.0,49984,4.0
Oregon,1978,1,1181956,64.4,1114069,60.7,67887,5.7
Pennsylvania,1978,1,5251023,58.9,4864770,54.6,386253,7.4
Rhode Island,1978,1,449681,63.2,418504,58.9,31177,6.9
South Carolina,1978,1,1341655,64.1,1263749,60.4,77906,5.8
South Dakota,1978,1,319220,65.3,309733,63.3,9487,3.0
Tennessee,1978,1,1950231,60.5,1834880,56.9,115351,5.9
Texas,1978,1,6115243,65.1,5796759,61.7,318484,5.2
Utah,1978,1,556616,63.1,531279,60.2,25337,4.6
Vermont,1978,1,234551,65.9,219841,61.8,14710,6.3
Virginia,1978,1,2446221,65.8,2313616,62.3,132605,5.4
Washington,1978,1,1751416,63.2,1631692,58.8,119724,6.8
West Virginia,1978,1,727585,51.8,678608,48.3,48977,6.7
Wisconsin,1978,1,2216473,66.3,2108384,63.0,108089,4.9
Wyoming,1978,1,203809,68.6,198061,66.7,5748,2.8
Alabama,1978,2,1603342,58.8,1501651,55.1,101691,6.3
Alaska,1978,2,180057,71.2,160171,63.3,19886,11.0
Arizona,1978,2,1058641,59.6,989740,55.7,68901,6.5
Arkansas,1978,2,938787,58.5,880204,54.9,58583,6.2
California,1978,2,10722565,64.7,9916934,59.8,805631,7.5
Los Angeles County,1978,2,3522721,64.6,3261325,59.8,261396,7.4
Colorado,1978,2,1328600,67.5,1247521,63.4,81079,6.1
Connecticut,1978,2,1500367,65.1,1415964,61.5,84403,5.6
Delaware,1978,2,274220,63.3,254704,58.8,19516,7.1
District of Columbia,1978,2,331194,64.9,304674,59.7,26520,8.0
Florida,1978,2,3878267,56.5,3606773,52.5,271494,7.0
Georgia,1978,2,2368666,64.0,2235798,60.4,132868,5.6
Hawaii,1978,2,417797,67.6,388302,62.8,29495,7.1
Idaho,1978,2,410157,65.7,388687,62.3,21470,5.2
Illinois,1978,2,5389045,64.6,5049961,60.6,339084,6.3
Indiana,1978,2,2544422,65.1,2397765,61.4,146657,5.8
Iowa,1978,2,1402808,66.1,1346932,63.4,55876,4.0
Kansas,1978,2,1125697,66.6,1088184,64.4,37513,3.3
Kentucky,1978,2,1568631,61.1,1490603,58.1,78028,5.0
Louisiana,1978,2,1661051,59.0,1535121,54.6,125930,7.6
Maine,1978,2,479514,59.9,447081,55.9,32433,6.8
Maryland,1978,2,2019169,66.0,1903925,62.2,115244,5.7
Massachusetts,1978,2,2792964,65.2,2610674,61.0,182290,6.5
Michigan,1978,2,4175740,63.3,3879701,58.8,296039,7.1
Minnesota,1978,2,1950724,67.5,1871091,64.7,79633,4.1
Mississippi,1978,2,1007101,58.9,936438,54.7,70663,7.0
Missouri,1978,2,2251933,63.2,2128735,59.7,123198,5.5
Montana,1978,2,358433,64.0,336613,60.1,21820,6.1
Nebraska,1978,2,751843,66.9,724839,64.5,27004,3.6
Nevada,1978,2,363893,70.7,347265,67.4,16628,4.6
New Hampshire,1978,2,427342,66.8,409241,63.9,18101,4.2
New Jersey,1978,2,3405968,62.2,3148547,57.5,257421,7.6
New Mexico,1978,2,522145,61.0,490061,57.3,32084,6.1
New York,1978,2,7776274,58.7,7147465,54.0,628809,8.1
New York city,1978,2,3052029,54.7,2764189,49.5,287840,9.4
North Carolina,1978,2,2745056,67.2,2611930,64.0,133126,4.8
North Dakota,1978,2,292761,64.1,280491,61.4,12270,4.2
Ohio,1978,2,4869671,61.9,4595746,58.4,273925,5.6
Oklahoma,1978,2,1263307,60.3,1214527,58.0,48780,3.9
Oregon,1978,2,1186991,64.5,1120038,60.9,66953,5.6
Pennsylvania,1978,2,5257244,59.0,4874749,54.7,382495,7.3
Rhode Island,1978,2,448858,63.0,418571,58.8,30287,6.7
South Carolina,1978,2,1343779,64.1,1268079,60.5,75700,5.6
South Dakota,1978,2,319561,65.3,310189,63.4,9372,2.9
Tennessee,1978,2,1951302,60.4,1837108,56.9,114194,5.9
Texas,1978,2,6131558,65.1,5817873,61.7,313685,5.1
Utah,1978,2,558472,63.1,533863,60.3,24609,4.4
Vermont,1978,2,234976,65.8,220645,61.8,14331,6.1
Virginia,1978,2,2453725,65.9,2321340,62.3,132385,5.4
Washington,1978,2,1762917,63.4,1644406,59.1,118511,6.7
West Virginia,1978,2,727903,51.8,680152,48.4,47751,6.6
Wisconsin,1978,2,2222152,66.4,2114828,63.1,107324,4.8
Wyoming,1978,2,205022,68.8,199341,66.9,5681,2.8
Alabama,1978,3,1607107,58.9,1506400,55.2,100707,6.3
Alaska,1978,3,180709,71.4,160654,63.5,20055,11.1
Arizona,1978,3,1061837,59.6,995104,55.8,66733,6.3
Arkansas,1978,3,940085,58.5,882240,54.9,57845,6.2
California,1978,3,10773803,64.8,9969880,60.0,803923,7.5
Los Angeles County,1978,3,3536517,64.8,3276011,60.0,260506,7.4
Colorado,1978,3,1334471,67.6,1254233,63.6,80238,6.0
Connecticut,1978,3,1500230,65.1,1417714,61.5,82516,5.5
Delaware,1978,3,274710,63.4,255275,59.0,19435,7.1
District of Columbia,1978,3,331608,65.0,305195,59.8,26413,8.0
Florida,1978,3,3900271,56.6,3631188,52.7,269083,6.9
Georgia,1978,3,2377142,64.1,2245222,60.6,131920,5.5
Hawaii,1978,3,417964,67.5,388731,62.8,29233,7.0
Idaho,1978,3,411281,65.7,389964,62.3,21317,5.2
Illinois,1978,3,5398095,64.7,5060566,60.6,337529,6.3
Indiana,1978,3,2552406,65.2,2406614,61.5,145792,5.7
Iowa,1978,3,1405578,66.2,1349695,63.5,55883,4.0
Kansas,1978,3,1128019,66.7,1091567,64.6,36452,3.2
Kentucky,1978,3,1570484,61.1,1492542,58.1,77942,5.0
Louisiana,1978,3,1664387,59.1,1539828,54.6,124559,7.5
Maine,1978,3,479938,59.9,448590,56.0,31348,6.5
Maryland,1978,3,2026131,66.1,1911487,62.4,114644,5.7
Massachusetts,1978,3,2798679,65.3,2619923,61.1,178756,6.4
Michigan,1978,3,4182308,63.3,3891561,58.9,290747,7.0
Minnesota,1978,3,1955574,67.6,1877904,64.9,77670,4.0
Mississippi,1978,3,1007621,58.8,937045,54.7,70576,7.0
Missouri,1978,3,2255306,63.2,2134971,59.8,120335,5.3
Montana,1978,3,360035,64.2,338639,60.4,21396,5.9
Nebraska,1978,3,751970,66.9,726016,64.6,25954,3.5
Nevada,1978,3,365735,70.6,349657,67.5,16078,4.4
New Hampshire,1978,3,428814,66.8,411179,64.0,17635,4.1
New Jersey,1978,3,3413414,62.3,3159610,57.7,253804,7.4
New Mexico,1978,3,523955,61.1,492089,57.4,31866,6.1
New York,1978,3,7786471,58.8,7165251,54.1,621220,8.0
New York city,1978,3,3052822,54.7,2770144,49.7,282678,9.3
North Carolina,1978,3,2746468,67.2,2617826,64.0,128642,4.7
North Dakota,1978,3,293232,64.2,281130,61.5,12102,4.1
Ohio,1978,3,4885448,62.1,4613039,58.6,272409,5.6
Oklahoma,1978,3,1264771,60.3,1217678,58.0,47093,3.7
Oregon,1978,3,1192356,64.7,1125393,61.0,66963,5.6
Pennsylvania,1978,3,5265346,59.0,4887426,54.8,377920,7.2
Rhode Island,1978,3,448388,63.0,418939,58.8,29449,6.6
South Carolina,1978,3,1347167,64.1,1272249,60.5,74918,5.6
South Dakota,1978,3,320194,65.5,310753,63.5,9441,2.9
Tennessee,1978,3,1956274,60.5,1843002,57.0,113272,5.8
Texas,1978,3,6150322,65.1,5841570,61.8,308752,5.0
Utah,1978,3,560293,63.1,536568,60.4,23725,4.2
Vermont,1978,3,235573,66.0,221563,62.1,14010,5.9
Virginia,1978,3,2463260,66.0,2331195,62.5,132065,5.4
Washington,1978,3,1775497,63.6,1657177,59.4,118320,6.7
West Virginia,1978,3,728061,51.7,681907,48.4,46154,6.3
Wisconsin,1978,3,2227663,66.5,2120948,63.3,106715,4.8
Wyoming,1978,3,206215,68.7,200541,66.8,5674,2.8
Alabama,1978,4,1610270,58.9,1510271,55.2,99999,6.2
Alaska,1978,4,181209,71.3,161171,63.5,20038,11.1
Arizona,1978,4,1066144,59.6,1001458,55.9,64686,6.1
Arkansas,1978,4,941983,58.5,884710,55.0,57273,6.1
California,1978,4,10825396,65.0,10023312,60.1,802084,7.4
Los Angeles County,1978,4,3552136,65.0,3293475,60.2,258661,7.3
Colorado,1978,4,1340464,67.7,1261301,63.7,79163,5.9
Connecticut,1978,4,1501549,65.1,1420464,61.6,81085,5.4
Delaware,1978,4,275507,63.5,256031,59.0,19476,7.1
District of Columbia,1978,4,331980,65.1,305628,59.9,26352,7.9
Florida,1978,4,3922808,56.8,3654670,52.9,268138,6.8
Georgia,1978,4,2387496,64.3,2254504,60.7,132992,5.6
Hawaii,1978,4,418653,67.5,389373,62.8,29280,7.0
Idaho,1978,4,412772,65.7,391365,62.3,21407,5.2
Illinois,1978,4,5405730,64.7,5070632,60.7,335098,6.2
Indiana,1978,4,2561882,65.4,2417503,61.7,144379,5.6
Iowa,1978,4,1410018,66.3,1354819,63.7,55199,3.9
Kansas,1978,4,1130364,66.8,1095042,64.7,35322,3.1
Kentucky,1978,4,1572319,61.1,1494528,58.1,77791,4.9
Louisiana,1978,4,1666219,59.0,1544372,54.7,121847,7.3
Maine,1978,4,481003,60.0,450390,56.2,30613,6.4
Maryland,1978,4,2033530,66.3,1919446,62.6,114084,5.6
Massachusetts,1978,4,2803770,65.4,2627721,61.3,176049,6.3
Michigan,1978,4,4190589,63.3,3901892,59.0,288697,6.9
Minnesota,1978,4,1960744,67.7,1884183,65.0,76561,3.9
Mississippi,1978,4,1008133,58.7,937539,54.6,70594,7.0
Missouri,1978,4,2257911,63.2,2140957,59.9,116954,5.2
Montana,1978,4,361683,64.4,340721,60.6,20962,5.8
Nebraska,1978,4,751868,66.8,727277,64.6,24591,3.3
Nevada,1978,4,367713,70.6,351989,67.6,15724,4.3
New Hampshire,1978,4,430756,67.0,413458,64.3,17298,4.0
New Jersey,1978,4,3423894,62.4,3171940,57.8,251954,7.4
New Mexico,1978,4,526156,61.2,494191,57.5,31965,6.1
New York,1978,4,7800480,58.9,7184303,54.2,616177,7.9
New York city,1978,4,3054195,54.8,2775954,49.8,278241,9.1
North Carolina,1978,4,2748872,67.1,2623674,64.1,125198,4.6
North Dakota,1978,4,293831,64.2,281867,61.5,11964,4.1
Ohio,1978,4,4906798,62.3,4634840,58.8,271958,5.5
Oklahoma,1978,4,1265648,60.2,1220869,58.1,44779,3.5
Oregon,1978,4,1198044,64.8,1130299,61.1,67745,5.7
Pennsylvania,1978,4,5275090,59.1,4902442,54.9,372648,7.1
Rhode Island,1978,4,448405,62.9,419659,58.9,28746,6.4
South Carolina,1978,4,1351655,64.2,1276103,60.6,75552,5.6
South Dakota,1978,4,321066,65.7,311368,63.7,9698,3.0
Tennessee,1978,4,1964022,60.6,1851012,57.1,113010,5.8
Texas,1978,4,6171665,65.2,5867132,62.0,304533,4.9
Utah,1978,4,562105,63.2,539408,60.6,22697,4.0
Vermont,1978,4,236338,66.0,222587,62.2,13751,5.8
Virginia,1978,4,2473990,66.2,2342156,62.6,131834,5.3
Washington,1978,4,1787791,63.8,1668751,59.6,119040,6.7
West Virginia,1978,4,728559,51.7,683818,48.5,44741,6.1
Wisconsin,1978,4,2233194,66.5,2126801,63.4,106393,4.8
Wyoming,1978,4,207414,68.9,201662,67.0,5752,2.8
Alabama,1978,5,1613550,58.9,1513699,55.3,99851,6.2
Alaska,1978,5,181554,71.2,161664,63.4,19890,11.0
Arizona,1978,5,1071375,59.6,1008536,56.1,62839,5.9
Arkansas,1978,5,944470,58.6,887385,55.0,57085,6.0
California,1978,5,10875201,65.1,10076881,60.3,798320,7.3
Los Angeles County,1978,5,3569967,65.2,3314839,60.5,255128,7.1
Colorado,1978,5,1346240,67.8,1268450,63.9,77790,5.8
Connecticut,1978,5,1504068,65.1,1424056,61.6,80012,5.3
Delaware,1978,5,276587,63.7,257009,59.2,19578,7.1
District of Columbia,1978,5,332281,65.2,306021,60.0,26260,7.9
Florida,1978,5,3945035,56.9,3677009,53.0,268026,6.8
Georgia,1978,5,2398968,64.5,2263497,60.8,135471,5.6
Hawaii,1978,5,419820,67.5,390231,62.7,29589,7.0
Idaho,1978,5,414435,65.8,392696,62.3,21739,5.2
Illinois,1978,5,5412839,64.8,5081049,60.8,331790,6.1
Indiana,1978,5,2573041,65.6,2430244,61.9,142797,5.5
Iowa,1978,5,1415307,66.5,1361285,64.0,54022,3.8
Kansas,1978,5,1132531,66.8,1098347,64.8,34184,3.0
Kentucky,1978,5,1574332,61.1,1496406,58.1,77926,4.9
Louisiana,1978,5,1667218,59.0,1548841,54.8,118377,7.1
Maine,1978,5,482573,60.0,452281,56.3,30292,6.3
Maryland,1978,5,2041147,66.4,1927577,62.7,113570,5.6
Massachusetts,1978,5,2808122,65.4,2634179,61.4,173943,6.2
Michigan,1978,5,4200277,63.4,3911070,59.0,289207,6.9
Minnesota,1978,5,1966662,67.8,1890523,65.1,76139,3.9
Mississippi,1978,5,1008966,58.7,938434,54.6,70532,7.0
Missouri,1978,5,2259982,63.2,2146530,60.0,113452,5.0
Montana,1978,5,363333,64.4,342793,60.8,20540,5.7
Nebraska,1978,5,751657,66.8,728608,64.7,23049,3.1
Nevada,1978,5,369854,70.6,354273,67.6,15581,4.2
New Hampshire,1978,5,432987,67.1,415946,64.5,17041,3.9
New Jersey,1978,5,3437219,62.6,3186114,58.0,251105,7.3
New Mexico,1978,5,528659,61.3,496363,57.5,32296,6.1
New York,1978,5,7817720,59.0,7204757,54.4,612963,7.8
New York city,1978,5,3056271,54.9,2781380,50.0,274891,9.0
North Carolina,1978,5,2753904,67.1,2630814,64.1,123090,4.5
North Dakota,1978,5,294459,64.3,282598,61.7,11861,4.0
Ohio,1978,5,4930395,62.5,4658453,59.1,271942,5.5
Oklahoma,1978,5,1265907,60.1,1223885,58.1,42022,3.3
Oregon,1978,5,1203952,64.9,1134701,61.2,69251,5.8
Pennsylvania,1978,5,5286307,59.2,4918457,55.1,367850,7.0
Rhode Island,1978,5,448824,62.9,420617,58.9,28207,6.3
South Carolina,1978,5,1356617,64.3,1279689,60.6,76928,5.7
South Dakota,1978,5,322031,65.7,311977,63.7,10054,3.1
Tennessee,1978,5,1972218,60.8,1858500,57.3,113718,5.8
Texas,1978,5,6194406,65.2,5892873,62.1,301533,4.9
Utah,1978,5,564046,63.2,542364,60.7,21682,3.8
Vermont,1978,5,237161,66.1,223630,62.3,13531,5.7
Virginia,1978,5,2484164,66.3,2352600,62.8,131564,5.3
Washington,1978,5,1798853,64.0,1678413,59.8,120440,6.7
West Virginia,1978,5,729823,51.8,685824,48.6,43999,6.0
Wisconsin,1978,5,2239416,66.6,2132958,63.5,106458,4.8
Wyoming,1978,5,208622,69.1,202714,67.1,5908,2.8
Alabama,1978,6,1617496,58.9,1517187,55.3,100309,6.2
Alaska,1978,6,181747,71.3,162101,63.6,19646,10.8
Arizona,1978,6,1077443,59.8,1016059,56.4,61384,5.7
Arkansas,1978,6,947133,58.6,889782,55.1,57351,6.1
California,1978,6,10918582,65.2,10128069,60.5,790513,7.2
Los Angeles County,1978,6,3588196,65.4,3338587,60.9,249609,7.0
Colorado,1978,6,1351735,67.9,1275809,64.1,75926,5.6
Connecticut,1978,6,1507105,65.2,1428056,61.8,79049,5.2
Delaware,1978,6,277656,63.8,258013,59.3,19643,7.1
District of Columbia,1978,6,332492,65.3,306430,60.2,26062,7.8
Florida,1978,6,3965759,57.0,3698065,53.2,267694,6.8
Georgia,1978,6,2409887,64.7,2271819,61.0,138068,5.7
Hawaii,1978,6,421208,67.6,391316,62.8,29892,7.1
Idaho,1978,6,415928,65.9,393728,62.4,22200,5.3
Illinois,1978,6,5420516,64.8,5093233,60.9,327283,6.0
Indiana,1978,6,2584575,65.8,2443163,62.2,141412,5.5
Iowa,1978,6,1420083,66.7,1367402,64.2,52681,3.7
Kansas,1978,6,1134426,66.8,1101281,64.9,33145,2.9
Kentucky,1978,6,1576429,61.1,1498063,58.1,78366,5.0
Louisiana,1978,6,1667912,58.9,1553153,54.8,114759,6.9
Maine,1978,6,484340,60.2,454112,56.4,30228,6.2
Maryland,1978,6,2048180,66.6,1935339,62.9,112841,5.5
Massachusetts,1978,6,2811794,65.5,2639849,61.5,171945,6.1
Michigan,1978,6,4210324,63.5,3919596,59.1,290728,6.9
Minnesota,1978,6,1973159,67.9,1897164,65.3,75995,3.9
Mississippi,1978,6,1010092,58.7,940087,54.6,70005,6.9
Missouri,1978,6,2261750,63.2,2151608,60.1,110142,4.9
Montana,1978,6,364964,64.6,344819,61.0,20145,5.5
Nebraska,1978,6,751432,66.7,729952,64.8,21480,2.9
Nevada,1978,6,372141,70.6,356515,67.6,15626,4.2
New Hampshire,1978,6,435186,67.3,418396,64.7,16790,3.9
New Jersey,1978,6,3452625,62.8,3202523,58.3,250102,7.2
New Mexico,1978,6,531120,61.4,498481,57.6,32639,6.1
New York,1978,6,7835746,59.1,7226363,54.5,609383,7.8
New York city,1978,6,3058314,55.0,2786035,50.1,272279,8.9
North Carolina,1978,6,2761126,67.2,2639080,64.2,122046,4.4
North Dakota,1978,6,295016,64.3,283212,61.7,11804,4.0
Ohio,1978,6,4952204,62.8,4680784,59.3,271420,5.5
Oklahoma,1978,6,1265963,60.0,1226564,58.1,39399,3.1
Oregon,1978,6,1209727,65.0,1138430,61.2,71297,5.9
Pennsylvania,1978,6,5297581,59.3,4933262,55.2,364319,6.9
Rhode Island,1978,6,449425,62.9,421597,59.0,27828,6.2
South Carolina,1978,6,1360925,64.3,1282952,60.6,77973,5.7
South Dakota,1978,6,322913,65.9,312537,63.8,10376,3.2
Tennessee,1978,6,1979214,60.9,1864255,57.4,114959,5.8
Texas,1978,6,6217251,65.3,5917371,62.2,299880,4.8
Utah,1978,6,566267,63.3,545443,60.9,20824,3.7
Vermont,1978,6,237893,66.3,224570,62.6,13323,5.6
Virginia,1978,6,2491918,66.4,2360942,62.9,130976,5.3
Washington,1978,6,1808520,64.2,1686847,59.9,121673,6.7
West Virginia,1978,6,731978,51.8,687958,48.7,44020,6.0
Wisconsin,1978,6,2246528,66.8,2139676,63.6,106852,4.8
Wyoming,1978,6,209832,69.0,203748,67.0,6084,2.9
Alabama,1978,7,1622316,59.0,1520668,55.3,101648,6.3
Alaska,1978,7,181963,71.1,162538,63.5,19425,10.7
Arizona,1978,7,1083840,59.9,1023252,56.5,60588,5.6
Arkansas,1978,7,949586,58.7,891556,55.1,58030,6.1
California,1978,7,10953156,65.2,10173539,60.6,779617,7.1
Los Angeles County,1978,7,3605263,65.6,3362253,61.2,243010,6.7
Colorado,1978,7,1356935,67.9,1282962,64.2,73973,5.5
Connecticut,1978,7,1510340,65.3,1432107,61.9,78233,5.2
Delaware,1978,7,278411,64.0,258761,59.5,19650,7.1
District of Columbia,1978,7,332618,65.3,306854,60.3,25764,7.7
Florida,1978,7,3984312,57.1,3717463,53.3,266849,6.7
Georgia,1978,7,2418937,64.8,2279013,61.0,139924,5.8
Hawaii,1978,7,422532,67.7,392547,62.9,29985,7.1
Idaho,1978,7,416874,65.9,394138,62.3,22736,5.5
Illinois,1978,7,5429310,64.8,5106550,61.0,322760,5.9
Indiana,1978,7,2594992,66.0,2454315,62.4,140677,5.4
Iowa,1978,7,1423737,66.8,1371805,64.4,51932,3.6
Kansas,1978,7,1136149,66.9,1103652,65.0,32497,2.9
Kentucky,1978,7,1578742,61.1,1499614,58.0,79128,5.0
Louisiana,1978,7,1668777,58.8,1557268,54.9,111509,6.7
Maine,1978,7,486127,60.3,455807,56.6,30320,6.2
Maryland,1978,7,2054433,66.7,1941983,63.1,112450,5.5
Massachusetts,1978,7,2814916,65.5,2644777,61.5,170139,6.0
Michigan,1978,7,4220681,63.6,3927787,59.2,292894,6.9
Minnesota,1978,7,1979619,68.1,1903597,65.4,76022,3.8
Mississippi,1978,7,1011334,58.7,942286,54.7,69048,6.8
Missouri,1978,7,2263551,63.1,2155973,60.1,107578,4.8
Montana,1978,7,366346,64.7,346542,61.2,19804,5.4
Nebraska,1978,7,751279,66.6,731028,64.8,20251,2.7
Nevada,1978,7,374448,70.7,358612,67.7,15836,4.2
New Hampshire,1978,7,436999,67.3,420495,64.8,16504,3.8
New Jersey,1978,7,3468421,63.1,3219635,58.5,248786,7.2
New Mexico,1978,7,533222,61.5,500334,57.7,32888,6.2
New York,1978,7,7852829,59.3,7248347,54.7,604482,7.7
New York city,1978,7,3059865,55.1,2789656,50.2,270209,8.8
North Carolina,1978,7,2768607,67.2,2646649,64.3,121958,4.4
North Dakota,1978,7,295488,64.4,283607,61.8,11881,4.0
Ohio,1978,7,4969977,62.9,4699650,59.5,270327,5.4
Oklahoma,1978,7,1266385,59.9,1228673,58.1,37712,3.0
Oregon,1978,7,1214955,65.1,1141414,61.2,73541,6.1
Pennsylvania,1978,7,5308359,59.4,4945380,55.3,362979,6.8
Rhode Island,1978,7,450021,62.9,422448,59.1,27573,6.1
South Carolina,1978,7,1363445,64.3,1285513,60.6,77932,5.7
South Dakota,1978,7,323589,66.0,312987,63.9,10602,3.3
Tennessee,1978,7,1984030,61.0,1867909,57.4,116121,5.9
Texas,1978,7,6239448,65.4,5938904,62.2,300544,4.8
Utah,1978,7,568765,63.3,548490,61.1,20275,3.6
Vermont,1978,7,238495,66.2,225353,62.6,13142,5.5
Virginia,1978,7,2496548,66.4,2366272,62.9,130276,5.2
Washington,1978,7,1817401,64.3,1694504,59.9,122897,6.8
West Virginia,1978,7,734872,52.0,690151,48.8,44721,6.1
Wisconsin,1978,7,2254545,67.0,2146518,63.8,108027,4.8
Wyoming,1978,7,211008,69.2,204763,67.1,6245,3.0
Alabama,1978,8,1627501,59.1,1523802,55.4,103699,6.4
Alaska,1978,8,182268,71.2,163024,63.7,19244,10.6
Arizona,1978,8,1090443,59.9,1029612,56.6,60831,5.6
Arkansas,1978,8,951771,58.7,892807,55.1,58964,6.2
California,1978,8,10981764,65.3,10213361,60.7,768403,7.0
Los Angeles County,1978,8,3620984,65.8,3384206,61.5,236778,6.5
Colorado,1978,8,1361997,68.0,1289908,64.4,72089,5.3
Connecticut,1978,8,1514160,65.4,1436417,62.0,77743,5.1
Delaware,1978,8,278855,64.1,259201,59.6,19654,7.0
District of Columbia,1978,8,332702,65.5,307214,60.5,25488,7.7
Florida,1978,8,4001454,57.2,3735248,53.4,266206,6.7
Georgia,1978,8,2425922,64.8,2284920,61.1,141002,5.8
Hawaii,1978,8,423598,67.7,393758,62.9,29840,7.0
Idaho,1978,8,417356,65.8,394036,62.2,23320,5.6
Illinois,1978,8,5438131,64.9,5119120,61.1,319011,5.9
Indiana,1978,8,2603444,66.1,2462646,62.6,140798,5.4
Iowa,1978,8,1425404,66.9,1373228,64.4,52176,3.7
Kansas,1978,8,1138055,66.9,1105610,65.0,32445,2.9
Kentucky,1978,8,1581256,61.1,1501149,58.0,80107,5.1
Louisiana,1978,8,1669905,58.7,1561270,54.9,108635,6.5
Maine,1978,8,487884,60.5,457379,56.7,30505,6.3
Maryland,1978,8,2060041,66.8,1947223,63.2,112818,5.5
Massachusetts,1978,8,2817675,65.5,2648841,61.6,168834,6.0
Michigan,1978,8,4231826,63.7,3936084,59.2,295742,7.0
Minnesota,1978,8,1985713,68.2,1909521,65.6,76192,3.8
Mississippi,1978,8,1012508,58.7,944601,54.7,67907,6.7
Missouri,1978,8,2265765,63.1,2160110,60.2,105655,4.7
Montana,1978,8,367294,64.8,347723,61.3,19571,5.3
Nebraska,1978,8,751361,66.6,731784,64.8,19577,2.6
Nevada,1978,8,376752,70.7,360563,67.6,16189,4.3
New Hampshire,1978,8,438442,67.3,422282,64.9,16160,3.7
New Jersey,1978,8,3482838,63.3,3235310,58.8,247528,7.1
New Mexico,1978,8,534913,61.5,501870,57.7,33043,6.2
New York,1978,8,7869398,59.4,7270385,54.9,599013,7.6
New York city,1978,8,3060853,55.1,2792099,50.3,268754,8.8
North Carolina,1978,8,2774339,67.3,2652246,64.3,122093,4.4
North Dakota,1978,8,295886,64.5,283818,61.8,12068,4.1
Ohio,1978,8,4984903,63.1,4714962,59.7,269941,5.4
Oklahoma,1978,8,1267727,59.9,1230388,58.1,37339,2.9
Oregon,1978,8,1219284,65.2,1143345,61.1,75939,6.2
Pennsylvania,1978,8,5318957,59.5,4955273,55.4,363684,6.8
Rhode Island,1978,8,450645,63.0,423176,59.2,27469,6.1
South Carolina,1978,8,1364225,64.2,1287258,60.6,76967,5.6
South Dakota,1978,8,324073,66.1,313360,64.0,10713,3.3
Tennessee,1978,8,1987035,60.9,1870051,57.3,116984,5.9
Texas,1978,8,6260442,65.4,5957611,62.3,302831,4.8
Utah,1978,8,571690,63.5,551501,61.2,20189,3.5
Vermont,1978,8,239054,66.2,226033,62.6,13021,5.4
Virginia,1978,8,2499275,66.3,2369256,62.9,130019,5.2
Washington,1978,8,1825910,64.4,1701522,60.0,124388,6.8
West Virginia,1978,8,738103,52.2,692196,48.9,45907,6.2
Wisconsin,1978,8,2262994,67.1,2152940,63.8,110054,4.9
Wyoming,1978,8,212167,69.3,205788,67.3,6379,3.0
Alabama,1978,9,1632310,59.2,1526379,55.4,105931,6.5
Alaska,1978,9,182680,71.4,163653,63.9,19027,10.4
Arizona,1978,9,1097675,60.1,1035679,56.7,61996,5.6
Arkansas,1978,9,953834,58.8,893907,55.1,59927,6.3
California,1978,9,11009558,65.3,10251598,60.8,757960,6.9
Los Angeles County,1978,9,3635734,66.1,3404068,61.8,231666,6.4
Colorado,1978,9,1367630,68.0,1297179,64.5,70451,5.2
Connecticut,1978,9,1519152,65.5,1441542,62.2,77610,5.1
Delaware,1978,9,279137,64.0,259488,59.5,19649,7.0
District of Columbia,1978,9,332803,65.5,307494,60.5,25309,7.6
Florida,1978,9,4018127,57.2,3752166,53.4,265961,6.6
Georgia,1978,9,2431556,64.8,2290280,61.1,141276,5.8
Hawaii,1978,9,424374,67.6,394881,62.9,29493,6.9
Idaho,1978,9,417752,65.7,393865,61.9,23887,5.7
Illinois,1978,9,5445023,65.0,5129818,61.2,315205,5.8
Indiana,1978,9,2609501,66.2,2467861,62.6,141640,5.4
Iowa,1978,9,1424452,66.8,1371281,64.3,53171,3.7
Kansas,1978,9,1140572,67.0,1107698,65.0,32874,2.9
Kentucky,1978,9,1583317,61.1,1502340,58.0,80977,5.1
Louisiana,1978,9,1671321,58.6,1565441,54.9,105880,6.3
Maine,1978,9,489497,60.6,458798,56.8,30699,6.3
Maryland,1978,9,2065506,66.9,1951529,63.2,113977,5.5
Massachusetts,1978,9,2821024,65.5,2653044,61.6,167980,6.0
Michigan,1978,9,4244193,63.8,3945581,59.3,298612,7.0
Minnesota,1978,9,1991685,68.3,1915246,65.7,76439,3.8
Mississippi,1978,9,1013314,58.6,946723,54.8,66591,6.6
Missouri,1978,9,2268913,63.2,2165105,60.3,103808,4.6
Montana,1978,9,367703,64.9,348287,61.4,19416,5.3
Nebraska,1978,9,751831,66.5,732488,64.8,19343,2.6
Nevada,1978,9,379085,70.6,362483,67.5,16602,4.4
New Hampshire,1978,9,439866,67.5,424093,65.0,15773,3.6
New Jersey,1978,9,3495547,63.4,3249156,59.0,246391,7.0
New Mexico,1978,9,536376,61.5,503145,57.7,33231,6.2
New York,1978,9,7887005,59.5,7294101,55.0,592904,7.5
New York city,1978,9,3061553,55.2,2794154,50.3,267399,8.7
North Carolina,1978,9,2777987,67.2,2656190,64.3,121797,4.4
North Dakota,1978,9,296262,64.4,283991,61.7,12271,4.1
Ohio,1978,9,4999535,63.2,4728178,59.8,271357,5.4
Oklahoma,1978,9,1270422,59.9,1232472,58.1,37950,3.0
Oregon,1978,9,1222567,65.2,1143984,61.0,78583,6.4
Pennsylvania,1978,9,5329373,59.5,4963861,55.5,365512,6.9
Rhode Island,1978,9,451475,63.1,423966,59.2,27509,6.1
South Carolina,1978,9,1364123,64.1,1288631,60.5,75492,5.5
South Dakota,1978,9,324469,66.1,313748,63.9,10721,3.3
Tennessee,1978,9,1989880,60.9,1872256,57.3,117624,5.9
Texas,1978,9,6281470,65.4,5976921,62.3,304549,4.8
Utah,1978,9,575128,63.7,554623,61.4,20505,3.6
Vermont,1978,9,239685,66.2,226711,62.6,12974,5.4
Virginia,1978,9,2501660,66.3,2371352,62.9,130308,5.2
Washington,1978,9,1834073,64.4,1708120,60.0,125953,6.9
West Virginia,1978,9,741229,52.3,693940,49.0,47289,6.4
Wisconsin,1978,9,2270955,67.3,2158835,63.9,112120,4.9
Wyoming,1978,9,213317,69.3,206897,67.2,6420,3.0
Alabama,1978,10,1636636,59.3,1528574,55.4,108062,6.6
Alaska,1978,10,183262,71.6,164489,64.3,18773,10.2
Arizona,1978,10,1106431,60.3,1042817,56.8,63614,5.7
Arkansas,1978,10,956204,58.8,895425,55.1,60779,6.4
California,1978,10,11041537,65.3,10292800,60.9,748737,6.8
Los Angeles County,1978,10,3650048,66.3,3422193,62.1,227855,6.2
Colorado,1978,10,1374559,68.1,1305034,64.7,69525,5.1
Connecticut,1978,10,1525728,65.8,1447893,62.4,77835,5.1
Delaware,1978,10,279467,64.1,259834,59.6,19633,7.0
District of Columbia,1978,10,332983,65.7,307732,60.7,25251,7.6
Florida,1978,10,4035724,57.2,3769685,53.4,266039,6.6
Georgia,1978,10,2437277,64.8,2296302,61.1,140975,5.8
Hawaii,1978,10,424897,67.6,395954,62.9,28943,6.8
Idaho,1978,10,418451,65.7,394054,61.9,24397,5.8
Illinois,1978,10,5450232,65.0,5138764,61.3,311468,5.7
Indiana,1978,10,2614460,66.3,2471552,62.7,142908,5.5
Iowa,1978,10,1421685,66.6,1367197,64.1,54488,3.8
Kansas,1978,10,1144015,67.1,1110529,65.2,33486,2.9
Kentucky,1978,10,1584730,61.1,1503067,58.0,81663,5.2
Louisiana,1978,10,1673479,58.6,1570217,55.0,103262,6.2
Maine,1978,10,491066,60.7,460121,56.9,30945,6.3
Maryland,1978,10,2071376,67.1,1955845,63.3,115531,5.6
Massachusetts,1978,10,2826542,65.6,2658998,61.7,167544,5.9
Michigan,1978,10,4258962,63.9,3957486,59.4,301476,7.1
Minnesota,1978,10,1998037,68.4,1921336,65.8,76701,3.8
Mississippi,1978,10,1013860,58.6,948615,54.8,65245,6.4
Missouri,1978,10,2273551,63.3,2171823,60.4,101728,4.5
Montana,1978,10,367568,64.7,348324,61.3,19244,5.2
Nebraska,1978,10,752699,66.6,733423,64.9,19276,2.6
Nevada,1978,10,381532,70.7,364517,67.5,17015,4.5
New Hampshire,1978,10,441575,67.5,426165,65.2,15410,3.5
New Jersey,1978,10,3508164,63.6,3262222,59.2,245942,7.0
New Mexico,1978,10,537946,61.5,504344,57.6,33602,6.2
New York,1978,10,7907987,59.6,7321205,55.2,586782,7.4
New York city,1978,10,3062997,55.2,2796795,50.4,266202,8.7
North Carolina,1978,10,2781335,67.2,2659445,64.3,121890,4.4
North Dakota,1978,10,296823,64.5,284368,61.8,12455,4.2
Ohio,1978,10,5016924,63.4,4742263,59.9,274661,5.5
Oklahoma,1978,10,1274514,59.9,1235571,58.1,38943,3.1
Oregon,1978,10,1225137,65.2,1143899,60.8,81238,6.6
Pennsylvania,1978,10,5339517,59.6,4972244,55.5,367273,6.9
Rhode Island,1978,10,452708,63.2,425109,59.4,27599,6.1
South Carolina,1978,10,1364354,64.0,1290496,60.5,73858,5.4
South Dakota,1978,10,324928,66.2,314246,64.0,10682,3.3
Tennessee,1978,10,1993891,60.9,1876269,57.3,117622,5.9
Texas,1978,10,6304655,65.5,6000860,62.3,303795,4.8
Utah,1978,10,578972,63.9,557995,61.6,20977,3.6
Vermont,1978,10,240485,66.4,227504,62.8,12981,5.4
Virginia,1978,10,2505259,66.3,2374465,62.8,130794,5.2
Washington,1978,10,1842516,64.5,1714933,60.0,127583,6.9
West Virginia,1978,10,743844,52.5,695453,49.0,48391,6.5
Wisconsin,1978,10,2277813,67.4,2164552,64.0,113261,5.0
Wyoming,1978,10,214453,69.4,208150,67.4,6303,2.9
Alabama,1978,11,1640650,59.4,1530696,55.4,109954,6.7
Alaska,1978,11,183977,71.6,165514,64.4,18463,10.0
Arizona,1978,11,1116473,60.5,1051380,57.0,65093,5.8
Arkansas,1978,11,958966,58.9,897506,55.1,61460,6.4
California,1978,11,11077465,65.4,10336820,61.0,740645,6.7
Los Angeles County,1978,11,3662473,66.4,3437421,62.3,225052,6.1
Colorado,1978,11,1382262,68.3,1313141,64.9,69121,5.0
Connecticut,1978,11,1533681,66.0,1455341,62.6,78340,5.1
Delaware,1978,11,279919,64.1,260259,59.6,19660,7.0
District of Columbia,1978,11,333107,65.7,307814,60.7,25293,7.6
Florida,1978,11,4054637,57.3,3788421,53.5,266216,6.6
Georgia,1978,11,2443523,64.9,2303225,61.1,140298,5.7
Hawaii,1978,11,425235,67.4,396958,62.9,28277,6.6
Idaho,1978,11,419609,65.8,394741,61.9,24868,5.9
Illinois,1978,11,5453739,65.0,5145509,61.3,308230,5.7
Indiana,1978,11,2618833,66.3,2474672,62.7,144161,5.5
Iowa,1978,11,1418303,66.4,1362554,63.8,55749,3.9
Kansas,1978,11,1148161,67.3,1114072,65.3,34089,3.0
Kentucky,1978,11,1586000,61.1,1503610,57.9,82390,5.2
Louisiana,1978,11,1676644,58.6,1575506,55.1,101138,6.0
Maine,1978,11,492722,60.8,461436,56.9,31286,6.3
Maryland,1978,11,2077697,67.2,1960442,63.4,117255,5.6
Massachusetts,1978,11,2834206,65.7,2666852,61.8,167354,5.9
Michigan,1978,11,4275194,64.1,3970239,59.5,304955,7.1
Minnesota,1978,11,2004599,68.5,1927517,65.9,77082,3.8
Mississippi,1978,11,1014427,58.5,950452,54.8,63975,6.3
Missouri,1978,11,2279504,63.4,2179924,60.6,99580,4.4
Montana,1978,11,367026,64.6,347944,61.3,19082,5.2
Nebraska,1978,11,753783,66.6,734600,65.0,19183,2.5
Nevada,1978,11,384106,70.7,366695,67.5,17411,4.5
New Hampshire,1978,11,443629,67.6,428499,65.3,15130,3.4
New Jersey,1978,11,3520871,63.8,3274643,59.3,246228,7.0
New Mexico,1978,11,539748,61.5,505526,57.6,34222,6.3
New York,1978,11,7930716,59.8,7349665,55.4,581051,7.3
New York city,1978,11,3065284,55.3,2800067,50.5,265217,8.7
North Carolina,1978,11,2785667,67.2,2662835,64.3,122832,4.4
North Dakota,1978,11,297591,64.6,284996,61.8,12595,4.2
Ohio,1978,11,5036737,63.6,4757606,60.1,279131,5.5
Oklahoma,1978,11,1279646,60.0,1239633,58.2,40013,3.1
Oregon,1978,11,1227352,65.1,1143669,60.7,83683,6.8
Pennsylvania,1978,11,5348897,59.7,4980436,55.6,368461,6.9
Rhode Island,1978,11,454397,63.4,426649,59.5,27748,6.1
South Carolina,1978,11,1365634,63.9,1293166,60.5,72468,5.3
South Dakota,1978,11,325513,66.3,314828,64.1,10685,3.3
Tennessee,1978,11,1999069,60.9,1882521,57.4,116548,5.8
Texas,1978,11,6330086,65.6,6030030,62.5,300056,4.7
Utah,1978,11,582959,64.1,561546,61.8,21413,3.7
Vermont,1978,11,241443,66.5,228429,62.9,13014,5.4
Virginia,1978,11,2510379,66.3,2379374,62.9,131005,5.2
Washington,1978,11,1851800,64.6,1722652,60.1,129148,7.0
West Virginia,1978,11,745709,52.6,696736,49.1,48973,6.6
Wisconsin,1978,11,2283492,67.5,2170410,64.1,113082,5.0
Wyoming,1978,11,215595,69.5,209517,67.6,6078,2.8
Alabama,1978,12,1644203,59.4,1532571,55.4,111632,6.8
Alaska,1978,12,184591,71.8,166480,64.8,18111,9.8
Arizona,1978,12,1126093,60.8,1060283,57.2,65810,5.8
Arkansas,1978,12,961823,59.0,899908,55.2,61915,6.4
California,1978,12,11112366,65.5,10378926,61.2,733440,6.6
Los Angeles County,1978,12,3670324,66.5,3447710,62.5,222614,6.1
Colorado,1978,12,1389775,68.5,1320821,65.1,68954,5.0
Connecticut,1978,12,1542025,66.3,1463021,62.9,79004,5.1
Delaware,1978,12,280424,64.2,260650,59.6,19774,7.1
District of Columbia,1978,12,332988,65.8,307625,60.8,25363,7.6
Florida,1978,12,4073109,57.3,3807073,53.6,266036,6.5
Georgia,1978,12,2449252,64.9,2310052,61.2,139200,5.7
Hawaii,1978,12,425456,67.2,397800,62.8,27656,6.5
Idaho,1978,12,421098,65.8,395803,61.8,25295,6.0
Illinois,1978,12,5453350,65.0,5147901,61.3,305449,5.6
Indiana,1978,12,2622524,66.3,2477199,62.7,145325,5.5
Iowa,1978,12,1415293,66.3,1358579,63.6,56714,4.0
Kansas,1978,12,1152069,67.5,1117506,65.4,34563,3.0
Kentucky,1978,12,1587441,61.1,1504131,57.9,83310,5.2
Louisiana,1978,12,1680582,58.6,1580786,55.1,99796,5.9
Maine,1978,12,494409,60.9,462638,57.0,31771,6.4
Maryland,1978,12,2083844,67.3,1964745,63.5,119099,5.7
Massachusetts,1978,12,2842500,65.8,2675324,62.0,167176,5.9
Michigan,1978,12,4289876,64.3,3980713,59.6,309163,7.2
Minnesota,1978,12,2010420,68.6,1932617,66.0,77803,3.9
Mississippi,1978,12,1014852,58.5,952227,54.9,62625,6.2
Missouri,1978,12,2285707,63.5,2187706,60.8,98001,4.3
Montana,1978,12,366259,64.4,347264,61.0,18995,5.2
Nebraska,1978,12,754812,66.7,735630,65.0,19182,2.5
Nevada,1978,12,386633,70.8,368864,67.6,17769,4.6
New Hampshire,1978,12,445772,67.8,430851,65.6,14921,3.3
New Jersey,1978,12,3531816,63.9,3285100,59.5,246716,7.0
New Mexico,1978,12,541509,61.5,506585,57.6,34924,6.4
New York,1978,12,7950015,59.9,7374569,55.6,575446,7.2
New York city,1978,12,3066958,55.3,2802704,50.6,264254,8.6
North Carolina,1978,12,2790078,67.2,2665419,64.2,124659,4.5
North Dakota,1978,12,298426,64.7,285705,62.0,12721,4.3
Ohio,1978,12,5054477,63.8,4770571,60.2,283906,5.6
Oklahoma,1978,12,1284900,60.2,1244070,58.3,40830,3.2
Oregon,1978,12,1229186,65.0,1143594,60.5,85592,7.0
Pennsylvania,1978,12,5356250,59.7,4987040,55.6,369210,6.9
Rhode Island,1978,12,456287,63.6,428284,59.7,28003,6.1
South Carolina,1978,12,1367851,63.9,1296173,60.5,71678,5.2
South Dakota,1978,12,326127,66.4,315326,64.2,10801,3.3
Tennessee,1978,12,2004599,61.0,1889597,57.5,115002,5.7
Texas,1978,12,6355857,65.6,6061189,62.6,294668,4.6
Utah,1978,12,586692,64.4,564936,62.0,21756,3.7
Vermont,1978,12,242387,66.6,229339,63.0,13048,5.4
Virginia,1978,12,2515672,66.4,2385142,62.9,130530,5.2
Washington,1978,12,1861871,64.8,1731290,60.2,130581,7.0
West Virginia,1978,12,746963,52.6,697652,49.1,49311,6.6
Wisconsin,1978,12,2287887,67.5,2176295,64.2,111592,4.9
Wyoming,1978,12,216643,69.7,210851,67.8,5792,2.7
Alabama,1979,1,1647083,59.4,1533846,55.4,113237,6.9
Alaska,1979,1,184941,72.0,167216,65.1,17725,9.6
Arizona,1979,1,1133847,60.9,1068338,57.4,65509,5.8
Arkansas,1979,1,964489,59.1,902443,55.3,62046,6.4
California,1979,1,11141282,65.5,10414825,61.2,726457,6.5
Los Angeles County,1979,1,3671974,66.5,3452218,62.5,219756,6.0
Colorado,1979,1,1396518,68.6,1327993,65.2,68525,4.9
Connecticut,1979,1,1549162,66.6,1469502,63.2,79660,5.1
Delaware,1979,1,280867,64.3,260932,59.7,19935,7.1
District of Columbia,1979,1,332526,65.7,307178,60.7,25348,7.6
Florida,1979,1,4088847,57.3,3823949,53.6,264898,6.5
Georgia,1979,1,2453372,64.8,2315782,61.2,137590,5.6
Hawaii,1979,1,425620,67.0,398440,62.7,27180,6.4
Idaho,1979,1,422826,66.0,397235,62.0,25591,6.1
Illinois,1979,1,5447651,64.9,5144664,61.3,302987,5.6
Indiana,1979,1,2625227,66.3,2478875,62.6,146352,5.6
Iowa,1979,1,1413363,66.1,1356092,63.5,57271,4.1
Kansas,1979,1,1154742,67.5,1119945,65.5,34797,3.0
Kentucky,1979,1,1588841,61.0,1504576,57.8,84265,5.3
Louisiana,1979,1,1685080,58.7,1585594,55.2,99486,5.9
Maine,1979,1,495881,61.0,463522,57.0,32359,6.5
Maryland,1979,1,2089179,67.4,1968448,63.5,120731,5.8
Massachusetts,1979,1,2849651,66.0,2682911,62.1,166740,5.9
Michigan,1979,1,4300331,64.4,3986924,59.7,313407,7.3
Minnesota,1979,1,2014878,68.7,1935977,66.0,78901,3.9
Mississippi,1979,1,1015088,58.4,953866,54.9,61222,6.0
Missouri,1979,1,2290830,63.6,2193347,60.9,97483,4.3
Montana,1979,1,365651,64.3,346668,60.9,18983,5.2
Nebraska,1979,1,755516,66.7,736146,65.0,19370,2.6
Nevada,1979,1,389030,70.7,370904,67.4,18126,4.7
New Hampshire,1979,1,447662,67.9,432940,65.7,14722,3.3
New Jersey,1979,1,3539795,64.0,3292804,59.5,246991,7.0
New Mexico,1979,1,543064,61.6,507529,57.5,35535,6.5
New York,1979,1,7962186,60.0,7392215,55.7,569971,7.2
New York city,1979,1,3066675,55.4,2803072,50.6,263603,8.6
North Carolina,1979,1,2793605,67.2,2666489,64.1,127116,4.6
North Dakota,1979,1,299146,64.9,286294,62.1,12852,4.3
Ohio,1979,1,5065499,63.9,4777655,60.3,287844,5.7
Oklahoma,1979,1,1289239,60.3,1248010,58.3,41229,3.2
Oregon,1979,1,1230590,64.9,1144035,60.4,86555,7.0
Pennsylvania,1979,1,5360067,59.7,4990510,55.6,369557,6.9
Rhode Island,1979,1,458015,63.9,429713,59.9,28302,6.2
South Carolina,1979,1,1370229,63.9,1298965,60.5,71264,5.2
South Dakota,1979,1,326586,66.4,315586,64.1,11000,3.4
Tennessee,1979,1,2009545,61.0,1895659,57.5,113886,5.7
Texas,1979,1,6378780,65.7,6089864,62.7,288916,4.5
Utah,1979,1,590014,64.6,567907,62.1,22107,3.7
Vermont,1979,1,243098,66.6,230075,63.0,13023,5.4
Virginia,1979,1,2519362,66.4,2390195,63.0,129167,5.1
Washington,1979,1,1872124,64.9,1740524,60.3,131600,7.0
West Virginia,1979,1,747675,52.6,698024,49.1,49651,6.6
Wisconsin,1979,1,2290872,67.5,2181857,64.3,109015,4.8
Wyoming,1979,1,217541,69.5,212059,67.8,5482,2.5
Alabama,1979,2,1649483,59.4,1534802,55.3,114681,7.0
Alaska,1979,2,184966,72.0,167620,65.2,17346,9.4
Arizona,1979,2,1138850,60.9,1074943,57.5,63907,5.6
Arkansas,1979,2,966878,59.1,905064,55.3,61814,6.4
California,1979,2,11162945,65.5,10445021,61.3,717924,6.4
Los Angeles County,1979,2,3668237,66.3,3452484,62.4,215753,5.9
Colorado,1979,2,1402575,68.7,1335042,65.3,67533,4.8
Connecticut,1979,2,1553902,66.7,1473871,63.3,80031,5.2
Delaware,1979,2,281095,64.2,261060,59.6,20035,7.1
District of Columbia,1979,2,331720,65.7,306620,60.7,25100,7.6
Florida,1979,2,4100456,57.3,3838339,53.6,262117,6.4
Georgia,1979,2,2455570,64.8,2320387,61.2,135183,5.5
Hawaii,1979,2,425792,66.9,398971,62.7,26821,6.3
Idaho,1979,2,424566,66.1,398928,62.1,25638,6.0
Illinois,1979,2,5439016,64.7,5138643,61.2,300373,5.5
Indiana,1979,2,2626298,66.3,2479206,62.6,147092,5.6
Iowa,1979,2,1412725,66.1,1355331,63.4,57394,4.1
Kansas,1979,2,1155966,67.6,1121160,65.5,34806,3.0
Kentucky,1979,2,1590539,61.0,1505558,57.8,84981,5.3
Louisiana,1979,2,1690010,58.7,1589607,55.2,100403,5.9
Maine,1979,2,496844,61.0,463935,57.0,32909,6.6
Maryland,1979,2,2093464,67.5,1971931,63.6,121533,5.8
Massachusetts,1979,2,2854573,66.0,2689061,62.2,165512,5.8
Michigan,1979,2,4305383,64.4,3989405,59.6,315978,7.3
Minnesota,1979,2,2018401,68.7,1938245,66.0,80156,4.0
Mississippi,1979,2,1015371,58.4,955643,55.0,59728,5.9
Missouri,1979,2,2294033,63.6,2196383,60.9,97650,4.3
Montana,1979,2,365527,64.1,346506,60.8,19021,5.2
Nebraska,1979,2,755907,66.7,736250,64.9,19657,2.6
Nevada,1979,2,391350,70.8,372844,67.4,18506,4.7
New Hampshire,1979,2,449052,67.9,434615,65.8,14437,3.2
New Jersey,1979,2,3544392,64.0,3298164,59.6,246228,6.9
New Mexico,1979,2,544420,61.5,508483,57.5,35937,6.6
New York,1979,2,7967468,60.0,7402825,55.8,564643,7.1
New York city,1979,2,3064349,55.4,2800882,50.6,263467,8.6
North Carolina,1979,2,2796087,67.1,2666508,64.0,129579,4.6
North Dakota,1979,2,299626,64.9,286706,62.1,12920,4.3
Ohio,1979,2,5067951,63.9,4777984,60.3,289967,5.7
Oklahoma,1979,2,1292478,60.3,1251327,58.4,41151,3.2
Oregon,1979,2,1231737,64.8,1145379,60.3,86358,7.0
Pennsylvania,1979,2,5360392,59.7,4991187,55.6,369205,6.9
Rhode Island,1979,2,459408,64.0,430768,60.0,28640,6.2
South Carolina,1979,2,1371914,63.8,1301408,60.5,70506,5.1
South Dakota,1979,2,326765,66.4,315628,64.2,11137,3.4
Tennessee,1979,2,2013437,61.0,1899806,57.6,113631,5.6
Texas,1979,2,6397642,65.7,6113863,62.8,283779,4.4
Utah,1979,2,593101,64.7,570485,62.2,22616,3.8
Vermont,1979,2,243444,66.7,230582,63.2,12862,5.3
Virginia,1979,2,2520725,66.3,2393901,63.0,126824,5.0
Washington,1979,2,1881952,65.0,1750142,60.5,131810,7.0
West Virginia,1979,2,748172,52.5,697896,49.0,50276,6.7
Wisconsin,1979,2,2293003,67.5,2187109,64.3,105894,4.6
Wyoming,1979,2,218372,69.5,213159,67.9,5213,2.4
Alabama,1979,3,1651916,59.5,1535922,55.3,115994,7.0
Alaska,1979,3,184735,71.9,167740,65.3,16995,9.2
Arizona,1979,3,1141140,60.7,1079814,57.5,61326,5.4
Arkansas,1979,3,969124,59.1,907743,55.4,61381,6.3
California,1979,3,11179494,65.5,10471986,61.3,707508,6.3
Los Angeles County,1979,3,3661153,66.1,3450305,62.3,210848,5.8
Colorado,1979,3,1408652,68.7,1342410,65.5,66242,4.7
Connecticut,1979,3,1556341,66.8,1476436,63.3,79905,5.1
Delaware,1979,3,280987,64.2,261010,59.6,19977,7.1
District of Columbia,1979,3,330656,65.6,306099,60.7,24557,7.4
Florida,1979,3,4108520,57.2,3850714,53.6,257806,6.3
Georgia,1979,3,2456219,64.6,2324268,61.1,131951,5.4
Hawaii,1979,3,426107,66.8,399608,62.6,26499,6.2
Idaho,1979,3,425923,66.1,400551,62.2,25372,6.0
Illinois,1979,3,5431075,64.6,5134804,61.1,296271,5.5
Indiana,1979,3,2625583,66.2,2477354,62.5,148229,5.6
Iowa,1979,3,1413192,66.1,1355958,63.4,57234,4.0
Kansas,1979,3,1156056,67.5,1121367,65.5,34689,3.0
Kentucky,1979,3,1593282,61.1,1507850,57.8,85432,5.4
Louisiana,1979,3,1695385,58.8,1592543,55.2,102842,6.1
Maine,1979,3,497171,61.0,463942,56.9,33229,6.7
Maryland,1979,3,2096891,67.5,1975445,63.6,121446,5.8
Massachusetts,1979,3,2857018,66.0,2693808,62.2,163210,5.7
Michigan,1979,3,4306298,64.3,3989890,59.6,316408,7.3
Minnesota,1979,3,2021790,68.7,1940433,66.0,81357,4.0
Mississippi,1979,3,1015800,58.3,957822,55.0,57978,5.7
Missouri,1979,3,2295581,63.6,2197231,60.9,98350,4.3
Montana,1979,3,365916,64.1,346853,60.7,19063,5.2
Nebraska,1979,3,756136,66.6,736133,64.9,20003,2.6
Nevada,1979,3,393641,70.8,374748,67.4,18893,4.8
New Hampshire,1979,3,449935,68.0,435909,65.8,14026,3.1
New Jersey,1979,3,3546405,64.0,3301820,59.6,244585,6.9
New Mexico,1979,3,545588,61.5,509509,57.4,36079,6.6
New York,1979,3,7968558,60.0,7408717,55.8,559841,7.0
New York city,1979,3,3061280,55.3,2797304,50.6,263976,8.6
North Carolina,1979,3,2797733,67.1,2666461,63.9,131272,4.7
North Dakota,1979,3,299888,64.9,286998,62.1,12890,4.3
Ohio,1979,3,5063252,63.8,4772653,60.2,290599,5.7
Oklahoma,1979,3,1295406,60.3,1254625,58.4,40781,3.1
Oregon,1979,3,1233330,64.7,1147929,60.2,85401,6.9
Pennsylvania,1979,3,5358243,59.6,4990182,55.5,368061,6.9
Rhode Island,1979,3,460487,64.1,431487,60.1,29000,6.3
South Carolina,1979,3,1372382,63.7,1303380,60.5,69002,5.0
South Dakota,1979,3,326638,66.4,315533,64.1,11105,3.4
Tennessee,1979,3,2016772,61.0,1902490,57.5,114282,5.7
Texas,1979,3,6413638,65.7,6133154,62.8,280484,4.4
Utah,1979,3,596189,64.9,572802,62.3,23387,3.9
Vermont,1979,3,243453,66.5,230892,63.1,12561,5.2
Virginia,1979,3,2520464,66.2,2396637,63.0,123827,4.9
Washington,1979,3,1890961,65.1,1760059,60.6,130902,6.9
West Virginia,1979,3,748865,52.5,697635,48.9,51230,6.8
Wisconsin,1979,3,2294703,67.4,2191913,64.4,102790,4.5
Wyoming,1979,3,219201,69.6,214172,68.0,5029,2.3
Alabama,1979,4,1654464,59.5,1537206,55.3,117258,7.1
Alaska,1979,4,184383,71.7,167695,65.3,16688,9.1
Arizona,1979,4,1141757,60.5,1083109,57.4,58648,5.1
Arkansas,1979,4,971238,59.2,910173,55.5,61065,6.3
California,1979,4,11195157,65.4,10497326,61.3,697831,6.2
Los Angeles County,1979,4,3652839,65.9,3446599,62.2,206240,5.6
Colorado,1979,4,1415391,68.8,1350293,65.7,65098,4.6
Connecticut,1979,4,1557503,66.8,1478086,63.4,79417,5.1
Delaware,1979,4,280593,63.9,260814,59.4,19779,7.0
District of Columbia,1979,4,329656,65.4,305842,60.7,23814,7.2
Florida,1979,4,4114736,57.1,3861612,53.6,253124,6.2
Georgia,1979,4,2456102,64.5,2327806,61.1,128296,5.2
Hawaii,1979,4,426702,66.7,400593,62.6,26109,6.1
Idaho,1979,4,426699,66.2,401808,62.3,24891,5.8
Illinois,1979,4,5426910,64.5,5135796,61.1,291114,5.4
Indiana,1979,4,2623894,66.1,2473190,62.3,150704,5.7
Iowa,1979,4,1414486,66.1,1357328,63.4,57158,4.0
Kansas,1979,4,1155723,67.4,1121061,65.4,34662,3.0
Kentucky,1979,4,1597506,61.2,1511619,57.9,85887,5.4
Louisiana,1979,4,1701530,58.9,1594694,55.2,106836,6.3
Maine,1979,4,497120,60.9,463841,56.8,33279,6.7
Maryland,1979,4,2100074,67.6,1978903,63.7,121171,5.8
Massachusetts,1979,4,2857968,66.0,2697654,62.3,160314,5.6
Michigan,1979,4,4305927,64.2,3989580,59.5,316347,7.3
Minnesota,1979,4,2025651,68.8,1943022,66.0,82629,4.1
Mississippi,1979,4,1016400,58.3,960073,55.1,56327,5.5
Missouri,1979,4,2296622,63.6,2196655,60.8,99967,4.4
Montana,1979,4,366764,64.2,347665,60.9,19099,5.2
Nebraska,1979,4,756387,66.6,735886,64.8,20501,2.7
Nevada,1979,4,395934,70.8,376659,67.4,19275,4.9
New Hampshire,1979,4,450483,67.8,436897,65.8,13586,3.0
New Jersey,1979,4,3547580,64.0,3304557,59.6,243023,6.9
New Mexico,1979,4,546647,61.4,510580,57.4,36067,6.6
New York,1979,4,7969332,60.0,7412399,55.8,556933,7.0
New York city,1979,4,3059125,55.3,2793895,50.5,265230,8.7
North Carolina,1979,4,2798448,67.0,2666281,63.8,132167,4.7
North Dakota,1979,4,300025,64.8,287245,62.0,12780,4.3
Ohio,1979,4,5055128,63.7,4764352,60.0,290776,5.8
Oklahoma,1979,4,1298825,60.4,1258351,58.5,40474,3.1
Oregon,1979,4,1235972,64.7,1151636,60.3,84336,6.8
Pennsylvania,1979,4,5355603,59.6,4988480,55.5,367123,6.9
Rhode Island,1979,4,461294,64.2,432018,60.1,29276,6.3
South Carolina,1979,4,1371928,63.6,1304885,60.5,67043,4.9
South Dakota,1979,4,326337,66.3,315398,64.1,10939,3.4
Tennessee,1979,4,2020900,61.0,1905126,57.5,115774,5.7
Texas,1979,4,6429400,65.6,6149376,62.8,280024,4.4
Utah,1979,4,599408,65.0,574953,62.4,24455,4.1
Vermont,1979,4,243285,66.3,231066,63.0,12219,5.0
Virginia,1979,4,2519664,66.1,2398816,62.9,120848,4.8
Washington,1979,4,1899765,65.2,1770415,60.8,129350,6.8
West Virginia,1979,4,750054,52.6,697726,48.9,52328,7.0
Wisconsin,1979,4,2296456,67.4,2196020,64.4,100436,4.4
Wyoming,1979,4,220075,69.6,215095,68.1,4980,2.3
Alabama,1979,5,1657348,59.5,1538757,55.2,118591,7.2
Alaska,1979,5,184094,71.4,167613,65.0,16481,9.0
Arizona,1979,5,1142299,60.2,1085926,57.2,56373,4.9
Arkansas,1979,5,973245,59.2,912255,55.5,60990,6.3
California,1979,5,11215470,65.4,10523859,61.4,691611,6.2
Los Angeles County,1979,5,3645288,65.7,3442434,62.1,202854,5.6
Colorado,1979,5,1423372,69.0,1358892,65.9,64480,4.5
Connecticut,1979,5,1558740,66.7,1479863,63.4,78877,5.1
Delaware,1979,5,280171,63.8,260629,59.4,19542,7.0
District of Columbia,1979,5,329071,65.4,306038,60.8,23033,7.0
Florida,1979,5,4121425,56.9,3872289,53.5,249136,6.0
Georgia,1979,5,2456837,64.4,2331874,61.1,124963,5.1
Hawaii,1979,5,427577,66.6,402052,62.6,25525,6.0
Idaho,1979,5,427173,66.1,402772,62.3,24401,5.7
Illinois,1979,5,5428521,64.5,5141772,61.1,286749,5.3
Indiana,1979,5,2623043,66.0,2467901,62.1,155142,5.9
Iowa,1979,5,1416441,66.2,1359106,63.5,57335,4.0
Kansas,1979,5,1155934,67.3,1121000,65.3,34934,3.0
Kentucky,1979,5,1603326,61.3,1516746,58.0,86580,5.4
Louisiana,1979,5,1708767,59.0,1597000,55.1,111767,6.5
Maine,1979,5,497172,60.8,463991,56.7,33181,6.7
Maryland,1979,5,2103534,67.6,1982333,63.7,121201,5.8
Massachusetts,1979,5,2858486,65.9,2701000,62.3,157486,5.5
Michigan,1979,5,4307552,64.2,3989250,59.4,318302,7.4
Minnesota,1979,5,2030558,68.8,1946492,66.0,84066,4.1
Mississippi,1979,5,1017521,58.3,962217,55.1,55304,5.4
Missouri,1979,5,2298292,63.6,2195762,60.7,102530,4.5
Montana,1979,5,367923,64.3,348774,61.0,19149,5.2
Nebraska,1979,5,756825,66.6,735624,64.8,21201,2.8
Nevada,1979,5,398307,70.7,378688,67.3,19619,4.9
New Hampshire,1979,5,451046,67.7,437802,65.7,13244,2.9
New Jersey,1979,5,3549953,64.0,3307628,59.6,242325,6.8
New Mexico,1979,5,547923,61.4,511835,57.4,36088,6.6
New York,1979,5,7973393,60.1,7416357,55.9,557036,7.0
New York city,1979,5,3058767,55.3,2791929,50.5,266838,8.7
North Carolina,1979,5,2798730,66.9,2665947,63.7,132783,4.7
North Dakota,1979,5,300168,64.8,287561,62.1,12607,4.2
Ohio,1979,5,5048181,63.6,4756657,59.9,291524,5.8
Oklahoma,1979,5,1303113,60.4,1262744,58.6,40369,3.1
Oregon,1979,5,1239744,64.7,1156202,60.3,83542,6.7
Pennsylvania,1979,5,5355093,59.5,4987777,55.4,367316,6.9
Rhode Island,1979,5,461995,64.3,432588,60.2,29407,6.4
South Carolina,1979,5,1371437,63.4,1306124,60.4,65313,4.8
South Dakota,1979,5,326089,66.1,315342,64.0,10747,3.3
Tennessee,1979,5,2026700,61.0,1909052,57.5,117648,5.8
Texas,1979,5,6447648,65.6,6165789,62.8,281859,4.4
Utah,1979,5,602819,65.2,577108,62.4,25711,4.3
Vermont,1979,5,243176,66.1,231241,62.8,11935,4.9
Virginia,1979,5,2520005,66.0,2401429,62.9,118576,4.7
Washington,1979,5,1909318,65.3,1781246,60.9,128072,6.7
West Virginia,1979,5,751961,52.6,698457,48.9,53504,7.1
Wisconsin,1979,5,2299119,67.4,2199729,64.5,99390,4.3
Wyoming,1979,5,221089,69.5,216000,67.9,5089,2.3
Alabama,1979,6,1660470,59.5,1540401,55.2,120069,7.2
Alaska,1979,6,183993,71.3,167575,65.0,16418,8.9
Arizona,1979,6,1144131,60.1,1089245,57.2,54886,4.8
Arkansas,1979,6,975205,59.2,914014,55.5,61191,6.3
California,1979,6,11243986,65.4,10553509,61.4,690477,6.1
Los Angeles County,1979,6,3641395,65.6,3440329,62.0,201066,5.5
Colorado,1979,6,1432078,69.2,1367375,66.1,64703,4.5
Connecticut,1979,6,1560733,66.8,1482125,63.4,78608,5.0
Delaware,1979,6,280054,63.6,260674,59.2,19380,6.9
District of Columbia,1979,6,328937,65.4,306561,60.9,22376,6.8
Florida,1979,6,4130138,56.9,3883670,53.5,246468,6.0
Georgia,1979,6,2459200,64.3,2336738,61.1,122462,5.0
Hawaii,1979,6,428596,66.7,403723,62.8,24873,5.8
Idaho,1979,6,427690,66.0,403600,62.3,24090,5.6
Illinois,1979,6,5435636,64.6,5150508,61.2,285128,5.2
Indiana,1979,6,2624380,66.0,2462864,61.9,161516,6.2
Iowa,1979,6,1418793,66.2,1360921,63.5,57872,4.1
Kansas,1979,6,1157131,67.4,1121640,65.3,35491,3.1
Kentucky,1979,6,1609979,61.5,1522300,58.1,87679,5.4
Louisiana,1979,6,1717070,59.2,1600206,55.2,116864,6.8
Maine,1979,6,497593,60.8,464493,56.7,33100,6.7
Maryland,1979,6,2107238,67.6,1985502,63.7,121736,5.8
Massachusetts,1979,6,2858486,65.9,2703160,62.3,155326,5.4
Michigan,1979,6,4312569,64.2,3989027,59.4,323542,7.5
Minnesota,1979,6,2036822,69.0,1951085,66.0,85737,4.2
Mississippi,1979,6,1019311,58.3,964001,55.1,55310,5.4
Missouri,1979,6,2300960,63.6,2195128,60.7,105832,4.6
Montana,1979,6,369124,64.5,349894,61.2,19230,5.2
Nebraska,1979,6,757441,66.6,735447,64.7,21994,2.9
Nevada,1979,6,400766,70.8,380828,67.3,19938,5.0
New Hampshire,1979,6,451960,67.8,438816,65.8,13144,2.9
New Jersey,1979,6,3554174,64.0,3311041,59.6,243133,6.8
New Mexico,1979,6,549553,61.4,513285,57.4,36268,6.6
New York,1979,6,7982172,60.1,7421428,55.9,560744,7.0
New York city,1979,6,3060392,55.4,2792038,50.5,268354,8.8
North Carolina,1979,6,2799839,66.8,2666181,63.6,133658,4.8
North Dakota,1979,6,300371,64.7,287949,62.1,12422,4.1
Ohio,1979,6,5044942,63.5,4751142,59.8,293800,5.8
Oklahoma,1979,6,1307910,60.6,1267487,58.7,40423,3.1
Oregon,1979,6,1244135,64.8,1160822,60.4,83313,6.7
Pennsylvania,1979,6,5358230,59.5,4988822,55.4,369408,6.9
Rhode Island,1979,6,462750,64.3,433325,60.2,29425,6.4
South Carolina,1979,6,1371649,63.3,1307105,60.3,64544,4.7
South Dakota,1979,6,326008,66.1,315397,64.0,10611,3.3
Tennessee,1979,6,2033452,61.1,1913807,57.5,119645,5.9
Texas,1979,6,6468922,65.6,6184122,62.8,284800,4.4
Utah,1979,6,606193,65.4,579239,62.5,26954,4.4
Vermont,1979,6,243283,66.1,231511,62.9,11772,4.8
Virginia,1979,6,2522473,66.0,2405052,62.9,117421,4.7
Washington,1979,6,1919333,65.4,1791624,61.1,127709,6.7
West Virginia,1979,6,754426,52.8,699580,48.9,54846,7.3
Wisconsin,1979,6,2303504,67.4,2203546,64.5,99958,4.3
Wyoming,1979,6,222219,69.7,216909,68.0,5310,2.4
Alabama,1979,7,1663440,59.6,1542100,55.2,121340,7.3
Alaska,1979,7,184087,71.4,167608,65.0,16479,9.0
Arizona,1979,7,1148329,60.0,1094122,57.2,54207,4.7
Arkansas,1979,7,977184,59.3,915721,55.5,61463,6.3
California,1979,7,11281439,65.5,10588578,61.5,692861,6.1
Los Angeles County,1979,7,3643650,65.6,3443476,62.0,200174,5.5
Colorado,1979,7,1440989,69.4,1375366,66.3,65623,4.6
Connecticut,1979,7,1563475,66.8,1484854,63.5,78621,5.0
Delaware,1979,7,280456,63.7,261131,59.3,19325,6.9
District of Columbia,1979,7,329069,65.6,307213,61.2,21856,6.6
Florida,1979,7,4141442,56.8,3896867,53.5,244575,5.9
Georgia,1979,7,2463188,64.2,2342425,61.1,120763,4.9
Hawaii,1979,7,429561,66.6,405290,62.8,24271,5.7
Idaho,1979,7,428599,66.0,404583,62.3,24016,5.6
Illinois,1979,7,5447782,64.7,5160721,61.3,287061,5.3
Indiana,1979,7,2628259,66.0,2459156,61.8,169103,6.4
Iowa,1979,7,1421449,66.3,1362748,63.6,58701,4.1
Kansas,1979,7,1159424,67.4,1123323,65.3,36101,3.1
Kentucky,1979,7,1616565,61.7,1527561,58.3,89004,5.5
Louisiana,1979,7,1726069,59.4,1604983,55.2,121086,7.0
Maine,1979,7,498424,60.8,465360,56.8,33064,6.6
Maryland,1979,7,2110972,67.7,1988685,63.8,122287,5.8
Massachusetts,1979,7,2858056,65.8,2704268,62.3,153788,5.4
Michigan,1979,7,4320426,64.2,3989015,59.3,331411,7.7
Minnesota,1979,7,2044529,69.1,1957033,66.2,87496,4.3
Mississippi,1979,7,1021597,58.4,965445,55.2,56152,5.5
Missouri,1979,7,2304789,63.7,2195283,60.6,109506,4.8
Montana,1979,7,370126,64.6,350855,61.2,19271,5.2
Nebraska,1979,7,758280,66.6,735647,64.6,22633,3.0
Nevada,1979,7,403309,70.9,383155,67.3,20154,5.0
New Hampshire,1979,7,453439,67.8,440102,65.8,13337,2.9
New Jersey,1979,7,3560221,64.0,3315363,59.6,244858,6.9
New Mexico,1979,7,551580,61.5,514984,57.4,36596,6.6
New York,1979,7,7995247,60.2,7428759,55.9,566488,7.1
New York city,1979,7,3063536,55.5,2794688,50.6,268848,8.8
North Carolina,1979,7,2803326,66.8,2668139,63.6,135187,4.8
North Dakota,1979,7,300658,64.8,288409,62.2,12249,4.1
Ohio,1979,7,5046005,63.5,4749074,59.7,296931,5.9
Oklahoma,1979,7,1312910,60.7,1272438,58.8,40472,3.1
Oregon,1979,7,1248515,64.8,1165082,60.5,83433,6.7
Pennsylvania,1979,7,5365109,59.6,4992374,55.4,372735,6.9
Rhode Island,1979,7,463645,64.4,434265,60.3,29380,6.3
South Carolina,1979,7,1373046,63.2,1308273,60.3,64773,4.7
South Dakota,1979,7,326175,66.2,315609,64.0,10566,3.2
Tennessee,1979,7,2040268,61.2,1918976,57.6,121292,5.9
Texas,1979,7,6493062,65.7,6206713,62.8,286349,4.4
Utah,1979,7,609374,65.5,581431,62.5,27943,4.6
Vermont,1979,7,243641,66.0,231912,62.8,11729,4.8
Virginia,1979,7,2527217,66.0,2410122,63.0,117095,4.6
Washington,1979,7,1929147,65.6,1801039,61.2,128108,6.6
West Virginia,1979,7,757033,52.9,700851,48.9,56182,7.4
Wisconsin,1979,7,2309605,67.5,2208235,64.5,101370,4.4
Wyoming,1979,7,223447,69.8,217892,68.1,5555,2.5
Alabama,1979,8,1666328,59.6,1543883,55.2,122445,7.3
Alaska,1979,8,184312,71.4,167730,65.0,16582,9.0
Arizona,1979,8,1155250,60.1,1100860,57.3,54390,4.7
Arkansas,1979,8,979170,59.3,917574,55.6,61596,6.3
California,1979,8,11324860,65.6,10628240,61.6,696620,6.2
Los Angeles County,1979,8,3652439,65.7,3452784,62.1,199655,5.5
Colorado,1979,8,1449487,69.7,1382640,66.5,66847,4.6
Connecticut,1979,8,1566841,66.9,1487931,63.5,78910,5.0
Delaware,1979,8,281324,63.9,261916,59.5,19408,6.9
District of Columbia,1979,8,329138,65.7,307692,61.4,21446,6.5
Florida,1979,8,4155394,56.8,3912436,53.5,242958,5.8
Georgia,1979,8,2468650,64.3,2348545,61.1,120105,4.9
Hawaii,1979,8,430405,66.5,406706,62.9,23699,5.5
Idaho,1979,8,429886,66.1,405680,62.4,24206,5.6
Illinois,1979,8,5464630,64.9,5171099,61.4,293531,5.4
Indiana,1979,8,2634121,66.1,2456718,61.7,177403,6.7
Iowa,1979,8,1424664,66.4,1364850,63.7,59814,4.2
Kansas,1979,8,1162614,67.5,1125983,65.4,36631,3.2
Kentucky,1979,8,1622646,61.8,1532343,58.4,90303,5.6
Louisiana,1979,8,1735099,59.5,1611259,55.3,123840,7.1
Maine,1979,8,499640,60.9,466523,56.9,33117,6.6
Maryland,1979,8,2114594,67.8,1992016,63.8,122578,5.8
Massachusetts,1979,8,2857515,65.8,2704746,62.3,152769,5.3
Michigan,1979,8,4329825,64.3,3988151,59.3,341674,7.9
Minnesota,1979,8,2053231,69.3,1963751,66.3,89480,4.4
Mississippi,1979,8,1024319,58.5,966786,55.2,57533,5.6
Missouri,1979,8,2309622,63.7,2196100,60.6,113522,4.9
Montana,1979,8,370841,64.7,351571,61.4,19270,5.2
Nebraska,1979,8,759272,66.7,736257,64.6,23015,3.0
Nevada,1979,8,405881,71.0,385669,67.4,20212,5.0
New Hampshire,1979,8,455398,68.0,441593,65.9,13805,3.0
New Jersey,1979,8,3567660,64.1,3321128,59.7,246532,6.9
New Mexico,1979,8,553869,61.6,516799,57.5,37070,6.7
New York,1979,8,8010119,60.3,7437684,56.0,572435,7.1
New York city,1979,8,3067263,55.6,2799387,50.7,267876,8.7
North Carolina,1979,8,2809545,66.8,2672187,63.5,137358,4.9
North Dakota,1979,8,301006,64.9,288844,62.3,12162,4.0
Ohio,1979,8,5050681,63.5,4750511,59.7,300170,5.9
Oklahoma,1979,8,1318069,60.8,1277498,58.9,40571,3.1
Oregon,1979,8,1252953,64.9,1169203,60.5,83750,6.7
Pennsylvania,1979,8,5375281,59.7,4998239,55.5,377042,7.0
Rhode Island,1979,8,464756,64.5,435414,60.5,29342,6.3
South Carolina,1979,8,1375410,63.2,1309639,60.2,65771,4.8
South Dakota,1979,8,326583,66.2,315959,64.1,10624,3.3
Tennessee,1979,8,2046872,61.3,1924602,57.6,122270,6.0
Texas,1979,8,6519815,65.8,6233683,62.9,286132,4.4
Utah,1979,8,612252,65.6,583675,62.6,28577,4.7
Vermont,1979,8,244196,66.0,232419,62.8,11777,4.8
Virginia,1979,8,2533603,66.1,2416264,63.0,117339,4.6
Washington,1979,8,1938433,65.6,1809207,61.2,129226,6.7
West Virginia,1979,8,759425,53.0,702015,49.0,57410,7.6
Wisconsin,1979,8,2316917,67.6,2213987,64.6,102930,4.4
Wyoming,1979,8,224739,70.0,218975,68.2,5764,2.6
Alabama,1979,9,1669055,59.6,1545533,55.2,123522,7.4
Alaska,1979,9,184641,71.3,167987,64.9,16654,9.0
Arizona,1979,9,1164057,60.3,1108628,57.5,55429,4.8
Arkansas,1979,9,981107,59.4,919580,55.6,61527,6.3
California,1979,9,11369128,65.7,10668358,61.6,700770,6.2
Los Angeles County,1979,9,3666692,65.8,3467140,62.2,199552,5.4
Colorado,1979,9,1456840,69.9,1388977,66.6,67863,4.7
Connecticut,1979,9,1570469,67.0,1490985,63.6,79484,5.1
Delaware,1979,9,282416,64.2,262809,59.7,19607,6.9
District of Columbia,1979,9,328886,65.8,307739,61.5,21147,6.4
Florida,1979,9,4171496,56.8,3929967,53.5,241529,5.8
Georgia,1979,9,2475015,64.3,2354321,61.2,120694,4.9
Hawaii,1979,9,431212,66.4,408050,62.9,23162,5.4
Idaho,1979,9,431290,66.3,406665,62.5,24625,5.7
Illinois,1979,9,5484329,65.0,5179226,61.4,305103,5.6
Indiana,1979,9,2640565,66.2,2454839,61.6,185726,7.0
Iowa,1979,9,1428786,66.6,1367509,63.8,61277,4.3
Kansas,1979,9,1166136,67.6,1129036,65.5,37100,3.2
Kentucky,1979,9,1628098,62.0,1536376,58.5,91722,5.6
Louisiana,1979,9,1743366,59.7,1618214,55.4,125152,7.2
Maine,1979,9,501125,61.0,467824,57.0,33301,6.6
Maryland,1979,9,2118035,67.9,1995458,63.9,122577,5.8
Massachusetts,1979,9,2856911,65.7,2704651,62.2,152260,5.3
Michigan,1979,9,4339231,64.4,3984539,59.2,354692,8.2
Minnesota,1979,9,2062108,69.5,1969946,66.4,92162,4.5
Mississippi,1979,9,1027514,58.6,968181,55.2,59333,5.8
Missouri,1979,9,2314591,63.8,2196752,60.5,117839,5.1
Montana,1979,9,371363,64.8,352073,61.4,19290,5.2
Nebraska,1979,9,760257,66.7,737074,64.7,23183,3.0
Nevada,1979,9,408379,70.9,388244,67.4,20135,4.9
New Hampshire,1979,9,457468,68.2,443021,66.0,14447,3.2
New Jersey,1979,9,3575039,64.3,3327673,59.8,247366,6.9
New Mexico,1979,9,556077,61.6,518496,57.5,37581,6.8
New York,1979,9,8024170,60.4,7446512,56.1,577658,7.2
New York city,1979,9,3070936,55.6,2804861,50.8,266075,8.7
North Carolina,1979,9,2817357,66.8,2677330,63.5,140027,5.0
North Dakota,1979,9,301351,64.9,289117,62.3,12234,4.1
Ohio,1979,9,5057443,63.5,4754299,59.7,303144,6.0
Oklahoma,1979,9,1323058,60.9,1282414,59.0,40644,3.1
Oregon,1979,9,1257383,64.9,1173485,60.6,83898,6.7
Pennsylvania,1979,9,5388082,59.8,5006271,55.5,381811,7.1
Rhode Island,1979,9,465982,64.7,436593,60.6,29389,6.3
South Carolina,1979,9,1378097,63.2,1310572,60.1,67525,4.9
South Dakota,1979,9,327177,66.4,316372,64.2,10805,3.3
Tennessee,1979,9,2053298,61.3,1930545,57.7,122753,6.0
Texas,1979,9,6547943,65.9,6261950,63.0,285993,4.4
Utah,1979,9,614780,65.7,585815,62.6,28965,4.7
Vermont,1979,9,244839,66.2,232950,63.0,11889,4.9
Virginia,1979,9,2540459,66.2,2422735,63.1,117724,4.6
Washington,1979,9,1946985,65.6,1815994,61.2,130991,6.7
West Virginia,1979,9,761291,53.1,702825,49.0,58466,7.7
Wisconsin,1979,9,2325040,67.8,2219963,64.7,105077,4.5
Wyoming,1979,9,226067,70.0,220097,68.1,5970,2.6
Alabama,1979,10,1671084,59.6,1546854,55.2,124230,7.4
Alaska,1979,10,184969,71.4,168402,65.0,16567,9.0
Arizona,1979,10,1173376,60.6,1116241,57.7,57135,4.9
Arkansas,1979,10,982805,59.4,921676,55.7,61129,6.2
California,1979,10,11409331,65.7,10706202,61.7,703129,6.2
Los Angeles County,1979,10,3684492,66.0,3484908,62.5,199584,5.4
Colorado,1979,10,1462395,70.0,1394592,66.8,67803,4.6
Connecticut,1979,10,1573707,67.1,1493660,63.6,80047,5.1
Delaware,1979,10,283435,64.4,263690,59.9,19745,7.0
District of Columbia,1979,10,328246,65.8,307325,61.6,20921,6.4
Florida,1979,10,4188719,56.8,3948874,53.5,239845,5.7
Georgia,1979,10,2481527,64.4,2359254,61.2,122273,4.9
Hawaii,1979,10,432069,66.5,409410,63.0,22659,5.2
Idaho,1979,10,432487,66.3,407374,62.5,25113,5.8
Illinois,1979,10,5503092,65.2,5183506,61.5,319586,5.8
Indiana,1979,10,2645571,66.3,2452726,61.5,192845,7.3
Iowa,1979,10,1433403,66.8,1370743,63.9,62660,4.4
Kansas,1979,10,1169158,67.8,1131742,65.6,37416,3.2
Kentucky,1979,10,1632553,62.1,1539214,58.5,93339,5.7
Louisiana,1979,10,1749794,59.8,1624981,55.5,124813,7.1
Maine,1979,10,502409,61.2,469048,57.1,33361,6.6
Maryland,1979,10,2120896,67.9,1998951,64.0,121945,5.7
Massachusetts,1979,10,2856085,65.7,2704343,62.2,151742,5.3
Michigan,1979,10,4345801,64.5,3976867,59.0,368934,8.5
Minnesota,1979,10,2070474,69.6,1974878,66.4,95596,4.6
Mississippi,1979,10,1030935,58.7,969808,55.3,61127,5.9
Missouri,1979,10,2318537,63.8,2196537,60.5,122000,5.3
Montana,1979,10,371819,64.9,352479,61.5,19340,5.2
Nebraska,1979,10,761023,66.7,737925,64.7,23098,3.0
Nevada,1979,10,410721,70.9,390754,67.5,19967,4.9
New Hampshire,1979,10,459334,68.3,444278,66.0,15056,3.3
New Jersey,1979,10,3580441,64.3,3334271,59.9,246170,6.9
New Mexico,1979,10,557777,61.7,519923,57.5,37854,6.8
New York,1979,10,8033796,60.5,7454201,56.1,579595,7.2
New York city,1979,10,3073240,55.7,2809848,50.9,263392,8.6
North Carolina,1979,10,2824962,66.9,2682719,63.5,142243,5.0
North Dakota,1979,10,301560,64.9,289174,62.2,12386,4.1
Ohio,1979,10,5063702,63.6,4758886,59.8,304816,6.0
Oklahoma,1979,10,1327531,60.9,1287102,59.1,40429,3.0
Oregon,1979,10,1260858,65.0,1177677,60.7,83181,6.6
Pennsylvania,1979,10,5401246,59.9,5016035,55.6,385211,7.1
Rhode Island,1979,10,467068,65.0,437495,60.8,29573,6.3
South Carolina,1979,10,1380156,63.2,1310321,60.0,69835,5.1
South Dakota,1979,10,327828,66.4,316772,64.1,11056,3.4
Tennessee,1979,10,2059339,61.4,1936373,57.8,122966,6.0
Texas,1979,10,6575376,65.9,6288133,63.0,287243,4.4
Utah,1979,10,617046,65.7,587733,62.6,29313,4.8
Vermont,1979,10,245401,66.1,233394,62.9,12007,4.9
Virginia,1979,10,2546256,66.3,2428788,63.2,117468,4.6
Washington,1979,10,1953741,65.6,1821417,61.2,132324,6.8
West Virginia,1979,10,762403,53.1,703120,49.0,59283,7.8
Wisconsin,1979,10,2332467,67.9,2224861,64.7,107606,4.6
Wyoming,1979,10,227408,70.2,221184,68.3,6224,2.7
Alabama,1979,11,1672076,59.6,1547532,55.2,124544,7.4
Alaska,1979,11,185332,71.3,168958,65.0,16374,8.8
Arizona,1979,11,1182611,60.8,1123369,57.8,59242,5.0
Arkansas,1979,11,984261,59.4,923671,55.7,60590,6.2
California,1979,11,11443437,65.8,10740319,61.7,703118,6.1
Los Angeles County,1979,11,3704560,66.3,3504708,62.7,199852,5.4
Colorado,1979,11,1466555,70.1,1399963,66.9,66592,4.5
Connecticut,1979,11,1576324,67.1,1495961,63.7,80363,5.1
Delaware,1979,11,284114,64.6,264415,60.1,19699,6.9
District of Columbia,1979,11,327361,65.7,306633,61.6,20728,6.3
Florida,1979,11,4205947,56.8,3968196,53.6,237751,5.7
Georgia,1979,11,2488098,64.4,2363325,61.2,124773,5.0
Hawaii,1979,11,433066,66.4,410913,63.0,22153,5.1
Idaho,1979,11,433246,66.3,407612,62.4,25634,5.9
Illinois,1979,11,5517541,65.4,5183227,61.4,334314,6.1
Indiana,1979,11,2647654,66.3,2449457,61.3,198197,7.5
Iowa,1979,11,1437934,67.0,1374430,64.0,63504,4.4
Kansas,1979,11,1171256,67.8,1133563,65.6,37693,3.2
Kentucky,1979,11,1635737,62.1,1540469,58.5,95268,5.8
Louisiana,1979,11,1753982,59.8,1630962,55.6,123020,7.0
Maine,1979,11,503225,61.2,470003,57.2,33222,6.6
Maryland,1979,11,2123327,67.9,2002346,64.1,120981,5.7
Massachusetts,1979,11,2855470,65.6,2704579,62.1,150891,5.3
Michigan,1979,11,4348352,64.5,3965054,58.8,383298,8.8
Minnesota,1979,11,2077989,69.8,1978505,66.4,99484,4.8
Mississippi,1979,11,1034238,58.9,971730,55.3,62508,6.0
Missouri,1979,11,2320934,63.8,2195071,60.4,125863,5.4
Montana,1979,11,372336,65.0,352850,61.6,19486,5.2
Nebraska,1979,11,761458,66.7,738642,64.7,22816,3.0
Nevada,1979,11,412953,70.8,393114,67.4,19839,4.8
New Hampshire,1979,11,460837,68.4,445327,66.1,15510,3.4
New Jersey,1979,11,3583287,64.3,3340549,60.0,242738,6.8
New Mexico,1979,11,558885,61.7,521017,57.5,37868,6.8
New York,1979,11,8035657,60.5,7458830,56.1,576827,7.2
New York city,1979,11,3073107,55.7,2813059,51.0,260048,8.5
North Carolina,1979,11,2831088,66.9,2687526,63.5,143562,5.1
North Dakota,1979,11,301630,64.9,289108,62.2,12522,4.2
Ohio,1979,11,5068220,63.6,4762679,59.8,305541,6.0
Oklahoma,1979,11,1331472,61.0,1291496,59.1,39976,3.0
Oregon,1979,11,1263141,64.9,1181601,60.7,81540,6.5
Pennsylvania,1979,11,5412774,60.0,5026176,55.7,386598,7.1
Rhode Island,1979,11,467842,65.1,437991,60.9,29851,6.4
South Carolina,1979,11,1380788,63.1,1308589,59.8,72199,5.2
South Dakota,1979,11,328393,66.5,317087,64.2,11306,3.4
Tennessee,1979,11,2064582,61.4,1941375,57.8,123207,6.0
Texas,1979,11,6601483,66.0,6310316,63.1,291167,4.4
Utah,1979,11,619281,65.7,589395,62.6,29886,4.8
Vermont,1979,11,245810,66.1,233724,62.8,12086,4.9
Virginia,1979,11,2550048,66.3,2433590,63.2,116458,4.6
Washington,1979,11,1958074,65.5,1825242,61.1,132832,6.8
West Virginia,1979,11,762973,53.1,702889,48.9,60084,7.9
Wisconsin,1979,11,2337343,67.9,2227082,64.7,110261,4.7
Wyoming,1979,11,228707,70.2,222193,68.2,6514,2.8
Alabama,1979,12,1672440,59.5,1547367,55.1,125073,7.5
Alaska,1979,12,185810,71.5,169583,65.2,16227,8.7
Arizona,1979,12,1191780,61.1,1129987,57.9,61793,5.2
Arkansas,1979,12,985678,59.4,925153,55.8,60525,6.1
California,1979,12,11472705,65.8,10768752,61.7,703953,6.1
Los Angeles County,1979,12,3725963,66.6,3524539,63.0,201424,5.4
Colorado,1979,12,1470449,70.1,1405036,67.0,65413,4.4
Connecticut,1979,12,1578580,67.1,1497966,63.7,80614,5.1
Delaware,1979,12,284350,64.8,264816,60.3,19534,6.9
District of Columbia,1979,12,326476,65.7,305821,61.5,20655,6.3
Florida,1979,12,4222533,56.8,3986207,53.6,236326,5.6
Georgia,1979,12,2495286,64.5,2366609,61.1,128677,5.2
Hawaii,1979,12,434304,66.4,412663,63.1,21641,5.0
Idaho,1979,12,433535,66.3,407201,62.3,26334,6.1
Illinois,1979,12,5527854,65.5,5179315,61.3,348539,6.3
Indiana,1979,12,2646409,66.2,2443469,61.1,202940,7.7
Iowa,1979,12,1441794,67.2,1377688,64.2,64106,4.4
Kansas,1979,12,1172650,67.8,1134273,65.6,38377,3.3
Kentucky,1979,12,1638294,62.2,1540287,58.5,98007,6.0
Louisiana,1979,12,1756428,59.7,1635504,55.6,120924,6.9
Maine,1979,12,503736,61.3,470647,57.3,33089,6.6
Maryland,1979,12,2125800,68.0,2005140,64.1,120660,5.7
Massachusetts,1979,12,2855872,65.6,2705672,62.1,150200,5.3
Michigan,1979,12,4348471,64.4,3948557,58.5,399914,9.2
Minnesota,1979,12,2084434,69.9,1981051,66.4,103383,5.0
Mississippi,1979,12,1037554,59.0,973843,55.4,63711,6.1
Missouri,1979,12,2322207,63.8,2192256,60.2,129951,5.6
Montana,1979,12,372908,65.1,353076,61.6,19832,5.3
Nebraska,1979,12,761595,66.6,739057,64.7,22538,3.0
Nevada,1979,12,415183,70.9,395240,67.4,19943,4.8
New Hampshire,1979,12,462000,68.4,446114,66.1,15886,3.4
New Jersey,1979,12,3584528,64.3,3345835,60.0,238693,6.7
New Mexico,1979,12,559613,61.6,521743,57.5,37870,6.8
New York,1979,12,8030532,60.4,7458271,56.1,572261,7.1
New York city,1979,12,3071405,55.7,2814008,51.0,257397,8.4
North Carolina,1979,12,2836088,66.8,2691605,63.4,144483,5.1
North Dakota,1979,12,301632,64.9,289044,62.2,12588,4.2
Ohio,1979,12,5071541,63.6,4763035,59.8,308506,6.1
Oklahoma,1979,12,1335039,61.0,1295342,59.2,39697,3.0
Oregon,1979,12,1265393,64.9,1185002,60.7,80391,6.4
Pennsylvania,1979,12,5422063,60.1,5034454,55.8,387609,7.1
Rhode Island,1979,12,468313,65.1,438132,60.9,30181,6.4
South Carolina,1979,12,1380257,62.9,1305791,59.5,74466,5.4
South Dakota,1979,12,328863,66.6,317251,64.2,11612,3.5
Tennessee,1979,12,2068414,61.5,1944551,57.8,123863,6.0
Texas,1979,12,6626499,66.0,6327833,63.1,298666,4.5
Utah,1979,12,621613,65.8,590768,62.5,30845,5.0
Vermont,1979,12,246123,66.0,233967,62.7,12156,4.9
Virginia,1979,12,2552190,66.2,2436729,63.2,115461,4.5
Washington,1979,12,1960197,65.3,1827313,60.9,132884,6.8
West Virginia,1979,12,763435,53.1,702196,48.9,61239,8.0
Wisconsin,1979,12,2339572,67.9,2225371,64.6,114201,4.9
Wyoming,1979,12,229934,70.3,223108,68.2,6826,3.0
Alabama,1980,1,1672687,59.5,1546209,55.0,126478,7.6
Alaska,1980,1,186379,71.4,170123,65.2,16256,8.7
Arizona,1980,1,1200696,61.3,1135663,58.0,65033,5.4
Arkansas,1980,1,986939,59.4,925485,55.7,61454,6.2
California,1980,1,11497843,65.8,10787840,61.7,710003,6.2
Los Angeles County,1980,1,3746345,66.9,3540860,63.2,205485,5.5
Colorado,1980,1,1474630,70.2,1408927,67.0,65703,4.5
Connecticut,1980,1,1580710,67.1,1499549,63.7,81161,5.1
Delaware,1980,1,284212,64.7,264803,60.3,19409,6.8
District of Columbia,1980,1,325793,65.8,304972,61.6,20821,6.4
Florida,1980,1,4237136,56.8,4000347,53.6,236789,5.6
Georgia,1980,1,2503147,64.5,2368769,61.1,134378,5.4
Hawaii,1980,1,435729,66.4,414532,63.2,21197,4.9
Idaho,1980,1,433223,66.1,405812,62.0,27411,6.3
Illinois,1980,1,5534485,65.5,5171463,61.2,363022,6.6
Indiana,1980,1,2643183,66.1,2433485,60.8,209698,7.9
Iowa,1980,1,1444035,67.3,1378735,64.2,65300,4.5
Kansas,1980,1,1173756,67.8,1133816,65.5,39940,3.4
Kentucky,1980,1,1641080,62.2,1538809,58.4,102271,6.2
Louisiana,1980,1,1757569,59.6,1638094,55.6,119475,6.8
Maine,1980,1,504200,61.3,470943,57.3,33257,6.6
Maryland,1980,1,2128297,68.0,2006189,64.1,122108,5.7
Massachusetts,1980,1,2856820,65.6,2706365,62.1,150455,5.3
Michigan,1980,1,4347500,64.4,3925544,58.1,421956,9.7
Minnesota,1980,1,2089255,69.9,1982087,66.4,107168,5.1
Mississippi,1980,1,1040912,59.1,975734,55.4,65178,6.3
Missouri,1980,1,2323214,63.7,2188029,60.0,135185,5.8
Montana,1980,1,373217,65.1,352842,61.6,20375,5.5
Nebraska,1980,1,761606,66.6,738976,64.7,22630,3.0
Nevada,1980,1,417418,70.9,396980,67.4,20438,4.9
New Hampshire,1980,1,462922,68.5,446557,66.1,16365,3.5
New Jersey,1980,1,3584398,64.3,3348511,60.1,235887,6.6
New Mexico,1980,1,560084,61.5,521904,57.3,38180,6.8
New York,1980,1,8019843,60.3,7450357,56.1,569486,7.1
New York city,1980,1,3068767,55.6,2812829,51.0,255938,8.3
North Carolina,1980,1,2840711,66.8,2694400,63.4,146311,5.2
North Dakota,1980,1,301609,64.9,288983,62.1,12626,4.2
Ohio,1980,1,5073129,63.6,4755451,59.6,317678,6.3
Oklahoma,1980,1,1338325,61.0,1298225,59.2,40100,3.0
Oregon,1980,1,1268565,64.9,1187062,60.7,81503,6.4
Pennsylvania,1980,1,5429163,60.2,5038000,55.8,391163,7.2
Rhode Island,1980,1,468602,65.2,437954,60.9,30648,6.5
South Carolina,1980,1,1379386,62.7,1302425,59.2,76961,5.6
South Dakota,1980,1,329254,66.7,317183,64.2,12071,3.7
Tennessee,1980,1,2069857,61.4,1944542,57.7,125315,6.1
Texas,1980,1,6649920,66.1,6339884,63.0,310036,4.7
Utah,1980,1,623862,65.8,591667,62.4,32195,5.2
Vermont,1980,1,246385,66.1,234074,62.8,12311,5.0
Virginia,1980,1,2553269,66.2,2437767,63.2,115502,4.5
Washington,1980,1,1960776,65.1,1827130,60.7,133646,6.8
West Virginia,1980,1,764153,53.1,701147,48.8,63006,8.2
Wisconsin,1980,1,2340273,67.8,2219229,64.3,121044,5.2
Wyoming,1980,1,230986,70.2,223835,68.0,7151,3.1
Alabama,1980,2,1673059,59.4,1543743,54.8,129316,7.7
Alaska,1980,2,187064,71.7,170512,65.3,16552,8.8
Arizona,1980,2,1209565,61.5,1140171,58.0,69394,5.7
Arkansas,1980,2,987870,59.4,924261,55.6,63609,6.4
California,1980,2,11519633,65.7,10795311,61.6,724322,6.3
Los Angeles County,1980,2,3763230,67.1,3550714,63.3,212516,5.6
Colorado,1980,2,1479326,70.2,1410950,67.0,68376,4.6
Connecticut,1980,2,1582944,67.2,1500549,63.7,82395,5.2
Delaware,1980,2,283924,64.7,264436,60.2,19488,6.9
District of Columbia,1980,2,325467,65.9,304202,61.6,21265,6.5
Florida,1980,2,4248773,56.7,4009238,53.5,239535,5.6
Georgia,1980,2,2511320,64.6,2369496,61.0,141824,5.6
Hawaii,1980,2,437142,66.5,416251,63.4,20891,4.8
Idaho,1980,2,432478,66.0,403552,61.6,28926,6.7
Illinois,1980,2,5537420,65.5,5157757,61.0,379663,6.9
Indiana,1980,2,2640113,66.0,2419559,60.4,220554,8.4
Iowa,1980,2,1444402,67.2,1376591,64.1,67811,4.7
Kansas,1980,2,1174919,67.8,1132380,65.3,42539,3.6
Kentucky,1980,2,1644299,62.3,1535949,58.2,108350,6.6
Louisiana,1980,2,1758063,59.5,1639109,55.5,118954,6.8
Maine,1980,2,504839,61.3,470883,57.2,33956,6.7
Maryland,1980,2,2130868,68.1,2004911,64.1,125957,5.9
Massachusetts,1980,2,2857250,65.5,2704818,62.1,152432,5.3
Michigan,1980,2,4346957,64.3,3895665,57.6,451292,10.4
Minnesota,1980,2,2092054,69.9,1980940,66.2,111114,5.3
Mississippi,1980,2,1043946,59.2,976759,55.4,67187,6.4
Missouri,1980,2,2324706,63.7,2182457,59.8,142249,6.1
Montana,1980,2,373040,65.1,351957,61.4,21083,5.7
Nebraska,1980,2,761597,66.6,738198,64.5,23399,3.1
Nevada,1980,2,419692,70.8,398289,67.2,21403,5.1
New Hampshire,1980,2,463764,68.5,446621,66.0,17143,3.7
New Jersey,1980,2,3583490,64.2,3347401,60.0,236089,6.6
New Mexico,1980,2,560384,61.4,521447,57.1,38937,6.9
New York,1980,2,8005787,60.2,7434432,55.9,571355,7.1
New York city,1980,2,3065588,55.6,2809872,50.9,255716,8.3
North Carolina,1980,2,2845342,66.8,2694027,63.2,151315,5.3
North Dakota,1980,2,301642,64.9,288867,62.1,12775,4.2
Ohio,1980,2,5072377,63.6,4736906,59.4,335471,6.6
Oklahoma,1980,2,1341325,61.0,1299832,59.1,41493,3.1
Oregon,1980,2,1272943,64.9,1186893,60.6,86050,6.8
Pennsylvania,1980,2,5434074,60.2,5034292,55.8,399782,7.4
Rhode Island,1980,2,468821,65.3,437547,60.9,31274,6.7
South Carolina,1980,2,1379200,62.6,1299100,59.0,80100,5.8
South Dakota,1980,2,329612,66.6,316853,64.0,12759,3.9
Tennessee,1980,2,2069082,61.2,1940886,57.4,128196,6.2
Texas,1980,2,6670529,66.1,6346353,62.9,324176,4.9
Utah,1980,2,625862,65.8,592012,62.3,33850,5.4
Vermont,1980,2,246685,66.0,234012,62.6,12673,5.1
Virginia,1980,2,2553916,66.1,2436403,63.1,117513,4.6
Washington,1980,2,1960848,64.9,1824416,60.4,136432,7.0
West Virginia,1980,2,765321,53.2,699813,48.6,65508,8.6
Wisconsin,1980,2,2340584,67.7,2209298,63.9,131286,5.6
Wyoming,1980,2,231781,70.2,224309,68.0,7472,3.2
Alabama,1980,3,1673967,59.4,1540076,54.7,133891,8.0
Alaska,1980,3,187884,71.7,170754,65.2,17130,9.1
Arizona,1980,3,1218278,61.7,1143426,57.9,74852,6.1
Arkansas,1980,3,988439,59.4,921573,55.3,66866,6.8
California,1980,3,11540580,65.7,10793087,61.4,747493,6.5
Los Angeles County,1980,3,3776061,67.2,3553844,63.3,222217,5.9
Colorado,1980,3,1484619,70.3,1411018,66.8,73601,5.0
Connecticut,1980,3,1585156,67.2,1500648,63.6,84508,5.3
Delaware,1980,3,283727,64.6,263850,60.1,19877,7.0
District of Columbia,1980,3,325589,66.0,303647,61.6,21942,6.7
Florida,1980,3,4258033,56.6,4013729,53.4,244304,5.7
Georgia,1980,3,2519373,64.7,2368845,60.8,150528,6.0
Hawaii,1980,3,438278,66.5,417483,63.4,20795,4.7
Idaho,1980,3,431642,65.8,400899,61.1,30743,7.1
Illinois,1980,3,5537864,65.5,5137472,60.7,400392,7.2
Indiana,1980,3,2637896,65.8,2402255,60.0,235641,8.9
Iowa,1980,3,1443093,67.2,1370937,63.8,72156,5.0
Kansas,1980,3,1176474,67.8,1130447,65.2,46027,3.9
Kentucky,1980,3,1647892,62.4,1532058,58.0,115834,7.0
Louisiana,1980,3,1758658,59.4,1639547,55.4,119111,6.8
Maine,1980,3,505687,61.4,470474,57.2,35213,7.0
Maryland,1980,3,2133828,68.1,2002044,63.9,131784,6.2
Massachusetts,1980,3,2856954,65.5,2700595,61.9,156359,5.5
Michigan,1980,3,4347619,64.3,3861330,57.1,486289,11.2
Minnesota,1980,3,2093114,69.8,1977804,66.0,115310,5.5
Mississippi,1980,3,1046593,59.3,976610,55.4,69983,6.7
Missouri,1980,3,2327198,63.7,2176171,59.6,151027,6.5
Montana,1980,3,372457,65.0,350537,61.2,21920,5.9
Nebraska,1980,3,761788,66.5,736864,64.4,24924,3.3
Nevada,1980,3,422129,70.8,399267,67.0,22862,5.4
New Hampshire,1980,3,464686,68.5,446376,65.8,18310,3.9
New Jersey,1980,3,3582876,64.2,3342748,59.9,240128,6.7
New Mexico,1980,3,560624,61.3,520597,56.9,40027,7.1
New York,1980,3,7991318,60.1,7412577,55.8,578741,7.2
New York city,1980,3,3062745,55.5,2806124,50.9,256621,8.4
North Carolina,1980,3,2850082,66.7,2689287,63.0,160795,5.6
North Dakota,1980,3,301806,64.9,288650,62.1,13156,4.4
Ohio,1980,3,5069578,63.5,4708189,59.0,361389,7.1
Oklahoma,1980,3,1344129,61.0,1300267,59.0,43862,3.3
Oregon,1980,3,1278016,65.0,1184266,60.3,93750,7.3
Pennsylvania,1980,3,5437900,60.2,5023174,55.6,414726,7.6
Rhode Island,1980,3,469134,65.3,437011,60.9,32123,6.8
South Carolina,1980,3,1380573,62.5,1296580,58.7,83993,6.1
South Dakota,1980,3,330045,66.7,316354,63.9,13691,4.1
Tennessee,1980,3,2066780,61.1,1933794,57.1,132986,6.4
Texas,1980,3,6688726,66.0,6349543,62.7,339183,5.1
Utah,1980,3,627592,65.9,591900,62.1,35692,5.7
Vermont,1980,3,247122,65.9,233834,62.4,13288,5.4
Virginia,1980,3,2554661,66.0,2432865,62.9,121796,4.8
Washington,1980,3,1961352,64.6,1819708,60.0,141644,7.2
West Virginia,1980,3,766984,53.3,698071,48.5,68913,9.0
Wisconsin,1980,3,2341851,67.6,2197462,63.5,144389,6.2
Wyoming,1980,3,232370,70.2,224572,67.8,7798,3.4
Alabama,1980,4,1675653,59.4,1536048,54.4,139605,8.3
Alaska,1980,4,188693,72.0,170820,65.2,17873,9.5
Arizona,1980,4,1226164,61.9,1145552,57.8,80612,6.6
Arkansas,1980,4,988643,59.3,918069,55.1,70574,7.1
California,1980,4,11561952,65.6,10786253,61.2,775699,6.7
Los Angeles County,1980,4,3785008,67.3,3551674,63.1,233334,6.2
Colorado,1980,4,1490135,70.5,1409416,66.6,80719,5.4
Connecticut,1980,4,1586768,67.2,1499597,63.5,87171,5.5
Delaware,1980,4,283710,64.6,263166,59.9,20544,7.2
District of Columbia,1980,4,325927,66.2,303183,61.6,22744,7.0
Florida,1980,4,4265827,56.5,4015812,53.2,250015,5.9
Georgia,1980,4,2526840,64.8,2367480,60.7,159360,6.3
Hawaii,1980,4,438991,66.4,418007,63.2,20984,4.8
Idaho,1980,4,430878,65.6,398346,60.6,32532,7.6
Illinois,1980,4,5536887,65.4,5112952,60.4,423935,7.7
Indiana,1980,4,2636078,65.8,2383215,59.4,252863,9.6
Iowa,1980,4,1439782,67.0,1361693,63.4,78089,5.4
Kansas,1980,4,1178444,67.9,1128550,65.0,49894,4.2
Kentucky,1980,4,1651922,62.5,1528036,57.8,123886,7.5
Louisiana,1980,4,1759585,59.3,1640266,55.3,119319,6.8
Maine,1980,4,506472,61.5,469656,57.0,36816,7.3
Maryland,1980,4,2136949,68.2,1998763,63.8,138186,6.5
Massachusetts,1980,4,2855983,65.4,2694623,61.7,161360,5.6
Michigan,1980,4,4348385,64.2,3826789,56.5,521596,12.0
Minnesota,1980,4,2093308,69.7,1973814,65.7,119494,5.7
Mississippi,1980,4,1048758,59.4,975621,55.2,73137,7.0
Missouri,1980,4,2330517,63.7,2170232,59.4,160285,6.9
Montana,1980,4,371500,64.8,348735,60.9,22765,6.1
Nebraska,1980,4,762319,66.5,735378,64.2,26941,3.5
Nevada,1980,4,424777,70.8,400108,66.7,24669,5.8
New Hampshire,1980,4,465636,68.5,445870,65.6,19766,4.2
New Jersey,1980,4,3582220,64.2,3335403,59.7,246817,6.9
New Mexico,1980,4,560903,61.2,519672,56.7,41231,7.4
New York,1980,4,7977848,60.0,7388893,55.6,588955,7.4
New York city,1980,4,3060226,55.5,2802494,50.8,257732,8.4
North Carolina,1980,4,2854107,66.7,2680689,62.6,173418,6.1
North Dakota,1980,4,302118,64.8,288337,61.9,13781,4.6
Ohio,1980,4,5064854,63.4,4673088,58.5,391766,7.7
Oklahoma,1980,4,1347146,61.0,1300360,58.9,46786,3.5
Oregon,1980,4,1282760,65.1,1179782,59.9,102978,8.0
Pennsylvania,1980,4,5441549,60.2,5007433,55.4,434116,8.0
Rhode Island,1980,4,469613,65.4,436391,60.8,33222,7.1
South Carolina,1980,4,1383802,62.6,1295594,58.6,88208,6.4
South Dakota,1980,4,330605,66.8,315864,63.8,14741,4.5
Tennessee,1980,4,2063617,60.8,1924433,56.7,139184,6.7
Texas,1980,4,6705365,66.0,6353160,62.5,352205,5.3
Utah,1980,4,629053,65.8,591558,61.9,37495,6.0
Vermont,1980,4,247705,65.9,233648,62.1,14057,5.7
Virginia,1980,4,2556111,66.0,2428507,62.7,127604,5.0
Washington,1980,4,1962271,64.4,1814013,59.6,148258,7.6
West Virginia,1980,4,768841,53.3,695821,48.3,73020,9.5
Wisconsin,1980,4,2344306,67.6,2185754,63.0,158552,6.8
Wyoming,1980,4,232851,69.9,224749,67.5,8102,3.5
Alabama,1980,5,1677891,59.4,1532322,54.2,145569,8.7
Alaska,1980,5,189352,72.0,170781,64.9,18571,9.8
Arizona,1980,5,1232546,62.1,1146803,57.7,85743,7.0
Arkansas,1980,5,988771,59.3,914652,54.8,74119,7.5
California,1980,5,11583664,65.6,10779902,61.1,803762,6.9
Los Angeles County,1980,5,3790728,67.3,3546278,63.0,244450,6.4
Colorado,1980,5,1495447,70.5,1406923,66.4,88524,5.9
Connecticut,1980,5,1587519,67.2,1497649,63.4,89870,5.7
Delaware,1980,5,283816,64.7,262476,59.8,21340,7.5
District of Columbia,1980,5,326014,66.3,302471,61.5,23543,7.2
Florida,1980,5,4273224,56.4,4017643,53.0,255581,6.0
Georgia,1980,5,2533169,64.8,2366155,60.5,167014,6.6
Hawaii,1980,5,439398,66.4,417935,63.1,21463,4.9
Idaho,1980,5,430194,65.4,396237,60.2,33957,7.9
Illinois,1980,5,5535656,65.4,5088188,60.1,447468,8.1
Indiana,1980,5,2633783,65.7,2364934,59.0,268849,10.2
Iowa,1980,5,1434524,66.7,1349858,62.8,84666,5.9
Kansas,1980,5,1180434,68.0,1127025,64.9,53409,4.5
Kentucky,1980,5,1656252,62.6,1524547,57.6,131705,8.0
Louisiana,1980,5,1761729,59.3,1641942,55.2,119787,6.8
Maine,1980,5,506944,61.4,468529,56.8,38415,7.6
Maryland,1980,5,2140034,68.2,1996039,63.6,143995,6.7
Massachusetts,1980,5,2855381,65.4,2689026,61.6,166355,5.8
Michigan,1980,5,4347575,64.2,3795714,56.1,551861,12.7
Minnesota,1980,5,2093625,69.7,1970298,65.6,123327,5.9
Mississippi,1980,5,1050223,59.4,974125,55.1,76098,7.2
Missouri,1980,5,2334226,63.8,2165374,59.2,168852,7.2
Montana,1980,5,370406,64.5,346886,60.4,23520,6.3
Nebraska,1980,5,763124,66.5,734086,64.0,29038,3.8
Nevada,1980,5,427585,71.0,401031,66.6,26554,6.2
New Hampshire,1980,5,466504,68.5,445214,65.4,21290,4.6
New Jersey,1980,5,3581465,64.1,3326998,59.5,254467,7.1
New Mexico,1980,5,561335,61.1,518937,56.5,42398,7.6
New York,1980,5,7966957,59.9,7368052,55.4,598905,7.5
New York city,1980,5,3058244,55.4,2799763,50.7,258481,8.5
North Carolina,1980,5,2857160,66.7,2670601,62.3,186559,6.5
North Dakota,1980,5,302550,64.9,287990,61.8,14560,4.8
Ohio,1980,5,5059701,63.3,4637913,58.1,421788,8.3
Oklahoma,1980,5,1350826,61.0,1301090,58.8,49736,3.7
Oregon,1980,5,1286563,65.2,1174855,59.6,111708,8.7
Pennsylvania,1980,5,5444936,60.2,4991058,55.2,453878,8.3
Rhode Island,1980,5,470215,65.4,435785,60.6,34430,7.3
South Carolina,1980,5,1388589,62.7,1296301,58.5,92288,6.6
South Dakota,1980,5,331245,66.9,315523,63.7,15722,4.7
Tennessee,1980,5,2061124,60.7,1915153,56.4,145971,7.1
Texas,1980,5,6721357,66.0,6360261,62.4,361096,5.4
Utah,1980,5,630358,65.8,591259,61.7,39099,6.2
Vermont,1980,5,248402,66.1,233543,62.1,14859,6.0
Virginia,1980,5,2558452,66.0,2424841,62.5,133611,5.2
Washington,1980,5,1963457,64.4,1808485,59.3,154972,7.9
West Virginia,1980,5,770466,53.4,693263,48.0,77203,10.0
Wisconsin,1980,5,2346779,67.6,2175493,62.7,171286,7.3
Wyoming,1980,5,233371,69.9,224983,67.4,8388,3.6
Alabama,1980,6,1680474,59.4,1529535,54.1,150939,9.0
Alaska,1980,6,189815,72.2,170757,64.9,19058,10.0
Arizona,1980,6,1237479,62.2,1147880,57.7,89599,7.2
Arkansas,1980,6,989246,59.2,912182,54.6,77064,7.8
California,1980,6,11606681,65.7,10779355,61.0,827326,7.1
Los Angeles County,1980,6,3794232,67.3,3539726,62.8,254506,6.7
Colorado,1980,6,1500264,70.6,1404902,66.1,95362,6.4
Connecticut,1980,6,1587804,67.1,1495629,63.2,92175,5.8
Delaware,1980,6,284029,64.6,261957,59.5,22072,7.8
District of Columbia,1980,6,325649,66.3,301382,61.4,24267,7.5
Florida,1980,6,4282520,56.4,4022095,52.9,260425,6.1
Georgia,1980,6,2538411,64.8,2366030,60.4,172381,6.8
Hawaii,1980,6,439811,66.3,417801,63.0,22010,5.0
Idaho,1980,6,429586,65.2,394740,59.9,34846,8.1
Illinois,1980,6,5536190,65.4,5067596,59.8,468594,8.5
Indiana,1980,6,2630561,65.6,2350360,58.6,280201,10.7
Iowa,1980,6,1428369,66.4,1337698,62.2,90671,6.3
Kansas,1980,6,1182210,68.0,1126166,64.8,56044,4.7
Kentucky,1980,6,1660973,62.7,1522321,57.5,138652,8.3
Louisiana,1980,6,1765950,59.3,1645035,55.2,120915,6.8
Maine,1980,6,507133,61.4,467459,56.6,39674,7.8
Maryland,1980,6,2143275,68.2,1994940,63.5,148335,6.9
Massachusetts,1980,6,2857415,65.4,2686940,61.5,170475,6.0
Michigan,1980,6,4344812,64.2,3771477,55.7,573335,13.2
Minnesota,1980,6,2095110,69.7,1968712,65.4,126398,6.0
Mississippi,1980,6,1051294,59.4,972655,55.0,78639,7.5
Missouri,1980,6,2337993,63.9,2162249,59.1,175744,7.5
Montana,1980,6,369629,64.4,345506,60.2,24123,6.5
Nebraska,1980,6,764159,66.6,733303,63.9,30856,4.0
Nevada,1980,6,430425,71.1,402242,66.5,28183,6.5
New Hampshire,1980,6,467256,68.5,444676,65.2,22580,4.8
New Jersey,1980,6,3581786,64.0,3320363,59.3,261423,7.3
New Mexico,1980,6,562090,61.0,518632,56.3,43458,7.7
New York,1980,6,7961264,59.8,7355112,55.3,606152,7.6
New York city,1980,6,3057311,55.4,2798455,50.7,258856,8.5
North Carolina,1980,6,2859286,66.6,2661826,62.0,197460,6.9
North Dakota,1980,6,303106,64.9,287774,61.6,15332,5.1
Ohio,1980,6,5057548,63.3,4610843,57.7,446705,8.8
Oklahoma,1980,6,1368684,61.7,1303385,58.8,65299,4.8
Oregon,1980,6,1289557,65.3,1171399,59.3,118158,9.2
Pennsylvania,1980,6,5448596,60.2,4978900,55.0,469696,8.6
Rhode Island,1980,6,470949,65.5,435411,60.6,35538,7.5
South Carolina,1980,6,1394359,62.8,1298452,58.5,95907,6.9
South Dakota,1980,6,331937,67.1,315453,63.7,16484,5.0
Tennessee,1980,6,2061139,60.6,1908735,56.2,152404,7.4
Texas,1980,6,6739558,66.0,6373850,62.4,365708,5.4
Utah,1980,6,631771,65.7,591270,61.5,40501,6.4
Vermont,1980,6,249185,66.1,233610,62.0,15575,6.3
Virginia,1980,6,2561628,65.9,2423264,62.4,138364,5.4
Washington,1980,6,1965357,64.3,1804597,59.1,160760,8.2
West Virginia,1980,6,771719,53.4,690883,47.8,80836,10.5
Wisconsin,1980,6,2348032,67.6,2167685,62.4,180347,7.7
Wyoming,1980,6,234146,69.9,225405,67.3,8741,3.7
Alabama,1980,7,1682886,59.4,1527894,54.0,154992,9.2
Alaska,1980,7,189938,71.9,170731,64.7,19207,10.1
Arizona,1980,7,1241034,62.2,1149473,57.6,91561,7.4
Arkansas,1980,7,990168,59.3,911065,54.5,79103,8.0
California,1980,7,11628111,65.7,10786083,60.9,842028,7.2
Los Angeles County,1980,7,3795024,67.2,3532698,62.6,262326,6.9
Colorado,1980,7,1504084,70.6,1404450,65.9,99634,6.6
Connecticut,1980,7,1587700,67.0,1494012,63.1,93688,5.9
Delaware,1980,7,284254,64.6,261712,59.5,22542,7.9
District of Columbia,1980,7,324781,66.1,299907,61.1,24874,7.7
Florida,1980,7,4295189,56.3,4031279,52.9,263910,6.1
Georgia,1980,7,2542320,64.8,2367843,60.3,174477,6.9
Hawaii,1980,7,440428,66.3,418040,63.0,22388,5.1
Idaho,1980,7,428923,65.0,393813,59.7,35110,8.2
Illinois,1980,7,5538134,65.3,5053315,59.6,484819,8.8
Indiana,1980,7,2625886,65.4,2341568,58.3,284318,10.8
Iowa,1980,7,1422270,66.1,1327560,61.7,94710,6.7
Kansas,1980,7,1183257,68.0,1125761,64.7,57496,4.9
Kentucky,1980,7,1665612,62.8,1521621,57.4,143991,8.6
Louisiana,1980,7,1772119,59.4,1649365,55.3,122754,6.9
Maine,1980,7,507054,61.4,466731,56.5,40323,8.0
Maryland,1980,7,2146185,68.2,1995601,63.4,150584,7.0
Massachusetts,1980,7,2862887,65.4,2689985,61.5,172902,6.0
Michigan,1980,7,4338870,64.1,3755570,55.5,583300,13.4
Minnesota,1980,7,2098132,69.7,1969956,65.4,128176,6.1
Mississippi,1980,7,1052253,59.4,971542,54.8,80711,7.7
Missouri,1980,7,2340590,63.9,2160620,59.0,179970,7.7
Montana,1980,7,369442,64.3,344905,60.0,24537,6.6
Nebraska,1980,7,765104,66.6,733017,63.8,32087,4.2
Nevada,1980,7,433130,71.4,403778,66.5,29352,6.8
New Hampshire,1980,7,467873,68.4,444501,65.0,23372,5.0
New Jersey,1980,7,3583348,64.0,3317114,59.2,266234,7.4
New Mexico,1980,7,563124,61.0,518818,56.2,44306,7.9
New York,1980,7,7959823,59.8,7350961,55.2,608862,7.6
New York city,1980,7,3056925,55.3,2798040,50.7,258885,8.5
North Carolina,1980,7,2860073,66.6,2656240,61.8,203833,7.1
North Dakota,1980,7,303679,65.0,287771,61.6,15908,5.2
Ohio,1980,7,5059265,63.3,4596549,57.5,462716,9.1
Oklahoma,1980,7,1377643,62.0,1307447,58.9,70196,5.1
Oregon,1980,7,1291914,65.4,1170690,59.2,121224,9.4
Pennsylvania,1980,7,5450646,60.2,4972918,54.9,477728,8.8
Rhode Island,1980,7,471654,65.5,435370,60.5,36284,7.7
South Carolina,1980,7,1399913,63.0,1301127,58.5,98786,7.1
South Dakota,1980,7,332552,67.2,315634,63.8,16918,5.1
Tennessee,1980,7,2063637,60.7,1906335,56.0,157302,7.6
Texas,1980,7,6761137,66.0,6393876,62.5,367261,5.4
Utah,1980,7,633275,65.8,591633,61.4,41642,6.6
Vermont,1980,7,249953,66.3,233884,62.0,16069,6.4
Virginia,1980,7,2564946,65.9,2424365,62.3,140581,5.5
Washington,1980,7,1968138,64.3,1803344,58.9,164794,8.4
West Virginia,1980,7,772400,53.5,689017,47.7,83383,10.8
Wisconsin,1980,7,2346853,67.5,2162536,62.2,184317,7.9
Wyoming,1980,7,235222,70.0,226045,67.3,9177,3.9
Alabama,1980,8,1684284,59.4,1526925,53.9,157359,9.3
Alaska,1980,8,189828,71.6,170768,64.4,19060,10.0
Arizona,1980,8,1243183,62.2,1152186,57.6,90997,7.3
Arkansas,1980,8,991719,59.3,911539,54.5,80180,8.1
California,1980,8,11644984,65.6,10798842,60.9,846142,7.3
Los Angeles County,1980,8,3793032,67.1,3526183,62.4,266849,7.0
Colorado,1980,8,1506620,70.6,1405916,65.9,100704,6.7
Connecticut,1980,8,1586890,66.9,1492691,62.9,94199,5.9
Delaware,1980,8,284400,64.5,261781,59.4,22619,8.0
District of Columbia,1980,8,323460,65.9,298141,60.7,25319,7.8
Florida,1980,8,4310744,56.4,4045174,52.9,265570,6.2
Georgia,1980,8,2544378,64.7,2371752,60.3,172626,6.8
Hawaii,1980,8,441296,66.4,418699,63.0,22597,5.1
Idaho,1980,8,428247,64.8,393475,59.5,34772,8.1
Illinois,1980,8,5539863,65.3,5045309,59.5,494554,8.9
Indiana,1980,8,2619930,65.2,2339471,58.3,280459,10.7
Iowa,1980,8,1417481,65.9,1321438,61.4,96043,6.8
Kansas,1980,8,1183191,68.0,1125492,64.6,57699,4.9
Kentucky,1980,8,1669490,62.9,1522192,57.4,147298,8.8
Louisiana,1980,8,1779984,59.6,1654585,55.4,125399,7.0
Maine,1980,8,506757,61.3,466451,56.4,40306,8.0
Maryland,1980,8,2148391,68.2,1997724,63.4,150667,7.0
Massachusetts,1980,8,2870867,65.6,2697566,61.6,173301,6.0
Michigan,1980,8,4329087,63.9,3747757,55.3,581330,13.4
Minnesota,1980,8,2102515,69.8,1974175,65.5,128340,6.1
Mississippi,1980,8,1053045,59.4,970733,54.7,82312,7.8
Missouri,1980,8,2341002,63.9,2159635,58.9,181367,7.7
Montana,1980,8,369990,64.3,345233,60.0,24757,6.7
Nebraska,1980,8,765646,66.6,733068,63.8,32578,4.3
Nevada,1980,8,435650,71.5,405566,66.6,30084,6.9
New Hampshire,1980,8,468404,68.4,444816,64.9,23588,5.0
New Jersey,1980,8,3585668,64.0,3317258,59.2,268410,7.5
New Mexico,1980,8,564432,61.1,519535,56.2,44897,8.0
New York,1980,8,7960540,59.8,7354004,55.2,606536,7.6
New York city,1980,8,3056559,55.3,2797998,50.6,258561,8.5
North Carolina,1980,8,2859729,66.4,2654799,61.7,204930,7.2
North Dakota,1980,8,304218,65.0,288032,61.5,16186,5.3
Ohio,1980,8,5063784,63.3,4594885,57.4,468899,9.3
Oklahoma,1980,8,1383370,62.2,1312870,59.0,70500,5.1
Oregon,1980,8,1293820,65.4,1173159,59.3,120661,9.3
Pennsylvania,1980,8,5449278,60.2,4973184,54.9,476094,8.7
Rhode Island,1980,8,472076,65.6,435629,60.5,36447,7.7
South Carolina,1980,8,1404244,63.1,1303584,58.5,100660,7.2
South Dakota,1980,8,333014,67.1,315958,63.7,17056,5.1
Tennessee,1980,8,2067698,60.7,1907567,56.0,160131,7.7
Texas,1980,8,6785866,66.1,6418555,62.5,367311,5.4
Utah,1980,8,634727,65.8,592253,61.4,42474,6.7
Vermont,1980,8,250597,66.3,234357,62.0,16240,6.5
Virginia,1980,8,2567653,65.9,2427873,62.3,139780,5.4
Washington,1980,8,1971446,64.3,1804970,58.9,166476,8.4
West Virginia,1980,8,772537,53.4,687867,47.6,84670,11.0
Wisconsin,1980,8,2361508,67.8,2159890,62.0,201618,8.5
Wyoming,1980,8,236514,70.2,226870,67.3,9644,4.1
Alabama,1980,9,1684447,59.4,1525980,53.8,158467,9.4
Alaska,1980,9,189664,71.3,170910,64.3,18754,9.9
Arizona,1980,9,1243927,62.0,1155825,57.6,88102,7.1
Arkansas,1980,9,994204,59.4,913628,54.6,80576,8.1
California,1980,9,11658002,65.6,10815487,60.9,842515,7.2
Los Angeles County,1980,9,3788623,67.0,3520560,62.2,268063,7.1
Colorado,1980,9,1508094,70.5,1408722,65.8,99372,6.6
Connecticut,1980,9,1585549,66.8,1491565,62.8,93984,5.9
Delaware,1980,9,284486,64.5,262093,59.4,22393,7.9
District of Columbia,1980,9,321834,65.5,296242,60.3,25592,8.0
Florida,1980,9,4328514,56.4,4062424,52.9,266090,6.1
Georgia,1980,9,2545312,64.6,2377297,60.4,168015,6.6
Hawaii,1980,9,442346,66.4,419649,63.0,22697,5.1
Idaho,1980,9,427664,64.6,393643,59.5,34021,8.0
Illinois,1980,9,5541179,65.3,5042905,59.4,498274,9.0
Indiana,1980,9,2614091,65.1,2343020,58.3,271071,10.4
Iowa,1980,9,1414918,65.7,1319918,61.3,95000,6.7
Kansas,1980,9,1182289,67.8,1125322,64.6,56967,4.8
Kentucky,1980,9,1672497,63.0,1523912,57.4,148585,8.9
Louisiana,1980,9,1789035,59.7,1660358,55.4,128677,7.2
Maine,1980,9,506478,61.2,466665,56.4,39813,7.9
Maryland,1980,9,2150024,68.1,2000785,63.4,149239,6.9
Massachusetts,1980,9,2880207,65.7,2707907,61.8,172300,6.0
Michigan,1980,9,4317021,63.7,3746005,55.3,571016,13.2
Minnesota,1980,9,2107759,69.9,1980673,65.7,127086,6.0
Mississippi,1980,9,1053566,59.3,970096,54.6,83470,7.9
Missouri,1980,9,2339459,63.8,2158619,58.9,180840,7.7
Montana,1980,9,371261,64.5,346412,60.1,24849,6.7
Nebraska,1980,9,765752,66.6,733346,63.8,32406,4.2
Nevada,1980,9,438029,71.6,407499,66.6,30530,7.0
New Hampshire,1980,9,469054,68.4,445717,65.0,23337,5.0
New Jersey,1980,9,3588653,63.9,3320014,59.2,268639,7.5
New Mexico,1980,9,566008,61.1,520762,56.2,45246,8.0
New York,1980,9,7963193,59.8,7361615,55.2,601578,7.6
New York city,1980,9,3056587,55.3,2798195,50.6,258392,8.5
North Carolina,1980,9,2859561,66.3,2657797,61.7,201764,7.1
North Dakota,1980,9,304754,65.1,288569,61.7,16185,5.3
Ohio,1980,9,5069771,63.3,4601487,57.5,468284,9.2
Oklahoma,1980,9,1387482,62.2,1319163,59.2,68319,4.9
Oregon,1980,9,1296197,65.4,1178184,59.5,118013,9.1
Pennsylvania,1980,9,5444732,60.1,4978180,54.9,466552,8.6
Rhode Island,1980,9,472209,65.5,436184,60.5,36025,7.6
South Carolina,1980,9,1407246,63.1,1305680,58.5,101566,7.2
South Dakota,1980,9,333374,67.2,316318,63.8,17056,5.1
Tennessee,1980,9,2072764,60.8,1911325,56.1,161439,7.8
Texas,1980,9,6813115,66.2,6446343,62.6,366772,5.4
Utah,1980,9,636013,65.7,593004,61.3,43009,6.8
Vermont,1980,9,251140,66.4,235036,62.2,16104,6.4
Virginia,1980,9,2570005,65.8,2432898,62.3,137107,5.3
Washington,1980,9,1975279,64.3,1808975,58.9,166304,8.4
West Virginia,1980,9,772547,53.4,687533,47.5,85014,11.0
Wisconsin,1980,9,2361355,67.8,2159440,62.0,201915,8.6
Wyoming,1980,9,237865,70.4,227813,67.4,10052,4.2
Alabama,1980,10,1683774,59.3,1524552,53.7,159222,9.5
Alaska,1980,10,189613,71.3,171186,64.4,18427,9.7
Arizona,1980,10,1243708,61.9,1159599,57.7,84109,6.8
Arkansas,1980,10,997626,59.6,916762,54.7,80864,8.1
California,1980,10,11668794,65.5,10832315,60.8,836479,7.2
Los Angeles County,1980,10,3781869,66.8,3514824,62.1,267045,7.1
Colorado,1980,10,1509468,70.4,1412241,65.8,97227,6.4
Connecticut,1980,10,1584399,66.7,1490746,62.7,93653,5.9
Delaware,1980,10,284590,64.5,262465,59.5,22125,7.8
District of Columbia,1980,10,320122,65.3,294343,60.1,25779,8.1
Florida,1980,10,4348009,56.5,4080865,53.0,267144,6.1
Georgia,1980,10,2546204,64.5,2383318,60.4,162886,6.4
Hawaii,1980,10,443539,66.5,420804,63.1,22735,5.1
Idaho,1980,10,427260,64.4,394138,59.4,33122,7.8
Illinois,1980,10,5542993,65.3,5044553,59.4,498440,9.0
Indiana,1980,10,2609740,64.9,2349479,58.4,260261,10.0
Iowa,1980,10,1414904,65.7,1322177,61.4,92727,6.6
Kansas,1980,10,1181171,67.7,1125301,64.5,55870,4.7
Kentucky,1980,10,1674885,63.0,1526677,57.5,148208,8.8
Louisiana,1980,10,1798408,59.9,1665949,55.5,132459,7.4
Maine,1980,10,506600,61.1,467380,56.4,39220,7.7
Maryland,1980,10,2151355,68.1,2003894,63.4,147461,6.9
Massachusetts,1980,10,2889614,65.9,2718477,62.0,171137,5.9
Michigan,1980,10,4305795,63.5,3747158,55.3,558637,13.0
Minnesota,1980,10,2113108,70.0,1987864,65.8,125244,5.9
Mississippi,1980,10,1053890,59.3,969359,54.5,84531,8.0
Missouri,1980,10,2336773,63.7,2157063,58.8,179710,7.7
Montana,1980,10,373039,64.7,348156,60.3,24883,6.7
Nebraska,1980,10,765613,66.5,733722,63.7,31891,4.2
Nevada,1980,10,440370,71.7,409469,66.7,30901,7.0
New Hampshire,1980,10,469976,68.4,447085,65.1,22891,4.9
New Jersey,1980,10,3592140,64.0,3323809,59.2,268331,7.5
New Mexico,1980,10,567782,61.2,522297,56.3,45485,8.0
New York,1980,10,7968175,59.8,7369830,55.3,598345,7.5
New York city,1980,10,3057812,55.3,2798165,50.6,259647,8.5
North Carolina,1980,10,2860649,66.3,2664378,61.7,196271,6.9
North Dakota,1980,10,305282,65.1,289251,61.7,16031,5.3
Ohio,1980,10,5076137,63.4,4610106,57.6,466031,9.2
Oklahoma,1980,10,1390605,62.3,1325903,59.4,64702,4.7
Oregon,1980,10,1300459,65.6,1184464,59.7,115995,8.9
Pennsylvania,1980,10,5440182,60.0,4985961,55.0,454221,8.3
Rhode Island,1980,10,472310,65.4,437033,60.5,35277,7.5
South Carolina,1980,10,1409551,63.1,1307427,58.5,102124,7.2
South Dakota,1980,10,333702,67.3,316613,63.8,17089,5.1
Tennessee,1980,10,2078885,60.9,1916199,56.1,162686,7.8
Texas,1980,10,6841575,66.3,6475138,62.8,366437,5.4
Utah,1980,10,637049,65.7,593774,61.2,43275,6.8
Vermont,1980,10,251674,66.6,235876,62.4,15798,6.3
Virginia,1980,10,2572979,65.8,2438368,62.4,134611,5.2
Washington,1980,10,1979856,64.3,1814001,58.9,165855,8.4
West Virginia,1980,10,772866,53.4,687877,47.5,84989,11.0
Wisconsin,1980,10,2357911,67.6,2160444,62.0,197467,8.4
Wyoming,1980,10,239145,70.5,228779,67.5,10366,4.3
Alabama,1980,11,1683165,59.2,1523039,53.6,160126,9.5
Alaska,1980,11,189777,71.1,171682,64.3,18095,9.5
Arizona,1980,11,1243372,61.7,1163086,57.7,80286,6.5
Arkansas,1980,11,1001805,59.7,920443,54.9,81362,8.1
California,1980,11,11680834,65.5,10849153,60.8,831681,7.1
Los Angeles County,1980,11,3773990,66.6,3509142,61.9,264848,7.0
Colorado,1980,11,1511699,70.3,1416373,65.9,95326,6.3
Connecticut,1980,11,1584038,66.6,1490457,62.7,93581,5.9
Delaware,1980,11,284824,64.4,262874,59.5,21950,7.7
District of Columbia,1980,11,318592,65.0,292688,59.7,25904,8.1
Florida,1980,11,4369528,56.6,4100019,53.1,269509,6.2
Georgia,1980,11,2548279,64.4,2389376,60.4,158903,6.2
Hawaii,1980,11,444847,66.6,422115,63.2,22732,5.1
Idaho,1980,11,427167,64.3,394951,59.5,32216,7.5
Illinois,1980,11,5547226,65.3,5050123,59.4,497103,9.0
Indiana,1980,11,2608771,64.9,2357280,58.6,251491,9.6
Iowa,1980,11,1417351,65.8,1326965,61.6,90386,6.4
Kansas,1980,11,1180561,67.7,1125737,64.5,54824,4.6
Kentucky,1980,11,1677030,63.1,1530346,57.6,146684,8.7
Louisiana,1980,11,1807615,60.2,1671114,55.6,136501,7.6
Maine,1980,11,507224,61.1,468566,56.5,38658,7.6
Maryland,1980,11,2152710,68.0,2006845,63.4,145865,6.8
Massachusetts,1980,11,2898275,66.0,2727655,62.1,170620,5.9
Michigan,1980,11,4298532,63.4,3750250,55.3,548282,12.8
Minnesota,1980,11,2118307,70.1,1994871,66.0,123436,5.8
Mississippi,1980,11,1054179,59.2,968613,54.4,85566,8.1
Missouri,1980,11,2334124,63.6,2155300,58.7,178824,7.7
Montana,1980,11,375050,65.0,350258,60.7,24792,6.6
Nebraska,1980,11,765616,66.5,734302,63.7,31314,4.1
Nevada,1980,11,442811,71.9,411522,66.8,31289,7.1
New Hampshire,1980,11,471273,68.5,448795,65.2,22478,4.8
New Jersey,1980,11,3596768,64.0,3328168,59.2,268600,7.5
New Mexico,1980,11,569661,61.3,524099,56.4,45562,8.0
New York,1980,11,7977595,59.8,7378582,55.3,599013,7.5
New York city,1980,11,3061766,55.3,2798957,50.5,262809,8.6
North Carolina,1980,11,2864365,66.3,2673502,61.9,190863,6.7
North Dakota,1980,11,305875,65.2,290012,61.8,15863,5.2
Ohio,1980,11,5082644,63.5,4617812,57.7,464832,9.1
Oklahoma,1980,11,1393430,62.3,1333061,59.6,60369,4.3
Oregon,1980,11,1306792,65.8,1190745,60.0,116047,8.9
Pennsylvania,1980,11,5439107,60.0,4995758,55.1,443349,8.2
Rhode Island,1980,11,472657,65.5,438145,60.7,34512,7.3
South Carolina,1980,11,1411935,63.1,1309217,58.5,102718,7.3
South Dakota,1980,11,334050,67.3,316867,63.9,17183,5.1
Tennessee,1980,11,2086586,61.1,1921761,56.3,164825,7.9
Texas,1980,11,6870471,66.4,6504739,62.9,365732,5.3
Utah,1980,11,637889,65.6,594660,61.2,43229,6.8
Vermont,1980,11,252270,66.6,236829,62.5,15441,6.1
Virginia,1980,11,2577244,65.8,2443598,62.4,133646,5.2
Washington,1980,11,1985164,64.4,1819040,59.0,166124,8.4
West Virginia,1980,11,773750,53.4,688841,47.5,84909,11.0
Wisconsin,1980,11,2356333,67.5,2163275,62.0,193058,8.2
Wyoming,1980,11,240360,70.7,229751,67.6,10609,4.4
Alabama,1980,12,1683630,59.2,1522224,53.5,161406,9.6
Alaska,1980,12,190229,71.0,172520,64.4,17709,9.3
Arizona,1980,12,1244212,61.6,1166841,57.8,77371,6.2
Arkansas,1980,12,1006658,60.0,924548,55.1,82110,8.2
California,1980,12,11699070,65.5,10869860,60.8,829210,7.1
Los Angeles County,1980,12,3767305,66.4,3505106,61.8,262199,7.0
Colorado,1980,12,1515156,70.3,1421383,66.0,93773,6.2
Connecticut,1980,12,1585073,66.5,1491220,62.6,93853,5.9
Delaware,1980,12,285281,64.5,263374,59.6,21907,7.7
District of Columbia,1980,12,317456,64.8,291513,59.5,25943,8.2
Florida,1980,12,4394409,56.7,4121336,53.2,273073,6.2
Georgia,1980,12,2552941,64.4,2396088,60.5,156853,6.1
Hawaii,1980,12,446234,66.7,423512,63.3,22722,5.1
Idaho,1980,12,427576,64.4,396218,59.7,31358,7.3
Illinois,1980,12,5555765,65.4,5060522,59.5,495243,8.9
Indiana,1980,12,2612443,64.9,2366012,58.8,246431,9.4
Iowa,1980,12,1421612,65.9,1333046,61.8,88566,6.2
Kansas,1980,12,1181101,67.6,1127155,64.5,53946,4.6
Kentucky,1980,12,1679115,63.1,1534517,57.6,144598,8.6
Louisiana,1980,12,1816595,60.3,1676409,55.7,140186,7.7
Maine,1980,12,508134,61.2,470104,56.6,38030,7.5
Maryland,1980,12,2154888,68.0,2010335,63.5,144553,6.7
Massachusetts,1980,12,2906274,66.1,2735296,62.2,170978,5.9
Michigan,1980,12,4296885,63.4,3756634,55.4,540251,12.6
Minnesota,1980,12,2123739,70.2,2001765,66.1,121974,5.7
Mississippi,1980,12,1054690,59.2,968298,54.3,86392,8.2
Missouri,1980,12,2332956,63.5,2154480,58.6,178476,7.7
Montana,1980,12,377179,65.3,352591,61.0,24588,6.5
Nebraska,1980,12,766189,66.5,735402,63.8,30787,4.0
Nevada,1980,12,445577,72.0,413867,66.9,31710,7.1
New Hampshire,1980,12,472993,68.5,450779,65.3,22214,4.7
New Jersey,1980,12,3603540,64.0,3333847,59.2,269693,7.5
New Mexico,1980,12,571637,61.3,526345,56.5,45292,7.9
New York,1980,12,7992929,59.9,7390440,55.4,602489,7.5
New York city,1980,12,3069233,55.4,2802095,50.6,267138,8.7
North Carolina,1980,12,2871037,66.3,2684057,62.0,186980,6.5
North Dakota,1980,12,306654,65.2,290899,61.9,15755,5.1
Ohio,1980,12,5090430,63.5,4625869,57.7,464561,9.1
Oklahoma,1980,12,1397123,62.3,1341084,59.8,56039,4.0
Oregon,1980,12,1314068,66.1,1196289,60.2,117779,9.0
Pennsylvania,1980,12,5443838,60.0,5007386,55.2,436452,8.0
Rhode Island,1980,12,473466,65.5,439504,60.8,33962,7.2
South Carolina,1980,12,1414904,63.1,1311554,58.5,103350,7.3
South Dakota,1980,12,334471,67.4,317223,64.0,17248,5.2
Tennessee,1980,12,2096357,61.3,1928393,56.4,167964,8.0
Texas,1980,12,6901394,66.5,6537127,63.0,364267,5.3
Utah,1980,12,638903,65.5,595974,61.1,42929,6.7
Vermont,1980,12,252989,66.8,237887,62.8,15102,6.0
Virginia,1980,12,2583162,65.9,2448440,62.4,134722,5.2
Washington,1980,12,1991160,64.5,1823745,59.0,167415,8.4
West Virginia,1980,12,775630,53.5,690413,47.6,85217,11.0
Wisconsin,1980,12,2358329,67.5,2168949,62.1,189380,8.0
Wyoming,1980,12,241578,70.6,230814,67.5,10764,4.5
Alabama,1981,1,1685498,59.2,1522218,53.4,163280,9.7
Alaska,1981,1,190991,71.0,173651,64.6,17340,9.1
Arizona,1981,1,1246734,61.6,1171248,57.8,75486,6.1
Arkansas,1981,1,1011856,60.2,928642,55.3,83214,8.2
California,1981,1,11723969,65.5,10894361,60.9,829608,7.1
Los Angeles County,1981,1,3762857,66.2,3502985,61.7,259872,6.9
Colorado,1981,1,1519614,70.4,1426873,66.1,92741,6.1
Connecticut,1981,1,1587478,66.6,1492994,62.6,94484,6.0
Delaware,1981,1,285848,64.5,263866,59.6,21982,7.7
District of Columbia,1981,1,316659,64.6,290723,59.3,25936,8.2
Florida,1981,1,4422672,56.9,4144893,53.3,277779,6.3
Georgia,1981,1,2560176,64.5,2403277,60.5,156899,6.1
Hawaii,1981,1,447619,66.8,424874,63.4,22745,5.1
Idaho,1981,1,428412,64.4,397745,59.8,30667,7.2
Illinois,1981,1,5568437,65.5,5075311,59.7,493126,8.9
Indiana,1981,1,2618895,65.0,2374142,59.0,244753,9.3
Iowa,1981,1,1426331,66.1,1338810,62.1,87521,6.1
Kansas,1981,1,1182700,67.7,1129454,64.6,53246,4.5
Kentucky,1981,1,1680890,63.1,1538381,57.7,142509,8.5
Louisiana,1981,1,1825169,60.5,1681880,55.8,143289,7.9
Maine,1981,1,509116,61.3,471673,56.8,37443,7.4
Maryland,1981,1,2158081,68.0,2014306,63.5,143775,6.7
Massachusetts,1981,1,2914164,66.2,2741869,62.3,172295,5.9
Michigan,1981,1,4300995,63.4,3767185,55.6,533810,12.4
Minnesota,1981,1,2129484,70.3,2008252,66.3,121232,5.7
Mississippi,1981,1,1055351,59.2,968574,54.3,86777,8.2
Missouri,1981,1,2333555,63.5,2154970,58.6,178585,7.7
Montana,1981,1,379245,65.6,354822,61.4,24423,6.4
Nebraska,1981,1,767411,66.5,737040,63.9,30371,4.0
Nevada,1981,1,448671,72.2,416536,67.1,32135,7.2
New Hampshire,1981,1,474882,68.7,452734,65.5,22148,4.7
New Jersey,1981,1,3611761,64.1,3340365,59.3,271396,7.5
New Mexico,1981,1,573650,61.4,528961,56.6,44689,7.8
New York,1981,1,8012355,60.0,7404757,55.4,607598,7.6
New York city,1981,1,3079680,55.5,2807605,50.6,272075,8.8
North Carolina,1981,1,2879752,66.4,2694609,62.2,185143,6.4
North Dakota,1981,1,307560,65.4,291844,62.1,15716,5.1
Ohio,1981,1,5099663,63.6,4635073,57.8,464590,9.1
Oklahoma,1981,1,1402254,62.4,1349893,60.1,52361,3.7
Oregon,1981,1,1321021,66.4,1200618,60.4,120403,9.1
Pennsylvania,1981,1,5453990,60.1,5019085,55.3,434905,8.0
Rhode Island,1981,1,474626,65.6,440906,61.0,33720,7.1
South Carolina,1981,1,1418507,63.2,1314353,58.5,104154,7.3
South Dakota,1981,1,334919,67.5,317704,64.1,17215,5.1
Tennessee,1981,1,2107537,61.6,1935409,56.5,172128,8.2
Texas,1981,1,6935389,66.7,6572110,63.2,363279,5.2
Utah,1981,1,640297,65.5,597770,61.2,42527,6.6
Vermont,1981,1,253865,66.8,239018,62.9,14847,5.8
Virginia,1981,1,2590292,66.0,2452455,62.5,137837,5.3
Washington,1981,1,1997590,64.5,1827884,59.1,169706,8.5
West Virginia,1981,1,778301,53.6,692068,47.7,86233,11.1
Wisconsin,1981,1,2363182,67.6,2176736,62.2,186446,7.9
Wyoming,1981,1,242807,70.8,232001,67.6,10806,4.5
Alabama,1981,2,1688377,59.2,1522734,53.4,165643,9.8
Alaska,1981,2,191959,71.4,174915,65.0,17044,8.9
Arizona,1981,2,1250512,61.6,1176120,57.9,74392,5.9
Arkansas,1981,2,1016623,60.5,932104,55.4,84519,8.3
California,1981,2,11750764,65.5,10918962,60.9,831802,7.1
Los Angeles County,1981,2,3760343,66.1,3502205,61.6,258138,6.9
Colorado,1981,2,1524485,70.4,1432404,66.2,92081,6.0
Connecticut,1981,2,1590456,66.6,1495144,62.6,95312,6.0
Delaware,1981,2,286384,64.6,264303,59.7,22081,7.7
District of Columbia,1981,2,315909,64.6,289944,59.3,25965,8.2
Florida,1981,2,4452450,57.1,4169086,53.5,283364,6.4
Georgia,1981,2,2568537,64.6,2410259,60.6,158278,6.2
Hawaii,1981,2,448880,66.9,426066,63.5,22814,5.1
Idaho,1981,2,429370,64.5,399083,59.9,30287,7.1
Illinois,1981,2,5583009,65.6,5093302,59.9,489707,8.8
Indiana,1981,2,2624955,65.2,2379944,59.1,245011,9.3
Iowa,1981,2,1429913,66.3,1342673,62.2,87240,6.1
Kansas,1981,2,1184629,67.7,1132047,64.7,52582,4.4
Kentucky,1981,2,1681597,63.1,1540934,57.8,140663,8.4
Louisiana,1981,2,1832920,60.7,1686833,55.8,146087,8.0
Maine,1981,2,509972,61.3,473058,56.9,36914,7.2
Maryland,1981,2,2161440,68.0,2017806,63.5,143634,6.6
Massachusetts,1981,2,2922141,66.4,2747802,62.4,174339,6.0
Michigan,1981,2,4307862,63.5,3780026,55.7,527836,12.3
Minnesota,1981,2,2134856,70.4,2013912,66.4,120944,5.7
Mississippi,1981,2,1056026,59.1,969344,54.3,86682,8.2
Missouri,1981,2,2334719,63.5,2156256,58.6,178463,7.6
Montana,1981,2,380921,65.8,356596,61.6,24325,6.4
Nebraska,1981,2,769093,66.6,739016,64.0,30077,3.9
Nevada,1981,2,451788,72.5,419338,67.3,32450,7.2
New Hampshire,1981,2,476546,68.9,454349,65.7,22197,4.7
New Jersey,1981,2,3619189,64.2,3346246,59.3,272943,7.5
New Mexico,1981,2,575452,61.5,531575,56.8,43877,7.6
New York,1981,2,8030887,60.1,7418444,55.5,612443,7.6
New York city,1981,2,3090801,55.7,2814202,50.7,276599,8.9
North Carolina,1981,2,2888410,66.6,2704649,62.3,183761,6.4
North Dakota,1981,2,308371,65.5,292685,62.1,15686,5.1
Ohio,1981,2,5108835,63.7,4644887,57.9,463948,9.1
Oklahoma,1981,2,1408484,62.6,1358844,60.4,49640,3.5
Oregon,1981,2,1326362,66.6,1203465,60.4,122897,9.3
Pennsylvania,1981,2,5466528,60.2,5029178,55.3,437350,8.0
Rhode Island,1981,2,475769,65.7,442012,61.1,33757,7.1
South Carolina,1981,2,1422364,63.2,1317216,58.5,105148,7.4
South Dakota,1981,2,335254,67.6,318223,64.2,17031,5.1
Tennessee,1981,2,2117526,61.8,1941013,56.6,176513,8.3
Texas,1981,2,6971036,66.9,6607523,63.4,363513,5.2
Utah,1981,2,641939,65.6,599799,61.3,42140,6.6
Vermont,1981,2,254817,67.1,240134,63.2,14683,5.8
Virginia,1981,2,2597419,66.0,2455304,62.4,142115,5.5
Washington,1981,2,2003585,64.6,1831159,59.1,172426,8.6
West Virginia,1981,2,780729,53.8,693293,47.7,87436,11.2
Wisconsin,1981,2,2368927,67.7,2184802,62.4,184125,7.8
Wyoming,1981,2,243999,70.9,233270,67.8,10729,4.4
Alabama,1981,3,1691098,59.2,1523245,53.4,167853,9.9
Alaska,1981,3,192992,71.5,176114,65.2,16878,8.7
Arizona,1981,3,1255162,61.7,1181441,58.1,73721,5.9
Arkansas,1981,3,1020332,60.7,934619,55.6,85713,8.4
California,1981,3,11774300,65.6,10941358,60.9,832942,7.1
Los Angeles County,1981,3,3759526,66.0,3503037,61.5,256489,6.8
Colorado,1981,3,1529299,70.5,1438251,66.3,91048,6.0
Connecticut,1981,3,1593354,66.7,1497309,62.7,96045,6.0
Delaware,1981,3,286890,64.8,264781,59.8,22109,7.7
District of Columbia,1981,3,314874,64.4,288819,59.1,26055,8.3
Florida,1981,3,4481415,57.3,4192596,53.6,288819,6.4
Georgia,1981,3,2576725,64.7,2417114,60.7,159611,6.2
Hawaii,1981,3,449883,66.9,427029,63.5,22854,5.1
Idaho,1981,3,430199,64.5,399978,60.0,30221,7.0
Illinois,1981,3,5596778,65.7,5112980,60.0,483798,8.6
Indiana,1981,3,2629283,65.2,2383795,59.2,245488,9.3
Iowa,1981,3,1431552,66.3,1344249,62.3,87303,6.1
Kansas,1981,3,1186223,67.7,1134536,64.8,51687,4.4
Kentucky,1981,3,1680588,63.0,1541350,57.8,139238,8.3
Louisiana,1981,3,1839670,60.8,1690744,55.9,148926,8.1
Maine,1981,3,510632,61.3,474287,56.9,36345,7.1
Maryland,1981,3,2164063,68.0,2020115,63.5,143948,6.7
Massachusetts,1981,3,2930165,66.5,2753577,62.5,176588,6.0
Michigan,1981,3,4313304,63.6,3792230,55.9,521074,12.1
Minnesota,1981,3,2139367,70.5,2018907,66.5,120460,5.6
Mississippi,1981,3,1056524,59.1,970317,54.3,86207,8.2
Missouri,1981,3,2334989,63.4,2157755,58.6,177234,7.6
Montana,1981,3,382037,65.9,357784,61.7,24253,6.3
Nebraska,1981,3,770955,66.7,741107,64.1,29848,3.9
Nevada,1981,3,454632,72.6,422111,67.4,32521,7.2
New Hampshire,1981,3,477764,68.9,455496,65.7,22268,4.7
New Jersey,1981,3,3623776,64.2,3350633,59.4,273143,7.5
New Mexico,1981,3,576868,61.5,533860,56.9,43008,7.5
New York,1981,3,8043149,60.2,7429098,55.6,614051,7.6
New York city,1981,3,3099106,55.8,2820239,50.8,278867,9.0
North Carolina,1981,3,2895278,66.6,2714311,62.5,180967,6.3
North Dakota,1981,3,308942,65.6,293371,62.3,15571,5.0
Ohio,1981,3,5116967,63.8,4655024,58.0,461943,9.0
Oklahoma,1981,3,1415073,62.8,1367229,60.7,47844,3.4
Oregon,1981,3,1329444,66.7,1205006,60.5,124438,9.4
Pennsylvania,1981,3,5478341,60.3,5037860,55.4,440481,8.0
Rhode Island,1981,3,476566,65.7,442613,61.1,33953,7.1
South Carolina,1981,3,1425845,63.3,1319659,58.5,106186,7.4
South Dakota,1981,3,335378,67.6,318723,64.3,16655,5.0
Tennessee,1981,3,2124340,61.9,1944627,56.7,179713,8.5
Texas,1981,3,7006295,67.0,6641393,63.5,364902,5.2
Utah,1981,3,643675,65.5,601852,61.3,41823,6.5
Vermont,1981,3,255719,67.3,241156,63.5,14563,5.7
Virginia,1981,3,2603817,66.1,2457617,62.4,146200,5.6
Washington,1981,3,2008451,64.7,1833337,59.0,175114,8.7
West Virginia,1981,3,781989,53.8,694112,47.8,87877,11.2
Wisconsin,1981,3,2373741,67.8,2191924,62.6,181817,7.7
Wyoming,1981,3,245133,71.1,234581,68.0,10552,4.3
Alabama,1981,4,1692219,59.2,1522540,53.3,169679,10.0
Alaska,1981,4,194082,71.6,177186,65.4,16896,8.7
Arizona,1981,4,1260215,61.8,1186880,58.2,73335,5.8
Arkansas,1981,4,1022615,60.7,935998,55.6,86617,8.5
California,1981,4,11790031,65.5,10957775,60.9,832256,7.1
Los Angeles County,1981,4,3759380,66.0,3504681,61.5,254699,6.8
Colorado,1981,4,1533694,70.5,1444505,66.4,89189,5.8
Connecticut,1981,4,1595715,66.7,1499120,62.7,96595,6.1
Delaware,1981,4,287384,64.7,265361,59.8,22023,7.7
District of Columbia,1981,4,313426,64.1,287224,58.7,26202,8.4
Florida,1981,4,4506802,57.4,4213318,53.7,293484,6.5
Georgia,1981,4,2583432,64.7,2423412,60.7,160020,6.2
Hawaii,1981,4,450484,66.9,427712,63.6,22772,5.1
Idaho,1981,4,430742,64.5,400312,59.9,30430,7.1
Illinois,1981,4,5607095,65.8,5130635,60.2,476460,8.5
Indiana,1981,4,2630786,65.3,2385645,59.2,245141,9.3
Iowa,1981,4,1431617,66.3,1344114,62.3,87503,6.1
Kansas,1981,4,1186766,67.7,1136311,64.9,50455,4.3
Kentucky,1981,4,1677559,62.8,1539336,57.7,138223,8.2
Louisiana,1981,4,1844965,60.8,1693226,55.8,151739,8.2
Maine,1981,4,511065,61.3,475296,57.0,35769,7.0
Maryland,1981,4,2165682,68.0,2020928,63.4,144754,6.7
Massachusetts,1981,4,2937365,66.6,2758556,62.6,178809,6.1
Michigan,1981,4,4313987,63.6,3799979,56.0,514008,11.9
Minnesota,1981,4,2142569,70.5,2023091,66.6,119478,5.6
Mississippi,1981,4,1056486,59.0,970766,54.2,85720,8.1
Missouri,1981,4,2333164,63.3,2158263,58.6,174901,7.5
Montana,1981,4,382612,66.0,358349,61.8,24263,6.3
Nebraska,1981,4,772540,66.8,742815,64.3,29725,3.8
Nevada,1981,4,457010,72.8,424674,67.6,32336,7.1
New Hampshire,1981,4,478494,68.9,456147,65.7,22347,4.7
New Jersey,1981,4,3624452,64.1,3352640,59.3,271812,7.5
New Mexico,1981,4,577678,61.5,535572,57.0,42106,7.3
New York,1981,4,8045767,60.2,7434257,55.6,611510,7.6
New York city,1981,4,3102234,55.8,2824213,50.8,278021,9.0
North Carolina,1981,4,2898812,66.6,2722236,62.5,176576,6.1
North Dakota,1981,4,309209,65.5,293846,62.3,15363,5.0
Ohio,1981,4,5122788,63.8,4663185,58.1,459603,9.0
Oklahoma,1981,4,1421146,62.9,1374305,60.9,46841,3.3
Oregon,1981,4,1330420,66.7,1205507,60.4,124913,9.4
Pennsylvania,1981,4,5485393,60.3,5043177,55.4,442216,8.1
Rhode Island,1981,4,476868,65.8,442678,61.1,34190,7.2
South Carolina,1981,4,1428230,63.3,1320903,58.5,107327,7.5
South Dakota,1981,4,335251,67.5,319063,64.2,16188,4.8
Tennessee,1981,4,2126974,61.9,1945659,56.7,181315,8.5
Texas,1981,4,7038486,67.2,6670790,63.7,367696,5.2
Utah,1981,4,645343,65.6,603704,61.4,41639,6.5
Vermont,1981,4,256470,67.3,241982,63.5,14488,5.6
Virginia,1981,4,2608524,66.1,2459378,62.3,149146,5.7
Washington,1981,4,2011743,64.7,1834123,59.0,177620,8.8
West Virginia,1981,4,781639,53.8,694600,47.8,87039,11.1
Wisconsin,1981,4,2376293,67.8,2197131,62.7,179162,7.5
Wyoming,1981,4,246171,71.1,235841,68.2,10330,4.2
Alabama,1981,5,1690978,59.1,1519595,53.1,171383,10.1
Alaska,1981,5,195256,71.8,178121,65.5,17135,8.8
Arizona,1981,5,1264947,61.9,1191756,58.3,73191,5.8
Arkansas,1981,5,1023402,60.7,936357,55.6,87045,8.5
California,1981,5,11796687,65.5,10965053,60.8,831634,7.0
Los Angeles County,1981,5,3758589,65.9,3505475,61.5,253114,6.7
Colorado,1981,5,1537296,70.5,1450725,66.5,86571,5.6
Connecticut,1981,5,1597195,66.7,1500200,62.7,96995,6.1
Delaware,1981,5,287855,64.8,266009,59.9,21846,7.6
District of Columbia,1981,5,311757,63.8,285360,58.4,26397,8.5
Florida,1981,5,4526968,57.5,4229482,53.7,297486,6.6
Georgia,1981,5,2588069,64.7,2428358,60.7,159711,6.2
Hawaii,1981,5,450659,66.9,428068,63.5,22591,5.0
Idaho,1981,5,430835,64.4,399971,59.8,30864,7.2
Illinois,1981,5,5611739,65.8,5142327,60.3,469412,8.4
Indiana,1981,5,2628998,65.2,2384868,59.1,244130,9.3
Iowa,1981,5,1430813,66.2,1342827,62.2,87986,6.1
Kansas,1981,5,1185871,67.6,1136715,64.8,49156,4.1
Kentucky,1981,5,1672869,62.6,1535277,57.5,137592,8.2
Louisiana,1981,5,1848021,60.9,1694308,55.8,153713,8.3
Maine,1981,5,511265,61.3,475948,57.1,35317,6.9
Maryland,1981,5,2166227,67.9,2020196,63.3,146031,6.7
Massachusetts,1981,5,2942698,66.7,2761727,62.6,180971,6.1
Michigan,1981,5,4308744,63.5,3801140,56.0,507604,11.8
Minnesota,1981,5,2144086,70.5,2025861,66.6,118225,5.5
Mississippi,1981,5,1055682,58.9,970140,54.1,85542,8.1
Missouri,1981,5,2329089,63.2,2156721,58.5,172368,7.4
Montana,1981,5,382692,65.9,358286,61.7,24406,6.4
Nebraska,1981,5,773510,66.9,743683,64.3,29827,3.9
Nevada,1981,5,458890,72.8,426828,67.8,32062,7.0
New Hampshire,1981,5,478788,68.8,456324,65.6,22464,4.7
New Jersey,1981,5,3621013,64.0,3351766,59.3,269247,7.4
New Mexico,1981,5,577753,61.4,536576,57.0,41177,7.1
New York,1981,5,8037871,60.1,7432667,55.5,605204,7.5
New York city,1981,5,3099847,55.8,2825433,50.8,274414,8.9
North Carolina,1981,5,2897988,66.5,2726837,62.6,171151,5.9
North Dakota,1981,5,309235,65.5,294113,62.3,15122,4.9
Ohio,1981,5,5124578,63.8,4665650,58.1,458928,9.0
Oklahoma,1981,5,1426165,63.0,1379714,61.0,46451,3.3
Oregon,1981,5,1329992,66.6,1205319,60.3,124673,9.4
Pennsylvania,1981,5,5485295,60.3,5042858,55.4,442437,8.1
Rhode Island,1981,5,476739,65.7,442285,60.9,34454,7.2
South Carolina,1981,5,1429164,63.2,1320394,58.4,108770,7.6
South Dakota,1981,5,334855,67.4,319103,64.2,15752,4.7
Tennessee,1981,5,2125265,61.8,1943428,56.5,181837,8.6
Texas,1981,5,7065284,67.3,6693816,63.7,371468,5.3
Utah,1981,5,646764,65.6,605129,61.4,41635,6.4
Vermont,1981,5,257009,67.5,242550,63.7,14459,5.6
Virginia,1981,5,2610903,66.1,2460177,62.3,150726,5.8
Washington,1981,5,2013005,64.6,1833151,58.8,179854,8.9
West Virginia,1981,5,779792,53.6,694813,47.8,84979,10.9
Wisconsin,1981,5,2376251,67.7,2199665,62.7,176586,7.4
Wyoming,1981,5,247014,71.2,236912,68.3,10102,4.1
Alabama,1981,6,1687704,58.9,1514252,52.9,173452,10.3
Alaska,1981,6,196600,72.3,179044,65.8,17556,8.9
Arizona,1981,6,1269046,61.9,1195802,58.4,73244,5.8
Arkansas,1981,6,1023234,60.7,936142,55.5,87092,8.5
California,1981,6,11798722,65.4,10964400,60.7,834322,7.1
Los Angeles County,1981,6,3757110,65.8,3504811,61.4,252299,6.7
Colorado,1981,6,1540648,70.5,1456853,66.7,83795,5.4
Connecticut,1981,6,1598138,66.7,1500772,62.6,97366,6.1
Delaware,1981,6,288207,64.8,266530,59.9,21677,7.5
District of Columbia,1981,6,310109,63.5,283513,58.1,26596,8.6
Florida,1981,6,4542138,57.5,4240700,53.7,301438,6.6
Georgia,1981,6,2591462,64.7,2431836,60.7,159626,6.2
Hawaii,1981,6,450590,66.8,428126,63.4,22464,5.0
Idaho,1981,6,430575,64.3,399165,59.6,31410,7.3
Illinois,1981,6,5610993,65.8,5146700,60.3,464293,8.3
Indiana,1981,6,2624799,65.1,2381500,59.0,243299,9.3
Iowa,1981,6,1429749,66.2,1340846,62.0,88903,6.2
Kansas,1981,6,1183879,67.5,1135755,64.7,48124,4.1
Kentucky,1981,6,1667502,62.4,1529958,57.2,137544,8.2
Louisiana,1981,6,1849087,60.8,1694461,55.7,154626,8.4
Maine,1981,6,511432,61.2,476265,57.0,35167,6.9
Maryland,1981,6,2166128,67.8,2018263,63.2,147865,6.8
Massachusetts,1981,6,2946206,66.7,2762950,62.5,183256,6.2
Michigan,1981,6,4299513,63.4,3796103,55.9,503410,11.7
Minnesota,1981,6,2144209,70.4,2026785,66.6,117424,5.5
Mississippi,1981,6,1054262,58.8,968356,54.0,85906,8.1
Missouri,1981,6,2323888,63.0,2153148,58.4,170740,7.3
Montana,1981,6,382498,65.8,357791,61.6,24707,6.5
Nebraska,1981,6,773861,66.8,743631,64.2,30230,3.9
Nevada,1981,6,460528,72.8,428591,67.7,31937,6.9
New Hampshire,1981,6,478864,68.7,456138,65.4,22726,4.7
New Jersey,1981,6,3614634,63.9,3348557,59.2,266077,7.4
New Mexico,1981,6,577415,61.2,537073,57.0,40342,7.0
New York,1981,6,8022179,59.9,7425334,55.5,596845,7.4
New York city,1981,6,3093862,55.6,2824357,50.8,269505,8.7
North Carolina,1981,6,2894007,66.3,2728256,62.5,165751,5.7
North Dakota,1981,6,309205,65.4,294297,62.2,14908,4.8
Ohio,1981,6,5122315,63.8,4660241,58.0,462074,9.0
Oklahoma,1981,6,1430233,63.1,1383680,61.1,46553,3.3
Oregon,1981,6,1328771,66.4,1204448,60.2,124323,9.4
Pennsylvania,1981,6,5479478,60.2,5037093,55.3,442385,8.1
Rhode Island,1981,6,476362,65.6,441625,60.8,34737,7.3
South Carolina,1981,6,1429279,63.1,1318419,58.2,110860,7.8
South Dakota,1981,6,334317,67.3,318845,64.2,15472,4.6
Tennessee,1981,6,2120604,61.6,1938384,56.3,182220,8.6
Texas,1981,6,7086544,67.3,6711343,63.7,375201,5.3
Utah,1981,6,648019,65.5,606220,61.3,41799,6.5
Vermont,1981,6,257385,67.4,242907,63.6,14478,5.6
Virginia,1981,6,2611606,66.0,2460094,62.2,151512,5.8
Washington,1981,6,2012251,64.5,1830205,58.6,182046,9.0
West Virginia,1981,6,777053,53.4,694935,47.7,82118,10.6
Wisconsin,1981,6,2374731,67.6,2199478,62.6,175253,7.4
Wyoming,1981,6,247664,71.2,237747,68.3,9917,4.0
Alabama,1981,7,1683638,58.7,1506961,52.6,176677,10.5
Alaska,1981,7,198164,72.6,180052,66.0,18112,9.1
Arizona,1981,7,1272625,62.0,1198644,58.4,73981,5.8
Arkansas,1981,7,1022961,60.6,935714,55.4,87247,8.5
California,1981,7,11803386,65.3,10958160,60.6,845226,7.2
Los Angeles County,1981,7,3756323,65.7,3502850,61.3,253473,6.7
Colorado,1981,7,1544166,70.5,1462378,66.8,81788,5.3
Connecticut,1981,7,1599354,66.7,1501305,62.6,98049,6.1
Delaware,1981,7,288380,64.8,266717,59.9,21663,7.5
District of Columbia,1981,7,308672,63.3,281836,57.8,26836,8.7
Florida,1981,7,4553762,57.5,4246980,53.6,306782,6.7
Georgia,1981,7,2594830,64.6,2433524,60.6,161306,6.2
Hawaii,1981,7,450497,66.6,427986,63.3,22511,5.0
Idaho,1981,7,430252,64.1,398179,59.3,32073,7.5
Illinois,1981,7,5606767,65.7,5143544,60.3,463223,8.3
Indiana,1981,7,2620040,64.9,2375622,58.8,244418,9.3
Iowa,1981,7,1429031,66.1,1338410,61.9,90621,6.3
Kansas,1981,7,1181449,67.3,1133743,64.6,47706,4.0
Kentucky,1981,7,1662527,62.1,1523832,56.9,138695,8.3
Louisiana,1981,7,1849329,60.7,1694063,55.6,155266,8.4
Maine,1981,7,511883,61.2,476401,57.0,35482,6.9
Maryland,1981,7,2166150,67.7,2015545,63.0,150605,7.0
Massachusetts,1981,7,2948906,66.7,2762612,62.5,186294,6.3
Michigan,1981,7,4290056,63.2,3785395,55.8,504661,11.8
Minnesota,1981,7,2143749,70.3,2025780,66.5,117969,5.5
Mississippi,1981,7,1052811,58.6,965661,53.8,87150,8.3
Missouri,1981,7,2319107,62.8,2147888,58.2,171219,7.4
Montana,1981,7,382417,65.7,357190,61.4,25227,6.6
Nebraska,1981,7,773817,66.8,742821,64.1,30996,4.0
Nevada,1981,7,462239,72.8,430012,67.7,32227,7.0
New Hampshire,1981,7,479025,68.6,455765,65.3,23260,4.9
New Jersey,1981,7,3607866,63.7,3343907,59.0,263959,7.3
New Mexico,1981,7,577134,61.1,537341,56.9,39793,6.9
New York,1981,7,8004179,59.8,7413783,55.3,590396,7.4
New York city,1981,7,3087531,55.5,2821674,50.7,265857,8.6
North Carolina,1981,7,2889188,66.1,2727440,62.4,161748,5.6
North Dakota,1981,7,309320,65.4,294529,62.3,14791,4.8
Ohio,1981,7,5118066,63.7,4646606,57.8,471460,9.2
Oklahoma,1981,7,1433776,63.2,1386470,61.1,47306,3.3
Oregon,1981,7,1327746,66.3,1202739,60.1,125007,9.4
Pennsylvania,1981,7,5471378,60.0,5026919,55.2,444459,8.1
Rhode Island,1981,7,476098,65.5,440890,60.6,35208,7.4
South Carolina,1981,7,1429774,63.0,1315520,58.0,114254,8.0
South Dakota,1981,7,333774,67.2,318338,64.1,15436,4.6
Tennessee,1981,7,2115315,61.4,1931548,56.1,183767,8.7
Texas,1981,7,7103336,67.3,6724751,63.7,378585,5.3
Utah,1981,7,649353,65.5,607110,61.3,42243,6.5
Vermont,1981,7,257719,67.5,243123,63.6,14596,5.7
Virginia,1981,7,2611890,65.9,2459075,62.1,152815,5.9
Washington,1981,7,2009828,64.3,1824962,58.3,184866,9.2
West Virginia,1981,7,774319,53.1,695020,47.7,79299,10.2
Wisconsin,1981,7,2373369,67.5,2196959,62.5,176410,7.4
Wyoming,1981,7,248189,71.1,238352,68.3,9837,4.0
Alabama,1981,8,1680501,58.6,1498987,52.2,181514,10.8
Alaska,1981,8,199895,72.7,181194,65.9,18701,9.4
Arizona,1981,8,1276300,62.0,1200097,58.3,76203,6.0
Arkansas,1981,8,1022897,60.6,935039,55.4,87858,8.6
California,1981,8,11815570,65.2,10948874,60.4,866696,7.3
Los Angeles County,1981,8,3756617,65.6,3498981,61.1,257636,6.9
Colorado,1981,8,1547783,70.5,1466635,66.8,81148,5.2
Connecticut,1981,8,1601367,66.7,1502129,62.6,99238,6.2
Delaware,1981,8,288452,64.7,266556,59.8,21896,7.6
District of Columbia,1981,8,307583,63.0,280473,57.5,27110,8.8
Florida,1981,8,4563563,57.4,4249731,53.5,313832,6.9
Georgia,1981,8,2599069,64.6,2433433,60.5,165636,6.4
Hawaii,1981,8,450550,66.6,427797,63.2,22753,5.1
Idaho,1981,8,430119,64.0,397205,59.1,32914,7.7
Illinois,1981,8,5600965,65.6,5134016,60.1,466949,8.3
Indiana,1981,8,2616148,64.8,2367169,58.6,248979,9.5
Iowa,1981,8,1428597,66.1,1335271,61.8,93326,6.5
Kansas,1981,8,1179222,67.1,1131088,64.4,48134,4.1
Kentucky,1981,8,1658753,61.9,1517482,56.7,141271,8.5
Louisiana,1981,8,1849501,60.6,1693125,55.5,156376,8.5
Maine,1981,8,512712,61.3,476486,56.9,36226,7.1
Maryland,1981,8,2166828,67.7,2012493,62.9,154335,7.1
Massachusetts,1981,8,2951828,66.7,2761367,62.4,190461,6.5
Michigan,1981,8,4283450,63.1,3770015,55.6,513435,12.0
Minnesota,1981,8,2143405,70.3,2023287,66.3,120118,5.6
Mississippi,1981,8,1051886,58.5,962669,53.5,89217,8.5
Missouri,1981,8,2316019,62.7,2141786,58.0,174233,7.5
Montana,1981,8,382585,65.6,356685,61.2,25900,6.8
Nebraska,1981,8,773671,66.8,741638,64.0,32033,4.1
Nevada,1981,8,464177,72.9,431174,67.7,33003,7.1
New Hampshire,1981,8,479427,68.6,455343,65.1,24084,5.0
New Jersey,1981,8,3602812,63.5,3338581,58.9,264231,7.3
New Mexico,1981,8,577306,61.0,537609,56.8,39697,6.9
New York,1981,8,7989004,59.6,7400061,55.2,588943,7.4
New York city,1981,8,3083186,55.4,2817778,50.6,265408,8.6
North Carolina,1981,8,2885281,65.9,2724498,62.2,160783,5.6
North Dakota,1981,8,309637,65.3,294837,62.2,14800,4.8
Ohio,1981,8,5113477,63.6,4626744,57.5,486733,9.5
Oklahoma,1981,8,1437420,63.1,1388545,61.0,48875,3.4
Oregon,1981,8,1327385,66.3,1200036,59.9,127349,9.6
Pennsylvania,1981,8,5463821,59.9,5013039,55.0,450782,8.3
Rhode Island,1981,8,476194,65.5,440189,60.5,36005,7.6
South Carolina,1981,8,1431363,63.0,1312495,57.8,118868,8.3
South Dakota,1981,8,333273,67.1,317695,63.9,15578,4.7
Tennessee,1981,8,2110879,61.2,1923742,55.8,187137,8.9
Texas,1981,8,7116988,67.2,6735502,63.6,381486,5.4
Utah,1981,8,650929,65.6,607947,61.2,42982,6.6
Vermont,1981,8,258112,67.6,243253,63.7,14859,5.8
Virginia,1981,8,2612628,65.8,2457170,61.9,155458,6.0
Washington,1981,8,2006766,64.1,1817850,58.1,188916,9.4
West Virginia,1981,8,772309,53.0,695005,47.7,77304,10.0
Wisconsin,1981,8,2373326,67.5,2192921,62.3,180405,7.6
Wyoming,1981,8,248624,71.0,238748,68.2,9876,4.0
Alabama,1981,9,1679619,58.5,1491854,52.0,187765,11.2
Alaska,1981,9,201610,73.0,182413,66.1,19197,9.5
Arizona,1981,9,1280890,62.0,1200974,58.2,79916,6.2
Arkansas,1981,9,1022891,60.5,933923,55.3,88968,8.7
California,1981,9,11836665,65.2,10939588,60.3,897077,7.6
Los Angeles County,1981,9,3758434,65.6,3493690,60.9,264744,7.0
Colorado,1981,9,1551398,70.5,1469377,66.7,82021,5.3
Connecticut,1981,9,1604252,66.8,1503406,62.6,100846,6.3
Delaware,1981,9,288559,64.7,266176,59.7,22383,7.8
District of Columbia,1981,9,306920,63.0,279527,57.4,27393,8.9
Florida,1981,9,4573121,57.4,4251210,53.4,321911,7.0
Georgia,1981,9,2604125,64.7,2432272,60.4,171853,6.6
Hawaii,1981,9,450801,66.5,427609,63.1,23192,5.1
Idaho,1981,9,430412,64.0,396399,58.9,34013,7.9
Illinois,1981,9,5595793,65.5,5120853,60.0,474940,8.5
Indiana,1981,9,2613766,64.7,2356868,58.4,256898,9.8
Iowa,1981,9,1428186,66.1,1331501,61.6,96685,6.8
Kansas,1981,9,1177519,66.9,1128133,64.1,49386,4.2
Kentucky,1981,9,1656552,61.8,1511642,56.4,144910,8.7
Louisiana,1981,9,1850202,60.5,1691667,55.3,158535,8.6
Maine,1981,9,513795,61.4,476559,56.9,37236,7.2
Maryland,1981,9,2168432,67.7,2009515,62.7,158917,7.3
Massachusetts,1981,9,2955256,66.8,2759664,62.4,195592,6.6
Michigan,1981,9,4280878,63.1,3752131,55.3,528747,12.4
Minnesota,1981,9,2143528,70.2,2020017,66.2,123511,5.8
Mississippi,1981,9,1051926,58.5,959996,53.4,91930,8.7
Missouri,1981,9,2315064,62.7,2135803,57.8,179261,7.7
Montana,1981,9,382951,65.7,356337,61.1,26614,6.9
Nebraska,1981,9,773610,66.7,740435,63.8,33175,4.3
Nevada,1981,9,466393,73.0,432206,67.6,34187,7.3
New Hampshire,1981,9,480084,68.6,454901,65.0,25183,5.2
New Jersey,1981,9,3600564,63.4,3333098,58.7,267466,7.4
New Mexico,1981,9,578175,60.9,538077,56.7,40098,6.9
New York,1981,9,7979395,59.5,7386136,55.1,593259,7.4
New York city,1981,9,3081423,55.3,2813357,50.5,268066,8.7
North Carolina,1981,9,2883207,65.8,2719769,62.1,163438,5.7
North Dakota,1981,9,310105,65.4,295194,62.3,14911,4.8
Ohio,1981,9,5110039,63.5,4604897,57.3,505142,9.9
Oklahoma,1981,9,1441656,63.1,1390344,60.9,51312,3.6
Oregon,1981,9,1327227,66.3,1196392,59.8,130835,9.9
Pennsylvania,1981,9,5458833,59.9,4996878,54.8,461955,8.5
Rhode Island,1981,9,476646,65.5,439570,60.4,37076,7.8
South Carolina,1981,9,1434226,63.0,1310205,57.6,124021,8.6
South Dakota,1981,9,332793,67.0,317047,63.8,15746,4.7
Tennessee,1981,9,2107357,61.1,1915207,55.5,192150,9.1
Texas,1981,9,7129802,67.1,6745214,63.5,384588,5.4
Utah,1981,9,652786,65.6,608914,61.2,43872,6.7
Vermont,1981,9,258581,67.5,243333,63.5,15248,5.9
Virginia,1981,9,2614404,65.8,2454812,61.8,159592,6.1
Washington,1981,9,2004403,64.0,1809930,57.8,194473,9.7
West Virginia,1981,9,771377,52.9,694769,47.7,76608,9.9
Wisconsin,1981,9,2375099,67.5,2188645,62.2,186454,7.9
Wyoming,1981,9,249015,70.9,239003,68.1,10012,4.0
Alabama,1981,10,1681576,58.5,1486599,51.7,194977,11.6
Alaska,1981,10,203206,73.1,183641,66.1,19565,9.6
Arizona,1981,10,1286900,62.1,1202269,58.1,84631,6.6
Arkansas,1981,10,1022800,60.5,932339,55.2,90461,8.8
California,1981,10,11866712,65.3,10932487,60.1,934225,7.9
Los Angeles County,1981,10,3762794,65.5,3488416,60.8,274378,7.3
Colorado,1981,10,1554880,70.5,1470419,66.6,84461,5.4
Connecticut,1981,10,1607678,66.9,1504921,62.6,102757,6.4
Delaware,1981,10,288841,64.6,265811,59.5,23030,8.0
District of Columbia,1981,10,306668,63.0,278946,57.3,27722,9.0
Florida,1981,10,4583662,57.4,4253200,53.3,330462,7.2
Georgia,1981,10,2609757,64.7,2431170,60.3,178587,6.8
Hawaii,1981,10,451211,66.5,427350,62.9,23861,5.3
Idaho,1981,10,431321,64.1,395910,58.8,35411,8.2
Illinois,1981,10,5592736,65.5,5106154,59.8,486582,8.7
Indiana,1981,10,2613124,64.7,2345649,58.1,267475,10.2
Iowa,1981,10,1427339,66.0,1326954,61.4,100385,7.0
Kansas,1981,10,1176580,66.9,1125240,63.9,51340,4.4
Kentucky,1981,10,1655770,61.8,1506595,56.2,149175,9.0
Louisiana,1981,10,1852027,60.4,1690004,55.2,162023,8.7
Maine,1981,10,514978,61.5,476538,56.9,38440,7.5
Maryland,1981,10,2171116,67.7,2006970,62.6,164146,7.6
Massachusetts,1981,10,2959274,66.8,2757816,62.3,201458,6.8
Michigan,1981,10,4282783,63.2,3733727,55.1,549056,12.8
Minnesota,1981,10,2144485,70.2,2016749,66.0,127736,6.0
Mississippi,1981,10,1053099,58.5,958162,53.2,94937,9.0
Missouri,1981,10,2316130,62.7,2130626,57.7,185504,8.0
Montana,1981,10,383517,65.7,356121,61.0,27396,7.1
Nebraska,1981,10,773767,66.7,739426,63.7,34341,4.4
Nevada,1981,10,468849,73.1,433194,67.6,35655,7.6
New Hampshire,1981,10,480938,68.6,454452,64.8,26486,5.5
New Jersey,1981,10,3601658,63.4,3327949,58.6,273709,7.6
New Mexico,1981,10,579744,61.0,538842,56.7,40902,7.1
New York,1981,10,7977109,59.5,7374003,55.0,603106,7.6
New York city,1981,10,3082355,55.3,2809542,50.4,272813,8.9
North Carolina,1981,10,2924852,66.7,2713870,61.8,210982,7.2
North Dakota,1981,10,310663,65.4,295579,62.2,15084,4.9
Ohio,1981,10,5109162,63.5,4584313,57.0,524849,10.3
Oklahoma,1981,10,1446604,63.1,1392077,60.8,54527,3.8
Oregon,1981,10,1326835,66.3,1192007,59.5,134828,10.2
Pennsylvania,1981,10,5457418,59.8,4980051,54.6,477367,8.7
Rhode Island,1981,10,477330,65.6,439008,60.3,38322,8.0
South Carolina,1981,10,1438466,63.1,1309367,57.5,129099,9.0
South Dakota,1981,10,332386,66.9,316513,63.7,15873,4.8
Tennessee,1981,10,2104724,61.0,1905990,55.2,198734,9.4
Texas,1981,10,7145053,67.0,6755616,63.3,389437,5.5
Utah,1981,10,654957,65.7,610111,61.2,44846,6.8
Vermont,1981,10,259093,67.6,243412,63.6,15681,6.1
Virginia,1981,10,2617504,65.8,2452315,61.6,165189,6.3
Washington,1981,10,2003785,63.9,1802612,57.5,201173,10.0
West Virginia,1981,10,771592,52.9,694211,47.6,77381,10.0
Wisconsin,1981,10,2378284,67.5,2185301,62.0,192983,8.1
Wyoming,1981,10,249335,71.0,239203,68.1,10132,4.1
Alabama,1981,11,1685624,58.6,1483079,51.6,202545,12.0
Alaska,1981,11,204485,73.3,184652,66.2,19833,9.7
Arizona,1981,11,1293525,62.3,1203518,58.0,90007,7.0
Arkansas,1981,11,1022290,60.5,930170,55.0,92120,9.0
California,1981,11,11901732,65.4,10926218,60.0,975514,8.2
Los Angeles County,1981,11,3769290,65.6,3483593,60.6,285697,7.6
Colorado,1981,11,1557866,70.4,1469637,66.4,88229,5.7
Connecticut,1981,11,1610840,67.0,1506029,62.6,104811,6.5
Delaware,1981,11,289362,64.7,265644,59.4,23718,8.2
District of Columbia,1981,11,306649,63.0,278495,57.2,28154,9.2
Florida,1981,11,4595133,57.4,4255819,53.2,339314,7.4
Georgia,1981,11,2615247,64.7,2430460,60.2,184787,7.1
Hawaii,1981,11,451606,66.3,426900,62.7,24706,5.5
Idaho,1981,11,432684,64.2,395612,58.7,37072,8.6
Illinois,1981,11,5591237,65.4,5090236,59.6,501001,9.0
Indiana,1981,11,2613025,64.7,2333439,57.7,279586,10.7
Iowa,1981,11,1425200,66.0,1320979,61.1,104221,7.3
Kansas,1981,11,1176383,66.8,1122607,63.7,53776,4.6
Kentucky,1981,11,1655933,61.7,1502217,56.0,153716,9.3
Louisiana,1981,11,1854387,60.4,1688048,55.0,166339,9.0
Maine,1981,11,516062,61.6,476286,56.8,39776,7.7
Maryland,1981,11,2174314,67.8,2004613,62.5,169701,7.8
Massachusetts,1981,11,2963194,66.9,2755527,62.2,207667,7.0
Michigan,1981,11,4286652,63.3,3714189,54.8,572463,13.4
Minnesota,1981,11,2145883,70.2,2013395,65.9,132488,6.2
Mississippi,1981,11,1054973,58.5,957034,53.1,97939,9.3
Missouri,1981,11,2318097,62.8,2126326,57.6,191771,8.3
Montana,1981,11,384090,65.8,355774,60.9,28316,7.4
Nebraska,1981,11,774067,66.7,738660,63.6,35407,4.6
Nevada,1981,11,471336,73.3,433994,67.5,37342,7.9
New Hampshire,1981,11,481821,68.6,453924,64.7,27897,5.8
New Jersey,1981,11,3604534,63.4,3322575,58.5,281959,7.8
New Mexico,1981,11,581600,61.0,539650,56.6,41950,7.2
New York,1981,11,7979955,59.5,7362817,54.9,617138,7.7
New York city,1981,11,3084362,55.3,2806028,50.3,278334,9.0
North Carolina,1981,11,2938672,66.9,2706674,61.6,231998,7.9
North Dakota,1981,11,311116,65.5,295849,62.3,15267,4.9
Ohio,1981,11,5109536,63.5,4564749,56.8,544787,10.7
Oklahoma,1981,11,1451783,63.2,1393622,60.6,58161,4.0
Oregon,1981,11,1325814,66.2,1186790,59.3,139024,10.5
Pennsylvania,1981,11,5458880,59.8,4963387,54.4,495493,9.1
Rhode Island,1981,11,478072,65.6,438342,60.1,39730,8.3
South Carolina,1981,11,1444016,63.3,1310105,57.4,133911,9.3
South Dakota,1981,11,332109,66.8,316123,63.6,15986,4.8
Tennessee,1981,11,2102455,60.8,1895816,54.9,206639,9.8
Texas,1981,11,7163312,66.9,6766201,63.2,397111,5.5
Utah,1981,11,657185,65.7,611318,61.1,45867,7.0
Vermont,1981,11,259650,67.6,243490,63.4,16160,6.2
Virginia,1981,11,2621775,65.8,2450074,61.5,171701,6.5
Washington,1981,11,2005034,63.9,1796706,57.2,208328,10.4
West Virginia,1981,11,772465,52.9,693114,47.5,79351,10.3
Wisconsin,1981,11,2382227,67.6,2182522,61.9,199705,8.4
Wyoming,1981,11,249514,70.9,239314,68.0,10200,4.1
Alabama,1981,12,1690724,58.8,1480970,51.5,209754,12.4
Alaska,1981,12,205430,73.1,185377,66.0,20053,9.8
Arizona,1981,12,1300346,62.5,1204430,57.8,95916,7.4
Arkansas,1981,12,1021219,60.4,927597,54.8,93622,9.2
California,1981,12,11938852,65.5,10921096,59.9,1017756,8.5
Los Angeles County,1981,12,3777762,65.6,3480151,60.4,297611,7.9
Colorado,1981,12,1560875,70.3,1468238,66.2,92637,5.9
Connecticut,1981,12,1613234,67.0,1506492,62.6,106742,6.6
Delaware,1981,12,290176,64.8,265860,59.3,24316,8.4
District of Columbia,1981,12,306776,63.1,278059,57.2,28717,9.4
Florida,1981,12,4607654,57.4,4259202,53.1,348452,7.6
Georgia,1981,12,2620395,64.8,2430583,60.1,189812,7.2
Hawaii,1981,12,451931,66.3,426342,62.5,25589,5.7
Idaho,1981,12,434339,64.3,395444,58.6,38895,9.0
Illinois,1981,12,5590452,65.4,5073409,59.4,517043,9.2
Indiana,1981,12,2612658,64.6,2321423,57.4,291235,11.1
Iowa,1981,12,1421896,65.8,1314054,60.8,107842,7.6
Kansas,1981,12,1176891,66.8,1120481,63.6,56410,4.8
Kentucky,1981,12,1657217,61.7,1498983,55.8,158234,9.5
Louisiana,1981,12,1856719,60.4,1685998,54.8,170721,9.2
Maine,1981,12,517033,61.6,475894,56.7,41139,8.0
Maryland,1981,12,2177386,67.8,2002339,62.3,175047,8.0
Massachusetts,1981,12,2966731,67.0,2753066,62.1,213665,7.2
Michigan,1981,12,4289540,63.3,3693599,54.5,595941,13.9
Minnesota,1981,12,2147684,70.2,2010114,65.7,137570,6.4
Mississippi,1981,12,1057205,58.6,956306,53.0,100899,9.5
Missouri,1981,12,2319647,62.8,2122952,57.5,196695,8.5
Montana,1981,12,384534,65.7,355215,60.7,29319,7.6
Nebraska,1981,12,774579,66.7,738194,63.6,36385,4.7
Nevada,1981,12,473692,73.4,434523,67.4,39169,8.3
New Hampshire,1981,12,482617,68.7,453279,64.5,29338,6.1
New Jersey,1981,12,3607876,63.4,3316995,58.3,290881,8.1
New Mexico,1981,12,583554,61.1,540286,56.6,43268,7.4
New York,1981,12,7985416,59.5,7352480,54.8,632936,7.9
New York city,1981,12,3086199,55.3,2802788,50.2,283411,9.2
North Carolina,1981,12,2943490,66.9,2698836,61.3,244654,8.3
North Dakota,1981,12,311370,65.4,295908,62.2,15462,5.0
Ohio,1981,12,5109864,63.5,4546152,56.5,563712,11.0
Oklahoma,1981,12,1456801,63.2,1395115,60.5,61686,4.2
Oregon,1981,12,1324249,66.1,1181312,59.0,142937,10.8
Pennsylvania,1981,12,5463094,59.9,4949152,54.2,513942,9.4
Rhode Island,1981,12,478837,65.7,437516,60.0,41321,8.6
South Carolina,1981,12,1450731,63.5,1312185,57.4,138546,9.6
South Dakota,1981,12,332008,66.8,315906,63.6,16102,4.8
Tennessee,1981,12,2100796,60.7,1885816,54.5,214980,10.2
Texas,1981,12,7184541,66.9,6776911,63.1,407630,5.7
Utah,1981,12,659255,65.8,612399,61.1,46856,7.1
Vermont,1981,12,260273,67.8,243590,63.4,16683,6.4
Virginia,1981,12,2627401,65.9,2449226,61.4,178175,6.8
Washington,1981,12,2007738,63.9,1792573,57.1,215165,10.7
West Virginia,1981,12,773429,53.0,691519,47.4,81910,10.6
Wisconsin,1981,12,2387035,67.7,2179775,61.8,207260,8.7
Wyoming,1981,12,249674,70.7,239343,67.8,10331,4.1
Alabama,1982,1,1696066,58.9,1480163,51.4,215903,12.7
Alaska,1982,1,206145,73.1,185922,65.9,20223,9.8
Arizona,1982,1,1307630,62.7,1205533,57.8,102097,7.8
Arkansas,1982,1,1019808,60.2,925247,54.7,94561,9.3
California,1982,1,11977339,65.6,10920493,59.8,1056846,8.8
Los Angeles County,1982,1,3788474,65.7,3479677,60.3,308797,8.2
Colorado,1982,1,1564632,70.3,1467872,66.0,96760,6.2
Connecticut,1982,1,1614841,67.1,1506580,62.6,108261,6.7
Delaware,1982,1,291291,65.0,266577,59.5,24714,8.5
District of Columbia,1982,1,306995,63.2,277652,57.1,29343,9.6
Florida,1982,1,4621497,57.4,4264328,53.0,357169,7.7
Georgia,1982,1,2625783,64.8,2432452,60.0,193331,7.4
Hawaii,1982,1,452286,66.2,425920,62.4,26366,5.8
Idaho,1982,1,436242,64.5,395605,58.5,40637,9.3
Illinois,1982,1,5590465,65.4,5056953,59.2,533512,9.5
Indiana,1982,1,2612301,64.6,2312107,57.2,300194,11.5
Iowa,1982,1,1418441,65.7,1307589,60.5,110852,7.8
Kansas,1982,1,1178288,66.8,1119210,63.4,59078,5.0
Kentucky,1982,1,1659929,61.8,1497571,55.7,162358,9.8
Louisiana,1982,1,1859105,60.4,1684565,54.7,174540,9.4
Maine,1982,1,517943,61.7,475691,56.7,42252,8.2
Maryland,1982,1,2180045,67.8,2000724,62.3,179321,8.2
Massachusetts,1982,1,2969919,67.0,2751134,62.1,218785,7.4
Michigan,1982,1,4288979,63.3,3673651,54.3,615328,14.3
Minnesota,1982,1,2150169,70.3,2007770,65.6,142399,6.6
Mississippi,1982,1,1059485,58.7,955739,52.9,103746,9.8
Missouri,1982,1,2320288,62.8,2120716,57.4,199572,8.6
Montana,1982,1,384923,65.8,354603,60.6,30320,7.9
Nebraska,1982,1,775432,66.8,738067,63.6,37365,4.8
Nevada,1982,1,475856,73.5,434878,67.2,40978,8.6
New Hampshire,1982,1,483358,68.7,452669,64.3,30689,6.3
New Jersey,1982,1,3611620,63.5,3312717,58.2,298903,8.3
New Mexico,1982,1,585568,61.2,540794,56.5,44774,7.6
New York,1982,1,7992415,59.5,7345465,54.7,646950,8.1
New York city,1982,1,3087909,55.3,2800806,50.1,287103,9.3
North Carolina,1982,1,2944426,66.8,2691513,61.1,252913,8.6
North Dakota,1982,1,311552,65.5,295875,62.2,15677,5.0
Ohio,1982,1,5110850,63.5,4531045,56.3,579805,11.3
Oklahoma,1982,1,1461530,63.2,1396904,60.4,64626,4.4
Oregon,1982,1,1322511,66.1,1176578,58.8,145933,11.0
Pennsylvania,1982,1,5468685,59.9,4939092,54.1,529593,9.7
Rhode Island,1982,1,479690,65.8,436687,59.9,43003,9.0
South Carolina,1982,1,1458046,63.7,1315249,57.5,142797,9.8
South Dakota,1982,1,332116,66.8,315889,63.6,16227,4.9
Tennessee,1982,1,2100720,60.7,1878340,54.3,222380,10.6
Texas,1982,1,7209230,66.9,6789610,63.0,419620,5.8
Utah,1982,1,661157,65.9,613461,61.1,47696,7.2
Vermont,1982,1,260921,67.9,243777,63.5,17144,6.6
Virginia,1982,1,2634487,66.0,2450901,61.4,183586,7.0
Washington,1982,1,2011125,64.0,1790275,56.9,220850,11.0
West Virginia,1982,1,774464,53.0,689868,47.3,84596,10.9
Wisconsin,1982,1,2392993,67.8,2177740,61.7,215253,9.0
Wyoming,1982,1,249906,70.6,239374,67.6,10532,4.2
Alabama,1982,2,1701014,59.0,1479948,51.4,221066,13.0
Alaska,1982,2,206871,72.8,186494,65.7,20377,9.9
Arizona,1982,2,1315378,62.8,1207024,57.7,108354,8.2
Arkansas,1982,2,1018554,60.2,923674,54.6,94880,9.3
California,1982,2,12017422,65.7,10924825,59.7,1092597,9.1
Los Angeles County,1982,2,3800770,65.8,3481597,60.3,319173,8.4
Colorado,1982,2,1569221,70.4,1468764,65.9,100457,6.4
Connecticut,1982,2,1615841,67.0,1506457,62.5,109384,6.8
Delaware,1982,2,292534,65.2,267648,59.6,24886,8.5
District of Columbia,1982,2,307346,63.2,277353,57.1,29993,9.8
Florida,1982,2,4636608,57.5,4271313,53.0,365295,7.9
Georgia,1982,2,2631824,64.8,2436029,60.0,195795,7.4
Hawaii,1982,2,452818,66.2,425793,62.3,27025,6.0
Idaho,1982,2,438247,64.8,396221,58.6,42026,9.6
Illinois,1982,2,5592216,65.4,5040845,59.0,551371,9.9
Indiana,1982,2,2612310,64.6,2306667,57.0,305643,11.7
Iowa,1982,2,1415734,65.5,1302454,60.3,113280,8.0
Kansas,1982,2,1180523,66.9,1118691,63.4,61832,5.2
Kentucky,1982,2,1664182,61.9,1497840,55.7,166342,10.0
Louisiana,1982,2,1861488,60.3,1684014,54.6,177474,9.5
Maine,1982,2,518836,61.8,475709,56.6,43127,8.3
Maryland,1982,2,2182181,67.8,2000235,62.2,181946,8.3
Massachusetts,1982,2,2972620,67.0,2749662,62.0,222958,7.5
Michigan,1982,2,4284947,63.3,3656158,54.0,628789,14.7
Minnesota,1982,2,2153326,70.3,2006287,65.5,147039,6.8
Mississippi,1982,2,1061424,58.7,954922,52.8,106502,10.0
Missouri,1982,2,2320586,62.8,2119361,57.3,201225,8.7
Montana,1982,2,385373,65.8,354090,60.4,31283,8.1
Nebraska,1982,2,776579,66.8,738125,63.5,38454,5.0
Nevada,1982,2,477822,73.5,435130,66.9,42692,8.9
New Hampshire,1982,2,484094,68.7,452180,64.1,31914,6.6
New Jersey,1982,2,3616094,63.5,3310889,58.1,305205,8.4
New Mexico,1982,2,587703,61.3,541265,56.4,46438,7.9
New York,1982,2,8000081,59.5,7342484,54.6,657597,8.2
New York city,1982,2,3089969,55.3,2800433,50.1,289536,9.4
North Carolina,1982,2,2943600,66.7,2685221,60.9,258379,8.8
North Dakota,1982,2,311829,65.4,295903,62.0,15926,5.1
Ohio,1982,2,5113892,63.6,4520672,56.2,593220,11.6
Oklahoma,1982,2,1466134,63.2,1398907,60.3,67227,4.6
Oregon,1982,2,1321130,66.0,1173533,58.6,147597,11.2
Pennsylvania,1982,2,5474147,59.9,4932086,54.0,542061,9.9
Rhode Island,1982,2,480652,65.8,436027,59.7,44625,9.3
South Carolina,1982,2,1465089,63.9,1318324,57.5,146765,10.0
South Dakota,1982,2,332406,66.7,315985,63.5,16421,4.9
Tennessee,1982,2,2103674,60.7,1875206,54.1,228468,10.9
Texas,1982,2,7237662,67.0,6804732,62.9,432930,6.0
Utah,1982,2,662980,65.9,614553,61.1,48427,7.3
Vermont,1982,2,261557,67.9,244053,63.4,17504,6.7
Virginia,1982,2,2642431,66.1,2454818,61.4,187613,7.1
Washington,1982,2,2014500,64.0,1789275,56.9,225225,11.2
West Virginia,1982,2,776040,53.1,688346,47.1,87694,11.3
Wisconsin,1982,2,2400036,68.0,2176729,61.7,223307,9.3
Wyoming,1982,2,250265,70.5,239418,67.4,10847,4.3
Alabama,1982,3,1705264,59.1,1479530,51.3,225734,13.2
Alaska,1982,3,207852,72.7,187312,65.5,20540,9.9
Arizona,1982,3,1323148,63.1,1208626,57.6,114522,8.7
Arkansas,1982,3,1017725,60.1,922929,54.5,94796,9.3
California,1982,3,12057227,65.8,10930905,59.6,1126322,9.3
Los Angeles County,1982,3,3812386,65.9,3483373,60.2,329013,8.6
Colorado,1982,3,1574255,70.4,1470160,65.7,104095,6.6
Connecticut,1982,3,1616059,67.0,1505884,62.4,110175,6.8
Delaware,1982,3,293564,65.4,268712,59.8,24852,8.5
District of Columbia,1982,3,307839,63.5,277227,57.2,30612,9.9
Florida,1982,3,4651988,57.5,4279046,52.9,372942,8.0
Georgia,1982,3,2637878,64.9,2440222,60.0,197656,7.5
Hawaii,1982,3,453597,66.2,425999,62.2,27598,6.1
Idaho,1982,3,440044,65.0,397113,58.7,42931,9.8
Illinois,1982,3,5595928,65.4,5024547,58.8,571381,10.2
Indiana,1982,3,2611871,64.6,2304057,57.0,307814,11.8
Iowa,1982,3,1414209,65.5,1299085,60.2,115124,8.1
Kansas,1982,3,1183201,67.0,1118327,63.3,64874,5.5
Kentucky,1982,3,1669373,62.0,1499129,55.7,170244,10.2
Louisiana,1982,3,1863512,60.3,1684013,54.5,179499,9.6
Maine,1982,3,519679,61.8,475781,56.6,43898,8.4
Maryland,1982,3,2183340,67.8,2000384,62.1,182956,8.4
Massachusetts,1982,3,2974644,67.1,2748309,62.0,226335,7.6
Michigan,1982,3,4279124,63.3,3642513,53.8,636611,14.9
Minnesota,1982,3,2156749,70.4,2004506,65.4,152243,7.1
Mississippi,1982,3,1062745,58.7,953561,52.7,109184,10.3
Missouri,1982,3,2320721,62.8,2118111,57.3,202610,8.7
Montana,1982,3,385907,65.9,353771,60.4,32136,8.3
Nebraska,1982,3,777811,66.9,738125,63.5,39686,5.1
Nevada,1982,3,479524,73.5,435251,66.8,44273,9.2
New Hampshire,1982,3,484813,68.7,451853,64.0,32960,6.8
New Jersey,1982,3,3620914,63.5,3311500,58.1,309414,8.5
New Mexico,1982,3,590008,61.4,541716,56.4,48292,8.2
New York,1982,3,8006251,59.6,7341352,54.6,664899,8.3
New York city,1982,3,3092193,55.3,2800772,50.1,291421,9.4
North Carolina,1982,3,2942504,66.6,2680062,60.7,262442,8.9
North Dakota,1982,3,312244,65.5,296030,62.1,16214,5.2
Ohio,1982,3,5118254,63.6,4513335,56.1,604919,11.8
Oklahoma,1982,3,1470731,63.2,1400724,60.2,70007,4.8
Oregon,1982,3,1320363,65.9,1172371,58.5,147992,11.2
Pennsylvania,1982,3,5477909,60.0,4925139,53.9,552770,10.1
Rhode Island,1982,3,481661,66.0,435634,59.7,46027,9.6
South Carolina,1982,3,1471100,64.1,1320456,57.5,150644,10.2
South Dakota,1982,3,332721,66.8,316018,63.5,16703,5.0
Tennessee,1982,3,2109734,60.9,1876186,54.1,233548,11.1
Texas,1982,3,7268101,67.0,6820671,62.9,447430,6.2
Utah,1982,3,664743,65.9,615589,61.1,49154,7.4
Vermont,1982,3,262152,68.1,244363,63.5,17789,6.8
Virginia,1982,3,2649800,66.2,2459349,61.5,190451,7.2
Washington,1982,3,2017252,64.1,1788724,56.8,228528,11.3
West Virginia,1982,3,778189,53.3,686754,47.0,91435,11.7
Wisconsin,1982,3,2407195,68.2,2175980,61.6,231215,9.6
Wyoming,1982,3,250824,70.5,239407,67.2,11417,4.6
Alabama,1982,4,1709179,59.2,1478975,51.3,230204,13.5
Alaska,1982,4,209206,72.9,188499,65.7,20707,9.9
Arizona,1982,4,1330924,63.3,1210338,57.5,120586,9.1
Arkansas,1982,4,1017553,60.0,922968,54.5,94585,9.3
California,1982,4,12096312,65.9,10938209,59.6,1158103,9.6
Los Angeles County,1982,4,3822596,66.0,3484415,60.1,338181,8.8
Colorado,1982,4,1579607,70.5,1471694,65.6,107913,6.8
Connecticut,1982,4,1615587,67.0,1504953,62.4,110634,6.8
Delaware,1982,4,294201,65.4,269512,59.9,24689,8.4
District of Columbia,1982,4,308469,63.6,277349,57.2,31120,10.1
Florida,1982,4,4667571,57.6,4287373,52.9,380198,8.1
Georgia,1982,4,2643635,64.9,2444546,60.0,199089,7.5
Hawaii,1982,4,454635,66.3,426545,62.2,28090,6.2
Idaho,1982,4,441609,65.1,398296,58.7,43313,9.8
Illinois,1982,4,5602282,65.5,5009249,58.6,593033,10.6
Indiana,1982,4,2610823,64.5,2303153,56.9,307670,11.8
Iowa,1982,4,1414025,65.5,1297746,60.1,116279,8.2
Kansas,1982,4,1186338,67.1,1117951,63.2,68387,5.8
Kentucky,1982,4,1674657,62.2,1500769,55.7,173888,10.4
Louisiana,1982,4,1865350,60.3,1684151,54.4,181199,9.7
Maine,1982,4,520524,61.9,476071,56.6,44453,8.5
Maryland,1982,4,2183467,67.8,2000763,62.1,182704,8.4
Massachusetts,1982,4,2976981,67.1,2747948,61.9,229033,7.7
Michigan,1982,4,4273513,63.2,3633343,53.7,640170,15.0
Minnesota,1982,4,2160075,70.5,2001882,65.3,158193,7.3
Mississippi,1982,4,1063702,58.7,951883,52.6,111819,10.5
Missouri,1982,4,2321059,62.8,2116811,57.2,204248,8.8
Montana,1982,4,386541,65.9,353764,60.3,32777,8.5
Nebraska,1982,4,779118,67.0,738182,63.5,40936,5.3
Nevada,1982,4,481007,73.5,435295,66.6,45712,9.5
New Hampshire,1982,4,485598,68.7,451867,63.9,33731,6.9
New Jersey,1982,4,3626275,63.6,3314674,58.1,311601,8.6
New Mexico,1982,4,592590,61.5,542280,56.3,50310,8.5
New York,1982,4,8009200,59.6,7339620,54.6,669580,8.4
New York city,1982,4,3094136,55.3,2800776,50.1,293360,9.5
North Carolina,1982,4,2942184,66.5,2676951,60.5,265233,9.0
North Dakota,1982,4,312839,65.4,296327,62.0,16512,5.3
Ohio,1982,4,5123684,63.7,4507874,56.0,615810,12.0
Oklahoma,1982,4,1475538,63.2,1402185,60.1,73353,5.0
Oregon,1982,4,1320358,65.9,1172794,58.6,147564,11.2
Pennsylvania,1982,4,5480396,60.0,4917659,53.8,562737,10.3
Rhode Island,1982,4,482648,66.0,435529,59.6,47119,9.8
South Carolina,1982,4,1476022,64.2,1321611,57.5,154411,10.5
South Dakota,1982,4,332979,66.9,315939,63.4,17040,5.1
Tennessee,1982,4,2117999,61.0,1880300,54.2,237699,11.2
Texas,1982,4,7299096,67.1,6836736,62.8,462360,6.3
Utah,1982,4,666639,66.0,616593,61.0,50046,7.5
Vermont,1982,4,262698,68.1,244706,63.4,17992,6.8
Virginia,1982,4,2656160,66.3,2463695,61.5,192465,7.2
Washington,1982,4,2019115,64.1,1788126,56.7,230989,11.4
West Virginia,1982,4,780817,53.4,685057,46.9,95760,12.3
Wisconsin,1982,4,2413901,68.3,2175185,61.6,238716,9.9
Wyoming,1982,4,251565,70.7,239325,67.2,12240,4.9
Alabama,1982,5,1713158,59.3,1478707,51.2,234451,13.7
Alaska,1982,5,210822,72.9,189961,65.7,20861,9.9
Arizona,1982,5,1338465,63.5,1211947,57.5,126518,9.5
Arkansas,1982,5,1018103,60.0,923638,54.5,94465,9.3
California,1982,5,12133491,66.0,10946059,59.5,1187432,9.8
Los Angeles County,1982,5,3830945,66.0,3484348,60.1,346597,9.0
Colorado,1982,5,1584965,70.5,1472785,65.5,112180,7.1
Connecticut,1982,5,1614521,66.9,1503726,62.3,110795,6.9
Delaware,1982,5,294450,65.4,269978,60.0,24472,8.3
District of Columbia,1982,5,309060,63.7,277593,57.2,31467,10.2
Florida,1982,5,4682916,57.6,4296031,52.9,386885,8.3
Georgia,1982,5,2648777,65.0,2448630,60.1,200147,7.6
Hawaii,1982,5,455833,66.3,427388,62.1,28445,6.2
Idaho,1982,5,443027,65.2,399739,58.9,43288,9.8
Illinois,1982,5,5610453,65.6,4995491,58.4,614962,11.0
Indiana,1982,5,2609626,64.5,2303169,56.9,306457,11.7
Iowa,1982,5,1414745,65.5,1297922,60.1,116823,8.3
Kansas,1982,5,1189967,67.3,1117781,63.2,72186,6.1
Kentucky,1982,5,1679402,62.3,1502339,55.8,177063,10.5
Louisiana,1982,5,1866799,60.2,1683518,54.3,183281,9.8
Maine,1982,5,521335,61.9,476618,56.6,44717,8.6
Maryland,1982,5,2182705,67.7,2001149,62.1,181556,8.3
Massachusetts,1982,5,2980097,67.1,2749004,61.9,231093,7.8
Michigan,1982,5,4268998,63.2,3627142,53.7,641856,15.0
Minnesota,1982,5,2162944,70.5,1998509,65.1,164435,7.6
Mississippi,1982,5,1064614,58.7,950229,52.4,114385,10.7
Missouri,1982,5,2321735,62.8,2115482,57.2,206253,8.9
Montana,1982,5,387218,66.0,354067,60.3,33151,8.6
Nebraska,1982,5,780460,67.1,738445,63.5,42015,5.4
Nevada,1982,5,482266,73.5,435282,66.4,46984,9.7
New Hampshire,1982,5,486440,68.7,452255,63.9,34185,7.0
New Jersey,1982,5,3631894,63.7,3319480,58.2,312414,8.6
New Mexico,1982,5,595384,61.7,543032,56.3,52352,8.8
New York,1982,5,8007911,59.5,7334729,54.5,673182,8.4
New York city,1982,5,3095008,55.3,2799621,50.0,295387,9.5
North Carolina,1982,5,2942844,66.4,2675765,60.4,267079,9.1
North Dakota,1982,5,313529,65.6,296723,62.1,16806,5.4
Ohio,1982,5,5129188,63.7,4503145,56.0,626043,12.2
Oklahoma,1982,5,1480624,63.2,1403000,59.9,77624,5.2
Oregon,1982,5,1320936,65.9,1174112,58.6,146824,11.1
Pennsylvania,1982,5,5481914,60.0,4909376,53.7,572538,10.4
Rhode Island,1982,5,483428,66.1,435537,59.6,47891,9.9
South Carolina,1982,5,1480177,64.3,1322339,57.4,157838,10.7
South Dakota,1982,5,333222,66.9,315792,63.4,17430,5.2
Tennessee,1982,5,2127067,61.2,1886024,54.3,241043,11.3
Texas,1982,5,7328925,67.1,6851337,62.8,477588,6.5
Utah,1982,5,668695,66.0,617523,61.0,51172,7.7
Vermont,1982,5,263136,68.2,245051,63.5,18085,6.9
Virginia,1982,5,2661607,66.3,2467499,61.5,194108,7.3
Washington,1982,5,2020131,64.0,1787313,56.7,232818,11.5
West Virginia,1982,5,783688,53.6,683177,46.7,100511,12.8
Wisconsin,1982,5,2419756,68.5,2174547,61.5,245209,10.1
Wyoming,1982,5,252410,70.7,239158,67.0,13252,5.3
Alabama,1982,6,1717506,59.4,1478887,51.2,238619,13.9
Alaska,1982,6,212495,73.3,191484,66.0,21011,9.9
Arizona,1982,6,1345200,63.6,1212891,57.3,132309,9.8
Arkansas,1982,6,1019095,60.1,924585,54.5,94510,9.3
California,1982,6,12165384,66.0,10950479,59.4,1214905,10.0
Los Angeles County,1982,6,3835441,66.0,3480674,59.9,354767,9.2
Colorado,1982,6,1590073,70.6,1472764,65.4,117309,7.4
Connecticut,1982,6,1612770,66.8,1502019,62.2,110751,6.9
Delaware,1982,6,294463,65.3,270180,59.9,24283,8.2
District of Columbia,1982,6,309513,63.9,277814,57.4,31699,10.2
Florida,1982,6,4697052,57.7,4303863,52.8,393189,8.4
Georgia,1982,6,2652922,65.0,2451649,60.0,201273,7.6
Hawaii,1982,6,457043,66.3,428468,62.2,28575,6.3
Idaho,1982,6,444365,65.4,401204,59.1,43161,9.7
Illinois,1982,6,5617611,65.6,4981498,58.2,636113,11.3
Indiana,1982,6,2608616,64.4,2302496,56.9,306120,11.7
Iowa,1982,6,1415728,65.6,1298554,60.2,117174,8.3
Kansas,1982,6,1193659,67.4,1117737,63.1,75922,6.4
Kentucky,1982,6,1683327,62.4,1503624,55.8,179703,10.7
Louisiana,1982,6,1867388,60.1,1681378,54.1,186010,10.0
Maine,1982,6,521902,62.0,477130,56.7,44772,8.6
Maryland,1982,6,2181335,67.6,2001262,62.0,180073,8.3
Massachusetts,1982,6,2982975,67.2,2750305,61.9,232670,7.8
Michigan,1982,6,4265547,63.1,3620277,53.6,645270,15.1
Minnesota,1982,6,2164812,70.5,1994195,65.0,170617,7.9
Mississippi,1982,6,1065591,58.7,948798,52.3,116793,11.0
Missouri,1982,6,2322592,62.8,2113708,57.1,208884,9.0
Montana,1982,6,387826,66.0,354508,60.3,33318,8.6
Nebraska,1982,6,781665,67.2,738855,63.5,42810,5.5
Nevada,1982,6,483262,73.4,435135,66.1,48127,10.0
New Hampshire,1982,6,487198,68.7,452844,63.9,34354,7.1
New Jersey,1982,6,3637203,63.7,3324068,58.2,313135,8.6
New Mexico,1982,6,598017,61.8,543843,56.2,54174,9.1
New York,1982,6,8002375,59.5,7324193,54.4,678182,8.5
New York city,1982,6,3094105,55.2,2796594,49.9,297511,9.6
North Carolina,1982,6,2943738,66.4,2674595,60.3,269143,9.1
North Dakota,1982,6,314131,65.6,297000,62.0,17131,5.5
Ohio,1982,6,5132348,63.8,4496311,55.9,636037,12.4
Oklahoma,1982,6,1485802,63.3,1402721,59.7,83081,5.6
Oregon,1982,6,1322105,66.0,1175598,58.7,146507,11.1
Pennsylvania,1982,6,5481677,59.9,4898482,53.6,583195,10.6
Rhode Island,1982,6,483801,66.1,435379,59.5,48422,10.0
South Carolina,1982,6,1483658,64.3,1323047,57.3,160611,10.8
South Dakota,1982,6,333459,67.0,315602,63.4,17857,5.4
Tennessee,1982,6,2135180,61.4,1890984,54.4,244196,11.4
Texas,1982,6,7355102,67.1,6861966,62.6,493136,6.7
Utah,1982,6,670750,66.1,618212,60.9,52538,7.8
Vermont,1982,6,263390,68.1,245297,63.4,18093,6.9
Virginia,1982,6,2666179,66.4,2470405,61.5,195774,7.3
Washington,1982,6,2020912,64.0,1786419,56.6,234493,11.6
West Virginia,1982,6,786581,53.8,680999,46.5,105582,13.4
Wisconsin,1982,6,2423690,68.5,2173796,61.5,249894,10.3
Wyoming,1982,6,253224,70.7,238872,66.7,14352,5.7
Alabama,1982,7,1722420,59.6,1479496,51.2,242924,14.1
Alaska,1982,7,214150,73.3,192953,66.1,21197,9.9
Arizona,1982,7,1351086,63.7,1212999,57.2,138087,10.2
Arkansas,1982,7,1020298,60.1,925420,54.5,94878,9.3
California,1982,7,12191944,66.1,10949543,59.3,1242401,10.2
Los Angeles County,1982,7,3835543,65.9,3471998,59.7,363545,9.5
Colorado,1982,7,1595289,70.6,1471778,65.2,123511,7.7
Connecticut,1982,7,1610566,66.6,1499895,62.0,110671,6.9
Delaware,1982,7,294452,65.3,270241,59.9,24211,8.2
District of Columbia,1982,7,309906,64.0,277982,57.4,31924,10.3
Florida,1982,7,4710432,57.7,4310408,52.8,400024,8.5
Georgia,1982,7,2656876,65.0,2453513,60.0,203363,7.7
Hawaii,1982,7,458259,66.4,429736,62.3,28523,6.2
Idaho,1982,7,445672,65.5,402436,59.2,43236,9.7
Illinois,1982,7,5623162,65.7,4966699,58.0,656463,11.7
Indiana,1982,7,2608500,64.4,2300403,56.8,308097,11.8
Iowa,1982,7,1416671,65.6,1298872,60.2,117799,8.3
Kansas,1982,7,1197133,67.6,1117795,63.1,79338,6.6
Kentucky,1982,7,1686924,62.5,1504609,55.8,182315,10.8
Louisiana,1982,7,1867311,60.0,1677908,53.9,189403,10.1
Maine,1982,7,522141,61.9,477385,56.6,44756,8.6
Maryland,1982,7,2179884,67.5,2001044,62.0,178840,8.2
Massachusetts,1982,7,2985057,67.2,2750911,61.9,234146,7.8
Michigan,1982,7,4264222,63.1,3610757,53.5,653465,15.3
Minnesota,1982,7,2165417,70.5,1988904,64.7,176513,8.2
Mississippi,1982,7,1066600,58.7,947694,52.2,118906,11.1
Missouri,1982,7,2324275,62.8,2111490,57.1,212785,9.2
Montana,1982,7,388385,66.1,354953,60.4,33432,8.6
Nebraska,1982,7,782759,67.2,739380,63.5,43379,5.5
Nevada,1982,7,484072,73.3,434829,65.9,49243,10.2
New Hampshire,1982,7,487790,68.7,453441,63.9,34349,7.0
New Jersey,1982,7,3641990,63.7,3327051,58.2,314939,8.6
New Mexico,1982,7,600195,61.9,544571,56.2,55624,9.3
New York,1982,7,7995066,59.4,7308403,54.3,686663,8.6
New York city,1982,7,3091500,55.2,2791624,49.8,299876,9.7
North Carolina,1982,7,2944300,66.3,2672122,60.2,272178,9.2
North Dakota,1982,7,314575,65.7,297062,62.0,17513,5.6
Ohio,1982,7,5132075,63.8,4485211,55.7,646864,12.6
Oklahoma,1982,7,1491226,63.3,1401403,59.5,89823,6.0
Oregon,1982,7,1323908,66.1,1176673,58.7,147235,11.1
Pennsylvania,1982,7,5481500,59.9,4885118,53.4,596382,10.9
Rhode Island,1982,7,483725,66.1,434855,59.4,48870,10.1
South Carolina,1982,7,1486763,64.4,1324038,57.3,162725,10.9
South Dakota,1982,7,333721,67.0,315430,63.3,18291,5.5
Tennessee,1982,7,2141609,61.6,1893229,54.4,248380,11.6
Texas,1982,7,7378097,67.1,6868264,62.5,509833,6.9
Utah,1982,7,672723,66.1,618586,60.8,54137,8.0
Vermont,1982,7,263443,68.1,245385,63.4,18058,6.9
Virginia,1982,7,2670512,66.4,2472543,61.5,197969,7.4
Washington,1982,7,2022633,64.0,1786028,56.5,236605,11.7
West Virginia,1982,7,789516,54.0,678552,46.4,110964,14.1
Wisconsin,1982,7,2425685,68.5,2172460,61.4,253225,10.4
Wyoming,1982,7,253886,70.7,238445,66.4,15441,6.1
Alabama,1982,8,1727495,59.7,1480152,51.2,247343,14.3
Alaska,1982,8,215712,73.1,194237,65.8,21475,10.0
Arizona,1982,8,1356206,63.8,1212411,57.0,143795,10.6
Arkansas,1982,8,1021740,60.1,925923,54.5,95817,9.4
California,1982,8,12215113,66.1,10944096,59.2,1271017,10.4
Los Angeles County,1982,8,3832739,65.8,3459352,59.4,373387,9.7
Colorado,1982,8,1601430,70.7,1471110,65.0,130320,8.1
Connecticut,1982,8,1608543,66.5,1497843,61.9,110700,6.9
Delaware,1982,8,294470,65.3,270189,59.9,24281,8.2
District of Columbia,1982,8,310380,64.1,278082,57.5,32298,10.4
Florida,1982,8,4723872,57.7,4315377,52.7,408495,8.6
Georgia,1982,8,2661515,65.0,2454417,60.0,207098,7.8
Hawaii,1982,8,459562,66.4,431190,62.3,28372,6.2
Idaho,1982,8,446994,65.6,403264,59.2,43730,9.8
Illinois,1982,8,5627875,65.7,4951964,57.8,675911,12.0
Indiana,1982,8,2609732,64.5,2297226,56.7,312506,12.0
Iowa,1982,8,1417203,65.7,1298101,60.2,119102,8.4
Kansas,1982,8,1200225,67.7,1118048,63.1,82177,6.8
Kentucky,1982,8,1690618,62.6,1504989,55.7,185629,11.0
Louisiana,1982,8,1867306,59.9,1673893,53.7,193413,10.4
Maine,1982,8,522249,61.9,477414,56.6,44835,8.6
Maryland,1982,8,2179025,67.5,2000777,61.9,178248,8.2
Massachusetts,1982,8,2986220,67.2,2750481,61.9,235739,7.9
Michigan,1982,8,4266025,63.2,3598946,53.3,667079,15.6
Minnesota,1982,8,2165120,70.5,1983279,64.5,181841,8.4
Mississippi,1982,8,1067583,58.8,946712,52.1,120871,11.3
Missouri,1982,8,2327072,62.8,2109019,57.0,218053,9.4
Montana,1982,8,389009,66.0,355339,60.3,33670,8.7
Nebraska,1982,8,783903,67.3,739927,63.5,43976,5.6
Nevada,1982,8,484832,73.3,434393,65.7,50439,10.4
New Hampshire,1982,8,488286,68.7,454016,63.9,34270,7.0
New Jersey,1982,8,3646330,63.7,3328025,58.2,318305,8.7
New Mexico,1982,8,601785,62.0,545078,56.1,56707,9.4
New York,1982,8,7988988,59.3,7289607,54.1,699381,8.8
New York city,1982,8,3087993,55.0,2785307,49.6,302686,9.8
North Carolina,1982,8,2944338,66.2,2668601,60.0,275737,9.4
North Dakota,1982,8,314890,65.6,296944,61.9,17946,5.7
Ohio,1982,8,5129047,63.7,4469539,55.5,659508,12.9
Oklahoma,1982,8,1496693,63.4,1399249,59.3,97444,6.5
Oregon,1982,8,1326510,66.2,1177206,58.8,149304,11.3
Pennsylvania,1982,8,5483273,59.9,4870609,53.2,612664,11.2
Rhode Island,1982,8,483421,66.0,433996,59.3,49425,10.2
South Carolina,1982,8,1489884,64.4,1325286,57.3,164598,11.0
South Dakota,1982,8,334076,66.9,315327,63.2,18749,5.6
Tennessee,1982,8,2146480,61.7,1892194,54.4,254286,11.8
Texas,1982,8,7400886,67.2,6871978,62.4,528908,7.1
Utah,1982,8,674629,66.1,618651,60.7,55978,8.3
Vermont,1982,8,263361,68.1,245330,63.4,18031,6.8
Virginia,1982,8,2675666,66.4,2474566,61.4,201100,7.5
Washington,1982,8,2025655,64.1,1786368,56.5,239287,11.8
West Virginia,1982,8,792552,54.1,675937,46.2,116615,14.7
Wisconsin,1982,8,2426694,68.6,2170002,61.3,256692,10.6
Wyoming,1982,8,254428,70.9,237907,66.3,16521,6.5
Alabama,1982,9,1732062,59.9,1480336,51.2,251726,14.5
Alaska,1982,9,217181,73.1,195276,65.7,21905,10.1
Arizona,1982,9,1360649,63.8,1211247,56.8,149402,11.0
Arkansas,1982,9,1023481,60.2,926072,54.4,97409,9.5
California,1982,9,12235476,66.1,10935247,59.1,1300229,10.6
Los Angeles County,1982,9,3828450,65.6,3444303,59.0,384147,10.0
Colorado,1982,9,1608719,70.9,1472129,64.9,136590,8.5
Connecticut,1982,9,1607085,66.4,1496203,61.8,110882,6.9
Delaware,1982,9,294507,65.2,270081,59.8,24426,8.3
District of Columbia,1982,9,310966,64.2,278060,57.5,32906,10.6
Florida,1982,9,4737229,57.7,4318452,52.6,418777,8.8
Georgia,1982,9,2667203,65.1,2454625,59.9,212578,8.0
Hawaii,1982,9,460991,66.5,432778,62.4,28213,6.1
Idaho,1982,9,448282,65.7,403627,59.2,44655,10.0
Illinois,1982,9,5631157,65.8,4937216,57.7,693941,12.3
Indiana,1982,9,2612007,64.5,2293280,56.6,318727,12.2
Iowa,1982,9,1416937,65.7,1295686,60.0,121251,8.6
Kansas,1982,9,1202691,67.8,1118469,63.0,84222,7.0
Kentucky,1982,9,1694402,62.7,1504276,55.7,190126,11.2
Louisiana,1982,9,1868148,59.8,1670140,53.5,198008,10.6
Maine,1982,9,522519,61.8,477367,56.5,45152,8.6
Maryland,1982,9,2179099,67.4,2000829,61.9,178270,8.2
Massachusetts,1982,9,2986035,67.1,2748617,61.8,237418,8.0
Michigan,1982,9,4270252,63.3,3586223,53.2,684029,16.0
Minnesota,1982,9,2164629,70.4,1978289,64.4,186340,8.6
Mississippi,1982,9,1068433,58.8,945462,52.0,122971,11.5
Missouri,1982,9,2330546,62.9,2106413,56.8,224133,9.6
Montana,1982,9,389770,66.1,355611,60.3,34159,8.8
Nebraska,1982,9,785261,67.3,740387,63.5,44874,5.7
Nevada,1982,9,485612,73.4,433829,65.5,51783,10.7
New Hampshire,1982,9,488801,68.7,454633,63.9,34168,7.0
New Jersey,1982,9,3650235,63.7,3327177,58.1,323058,8.9
New Mexico,1982,9,602919,62.0,545222,56.0,57697,9.6
New York,1982,9,7986033,59.2,7270434,53.9,715599,9.0
New York city,1982,9,3084134,54.9,2778006,49.5,306128,9.9
North Carolina,1982,9,2943606,66.2,2664003,59.9,279603,9.5
North Dakota,1982,9,315151,65.5,296717,61.7,18434,5.8
Ohio,1982,9,5124001,63.7,4450129,55.3,673872,13.2
Oklahoma,1982,9,1501828,63.4,1396468,59.0,105360,7.0
Oregon,1982,9,1330447,66.4,1177681,58.8,152766,11.5
Pennsylvania,1982,9,5486499,59.9,4855564,53.0,630935,11.5
Rhode Island,1982,9,483137,65.9,432978,59.1,50159,10.4
South Carolina,1982,9,1492840,64.5,1326243,57.3,166597,11.2
South Dakota,1982,9,334522,67.0,315301,63.2,19221,5.7
Tennessee,1982,9,2150492,61.7,1889002,54.2,261490,12.2
Texas,1982,9,7425521,67.2,6874903,62.3,550618,7.4
Utah,1982,9,676487,66.1,618409,60.5,58078,8.6
Vermont,1982,9,263264,67.9,245183,63.2,18081,6.9
Virginia,1982,9,2682004,66.5,2477193,61.4,204811,7.6
Washington,1982,9,2029146,64.1,1787163,56.5,241983,11.9
West Virginia,1982,9,795639,54.3,673218,46.0,122421,15.4
Wisconsin,1982,9,2427559,68.6,2166004,61.2,261555,10.8
Wyoming,1982,9,254887,70.8,237300,65.9,17587,6.9
Alabama,1982,10,1735656,59.9,1479997,51.1,255659,14.7
Alaska,1982,10,218601,72.9,196135,65.4,22466,10.3
Arizona,1982,10,1364589,63.8,1210006,56.6,154583,11.3
Arkansas,1982,10,1025268,60.2,925815,54.4,99453,9.7
California,1982,10,12251814,66.2,10924678,59.0,1327136,10.8
Los Angeles County,1982,10,3822865,65.4,3428098,58.7,394767,10.3
Colorado,1982,10,1616603,71.1,1475402,64.9,141201,8.7
Connecticut,1982,10,1606163,66.3,1495079,61.8,111084,6.9
Delaware,1982,10,294545,65.2,269944,59.7,24601,8.4
District of Columbia,1982,10,311544,64.4,277905,57.4,33639,10.8
Florida,1982,10,4749112,57.7,4319550,52.5,429562,9.0
Georgia,1982,10,2673580,65.1,2454602,59.8,218978,8.2
Hawaii,1982,10,462533,66.6,434372,62.5,28161,6.1
Idaho,1982,10,449400,65.9,403560,59.2,45840,10.2
Illinois,1982,10,5632495,65.8,4922989,57.5,709506,12.6
Indiana,1982,10,2614343,64.6,2289332,56.5,325011,12.4
Iowa,1982,10,1415967,65.6,1292026,59.9,123941,8.8
Kansas,1982,10,1204207,67.8,1118880,63.0,85327,7.1
Kentucky,1982,10,1698252,62.8,1502622,55.6,195630,11.5
Louisiana,1982,10,1870354,59.8,1667107,53.3,203247,10.9
Maine,1982,10,523102,61.8,477385,56.4,45717,8.7
Maryland,1982,10,2180214,67.4,2001524,61.9,178690,8.2
Massachusetts,1982,10,2983890,67.1,2745005,61.7,238885,8.0
Michigan,1982,10,4274269,63.4,3574472,53.0,699797,16.4
Minnesota,1982,10,2164166,70.4,1974408,64.2,189758,8.8
Mississippi,1982,10,1069033,58.8,943707,51.9,125326,11.7
Missouri,1982,10,2334212,63.0,2103891,56.7,230321,9.9
Montana,1982,10,390564,66.2,355723,60.3,34841,8.9
Nebraska,1982,10,786765,67.5,740656,63.5,46109,5.9
Nevada,1982,10,486353,73.4,433166,65.3,53187,10.9
New Hampshire,1982,10,489372,68.6,455316,63.9,34056,7.0
New Jersey,1982,10,3653293,63.7,3324967,58.0,328326,9.0
New Mexico,1982,10,603899,61.9,544958,55.9,58941,9.8
New York,1982,10,7986476,59.2,7253501,53.8,732975,9.2
New York city,1982,10,3079947,54.8,2770040,49.3,309907,10.1
North Carolina,1982,10,2941402,66.1,2657798,59.7,283604,9.6
North Dakota,1982,10,315425,65.6,296441,61.6,18984,6.0
Ohio,1982,10,5118093,63.6,4430269,55.1,687824,13.4
Oklahoma,1982,10,1506407,63.5,1393267,58.7,113140,7.5
Oregon,1982,10,1335219,66.6,1178533,58.8,156686,11.7
Pennsylvania,1982,10,5489153,60.0,4840098,52.9,649055,11.8
Rhode Island,1982,10,482906,65.9,432061,58.9,50845,10.5
South Carolina,1982,10,1494856,64.5,1326294,57.2,168562,11.3
South Dakota,1982,10,334969,67.0,315327,63.1,19642,5.9
Tennessee,1982,10,2154113,61.8,1885625,54.1,268488,12.5
Texas,1982,10,7452250,67.3,6878080,62.1,574170,7.7
Utah,1982,10,678211,66.2,617911,60.3,60300,8.9
Vermont,1982,10,263255,67.8,245020,63.1,18235,6.9
Virginia,1982,10,2688963,66.6,2480870,61.5,208093,7.7
Washington,1982,10,2032285,64.2,1788033,56.5,244252,12.0
West Virginia,1982,10,772141,52.7,643992,44.0,128149,16.6
Wisconsin,1982,10,2428753,68.6,2160632,61.1,268121,11.0
Wyoming,1982,10,255296,70.9,236649,65.7,18647,7.3
Alabama,1982,11,1738155,60.0,1479607,51.1,258548,14.9
Alaska,1982,11,220086,72.9,197024,65.2,23062,10.5
Arizona,1982,11,1368581,63.8,1210107,56.4,158474,11.6
Arkansas,1982,11,1026845,60.3,925334,54.3,101511,9.9
California,1982,11,12262703,66.1,10915325,58.9,1347378,11.0
Los Angeles County,1982,11,3816273,65.2,3412619,58.3,403654,10.6
Colorado,1982,11,1624662,71.3,1480791,65.0,143871,8.9
Connecticut,1982,11,1605786,66.3,1494679,61.7,111107,6.9
Delaware,1982,11,294546,65.0,269784,59.6,24762,8.4
District of Columbia,1982,11,312109,64.5,277744,57.4,34365,11.0
Florida,1982,11,4759026,57.7,4320056,52.4,438970,9.2
Georgia,1982,11,2679533,65.2,2454923,59.7,224610,8.4
Hawaii,1982,11,464103,66.7,435814,62.6,28289,6.1
Idaho,1982,11,450324,65.9,403377,59.1,46947,10.4
Illinois,1982,11,5632037,65.8,4910778,57.3,721259,12.8
Indiana,1982,11,2615090,64.6,2285990,56.4,329100,12.6
Iowa,1982,11,1414723,65.6,1288157,59.7,126566,8.9
Kansas,1982,11,1204435,67.8,1118996,63.0,85439,7.1
Kentucky,1982,11,1701560,62.9,1500485,55.5,201075,11.8
Louisiana,1982,11,1874128,59.9,1665149,53.2,208979,11.2
Maine,1982,11,524024,61.9,477641,56.4,46383,8.9
Maryland,1982,11,2182165,67.5,2003232,61.9,178933,8.2
Massachusetts,1982,11,2980008,66.9,2740327,61.5,239681,8.0
Michigan,1982,11,4276244,63.5,3566345,52.9,709899,16.6
Minnesota,1982,11,2163829,70.3,1972016,64.1,191813,8.9
Mississippi,1982,11,1069475,58.8,941577,51.8,127898,12.0
Missouri,1982,11,2337773,63.0,2101692,56.6,236081,10.1
Montana,1982,11,391295,66.2,355773,60.2,35522,9.1
Nebraska,1982,11,788176,67.5,740627,63.5,47549,6.0
Nevada,1982,11,486913,73.3,432567,65.1,54346,11.2
New Hampshire,1982,11,489995,68.6,456113,63.9,33882,6.9
New Jersey,1982,11,3655193,63.7,3322464,57.9,332729,9.1
New Mexico,1982,11,604940,61.9,544466,55.7,60474,10.0
New York,1982,11,7990478,59.2,7241908,53.7,748570,9.4
New York city,1982,11,3075649,54.7,2762460,49.1,313189,10.2
North Carolina,1982,11,2938044,65.9,2650817,59.5,287227,9.8
North Dakota,1982,11,315767,65.5,296215,61.5,19552,6.2
Ohio,1982,11,5113365,63.6,4414636,54.9,698729,13.7
Oklahoma,1982,11,1510250,63.5,1390137,58.4,120113,8.0
Oregon,1982,11,1339854,66.9,1180141,58.9,159713,11.9
Pennsylvania,1982,11,5489025,59.9,4824861,52.7,664164,12.1
Rhode Island,1982,11,482626,65.8,431541,58.9,51085,10.6
South Carolina,1982,11,1495229,64.4,1325018,57.1,170211,11.4
South Dakota,1982,11,335289,67.1,315361,63.1,19928,5.9
Tennessee,1982,11,2157737,61.9,1884003,54.0,273734,12.7
Texas,1982,11,7480149,67.4,6882595,62.0,597554,8.0
Utah,1982,11,679799,66.1,617393,60.1,62406,9.2
Vermont,1982,11,263337,67.7,244929,63.0,18408,7.0
Virginia,1982,11,2695790,66.7,2485795,61.5,209995,7.8
Washington,1982,11,2034558,64.2,1788865,56.4,245693,12.1
West Virginia,1982,11,766824,52.3,633465,43.2,133359,17.4
Wisconsin,1982,11,2429763,68.7,2154913,60.9,274850,11.3
Wyoming,1982,11,255727,70.8,236046,65.4,19681,7.7
Alabama,1982,12,1738941,60.0,1479174,51.0,259767,14.9
Alaska,1982,12,221621,72.7,198061,64.9,23560,10.6
Arizona,1982,12,1371983,63.8,1211841,56.4,160142,11.7
Arkansas,1982,12,1027806,60.2,924710,54.2,103096,10.0
California,1982,12,12264221,66.1,10907614,58.8,1356607,11.1
Los Angeles County,1982,12,3808483,65.0,3399316,58.0,409167,10.7
Colorado,1982,12,1631945,71.5,1487247,65.1,144698,8.9
Connecticut,1982,12,1605356,66.2,1494731,61.7,110625,6.9
Delaware,1982,12,294367,65.0,269529,59.5,24838,8.4
District of Columbia,1982,12,312577,64.6,277641,57.4,34936,11.2
Florida,1982,12,4766109,57.7,4321086,52.3,445023,9.3
Georgia,1982,12,2682953,65.2,2455271,59.7,227682,8.5
Hawaii,1982,12,465401,66.7,436842,62.6,28559,6.1
Idaho,1982,12,450782,65.9,403274,59.0,47508,10.5
Illinois,1982,12,5628671,65.7,4900979,57.2,727692,12.9
Indiana,1982,12,2611714,64.5,2282307,56.3,329407,12.6
Iowa,1982,12,1412863,65.5,1284353,59.5,128510,9.1
Kansas,1982,12,1202946,67.7,1118411,62.9,84535,7.0
Kentucky,1982,12,1702466,62.9,1497490,55.3,204976,12.0
Louisiana,1982,12,1878585,59.9,1663879,53.1,214706,11.4
Maine,1982,12,525141,61.9,478138,56.4,47003,9.0
Maryland,1982,12,2184025,67.5,2005876,62.0,178149,8.2
Massachusetts,1982,12,2974360,66.8,2735244,61.4,239116,8.0
Michigan,1982,12,4274772,63.5,3563053,52.9,711719,16.6
Minnesota,1982,12,2163153,70.3,1970866,64.1,192287,8.9
Mississippi,1982,12,1069311,58.8,938999,51.6,130312,12.2
Missouri,1982,12,2340569,63.0,2099684,56.5,240885,10.3
Montana,1982,12,391736,66.2,355720,60.1,36016,9.2
Nebraska,1982,12,789060,67.6,740188,63.4,48872,6.2
Nevada,1982,12,487080,73.2,432105,65.0,54975,11.3
New Hampshire,1982,12,490627,68.6,457138,63.9,33489,6.8
New Jersey,1982,12,3654881,63.6,3320345,57.8,334536,9.2
New Mexico,1982,12,605884,61.9,543895,55.6,61989,10.2
New York,1982,12,7994369,59.2,7235137,53.6,759232,9.5
New York city,1982,12,3069814,54.5,2754908,48.9,314906,10.3
North Carolina,1982,12,2933974,65.8,2643874,59.3,290100,9.9
North Dakota,1982,12,316076,65.4,296061,61.3,20015,6.3
Ohio,1982,12,5109593,63.5,4405096,54.8,704497,13.8
Oklahoma,1982,12,1512998,63.4,1387336,58.2,125662,8.3
Oregon,1982,12,1343108,67.0,1182193,59.0,160915,12.0
Pennsylvania,1982,12,5483503,59.9,4810066,52.5,673437,12.3
Rhode Island,1982,12,482045,65.8,431480,58.9,50565,10.5
South Carolina,1982,12,1493333,64.3,1322302,56.9,171031,11.5
South Dakota,1982,12,335362,66.9,315315,62.9,20047,6.0
Tennessee,1982,12,2160654,61.9,1884343,54.0,276311,12.8
Texas,1982,12,7504854,67.5,6887396,61.9,617458,8.2
Utah,1982,12,681166,66.1,616954,59.8,64212,9.4
Vermont,1982,12,263420,67.7,244900,63.0,18520,7.0
Virginia,1982,12,2700598,66.7,2491075,61.6,209523,7.8
Washington,1982,12,2035233,64.2,1789465,56.4,245768,12.1
West Virginia,1982,12,766071,52.2,628663,42.9,137408,17.9
Wisconsin,1982,12,2428630,68.6,2149605,60.7,279025,11.5
Wyoming,1982,12,256141,71.0,235491,65.2,20650,8.1
Alabama,1983,1,1738100,59.9,1478740,51.0,259360,14.9
Alaska,1983,1,223161,72.7,199315,64.9,23846,10.7
Arizona,1983,1,1374083,63.7,1214778,56.3,159305,11.6
Arkansas,1983,1,1028172,60.2,924129,54.1,104043,10.1
California,1983,1,12257740,66.0,10902953,58.7,1354787,11.1
Los Angeles County,1983,1,3801581,64.8,3390534,57.8,411047,10.8
Colorado,1983,1,1637723,71.5,1493797,65.3,143926,8.8
Connecticut,1983,1,1604589,66.2,1495056,61.7,109533,6.8
Delaware,1983,1,294000,64.9,269168,59.4,24832,8.4
District of Columbia,1983,1,312981,64.7,277686,57.4,35295,11.3
Florida,1983,1,4772196,57.6,4324548,52.2,447648,9.4
Georgia,1983,1,2683043,65.1,2455535,59.6,227508,8.5
Hawaii,1983,1,466160,66.7,437281,62.6,28879,6.2
Idaho,1983,1,450727,65.8,403414,58.9,47313,10.5
Illinois,1983,1,5623067,65.6,4894028,57.1,729039,13.0
Indiana,1983,1,2603477,64.3,2277616,56.2,325861,12.5
Iowa,1983,1,1410459,65.4,1281127,59.4,129332,9.2
Kansas,1983,1,1200017,67.5,1117218,62.8,82799,6.9
Kentucky,1983,1,1700557,62.8,1493706,55.1,206851,12.2
Louisiana,1983,1,1883129,60.0,1662969,52.9,220160,11.7
Maine,1983,1,526249,62.1,478761,56.5,47488,9.0
Maryland,1983,1,2185728,67.5,2009508,62.1,176220,8.1
Massachusetts,1983,1,2967821,66.6,2730830,61.3,236991,8.0
Michigan,1983,1,4270825,63.5,3564753,53.0,706072,16.5
Minnesota,1983,1,2162211,70.2,1970578,64.0,191633,8.9
Mississippi,1983,1,1068549,58.7,936048,51.4,132501,12.4
Missouri,1983,1,2342561,63.1,2098187,56.5,244374,10.4
Montana,1983,1,391831,66.1,355593,60.0,36238,9.2
Nebraska,1983,1,789253,67.5,739522,63.3,49731,6.3
Nevada,1983,1,486892,73.2,431871,64.9,55021,11.3
New Hampshire,1983,1,491334,68.7,458504,64.1,32830,6.7
New Jersey,1983,1,3652760,63.5,3319332,57.7,333428,9.1
New Mexico,1983,1,606716,61.8,543506,55.4,63210,10.4
New York,1983,1,7996323,59.2,7232007,53.5,764316,9.6
New York city,1983,1,3062190,54.3,2747443,48.7,314747,10.3
North Carolina,1983,1,2929636,65.6,2638123,59.1,291513,10.0
North Dakota,1983,1,316301,65.4,295999,61.2,20302,6.4
Ohio,1983,1,5106393,63.5,4401030,54.7,705363,13.8
Oklahoma,1983,1,1515176,63.4,1385392,57.9,129784,8.6
Oregon,1983,1,1344523,67.1,1184630,59.1,159893,11.9
Pennsylvania,1983,1,5474072,59.7,4797670,52.4,676402,12.4
Rhode Island,1983,1,481145,65.6,431835,58.8,49310,10.2
South Carolina,1983,1,1489595,64.0,1318753,56.7,170842,11.5
South Dakota,1983,1,335210,66.9,315207,62.9,20003,6.0
Tennessee,1983,1,2162599,61.9,1886319,54.0,276280,12.8
Texas,1983,1,7524154,67.5,6892087,61.8,632067,8.4
Utah,1983,1,682446,66.0,616737,59.6,65709,9.6
Vermont,1983,1,263516,67.7,244917,63.0,18599,7.1
Virginia,1983,1,2702724,66.7,2496362,61.6,206362,7.6
Washington,1983,1,2034619,64.1,1790045,56.4,244574,12.0
West Virginia,1983,1,765724,52.2,625749,42.6,139975,18.3
Wisconsin,1983,1,2424457,68.5,2145485,60.6,278972,11.5
Wyoming,1983,1,256642,71.1,234996,65.1,21646,8.4
Alabama,1983,2,1737094,59.8,1479636,51.0,257458,14.8
Alaska,1983,2,224658,72.5,200818,64.8,23840,10.6
Arizona,1983,2,1375429,63.6,1219185,56.4,156244,11.4
Arkansas,1983,2,1028397,60.2,924136,54.1,104261,10.1
California,1983,2,12249015,65.8,10907130,58.6,1341885,11.0
Los Angeles County,1983,2,3797864,64.6,3388736,57.7,409128,10.8
Colorado,1983,2,1642086,71.6,1500494,65.4,141592,8.6
Connecticut,1983,2,1603970,66.1,1496202,61.7,107768,6.7
Delaware,1983,2,293602,64.7,268857,59.2,24745,8.4
District of Columbia,1983,2,313409,64.9,278000,57.6,35409,11.3
Florida,1983,2,4781301,57.6,4333952,52.2,447349,9.4
Georgia,1983,2,2681077,65.0,2456647,59.6,224430,8.4
Hawaii,1983,2,466443,66.5,437377,62.4,29066,6.2
Idaho,1983,2,450433,65.7,404030,58.9,46403,10.3
Illinois,1983,2,5616253,65.5,4891130,57.1,725123,12.9
Indiana,1983,2,2592261,64.0,2273325,56.1,318936,12.3
Iowa,1983,2,1408254,65.2,1279725,59.3,128529,9.1
Kansas,1983,2,1196718,67.2,1116191,62.7,80527,6.7
Kentucky,1983,2,1697071,62.6,1490606,54.9,206465,12.2
Louisiana,1983,2,1888001,60.0,1663122,52.9,224879,11.9
Maine,1983,2,527303,62.1,479634,56.5,47669,9.0
Maryland,1983,2,2187874,67.5,2014555,62.2,173319,7.9
Massachusetts,1983,2,2962702,66.4,2729547,61.2,233155,7.9
Michigan,1983,2,4266108,63.4,3572043,53.1,694065,16.3
Minnesota,1983,2,2162010,70.2,1972037,64.0,189973,8.8
Mississippi,1983,2,1068006,58.6,933733,51.2,134273,12.6
Missouri,1983,2,2344474,63.1,2098128,56.4,246346,10.5
Montana,1983,2,391834,66.1,355651,60.0,36183,9.2
Nebraska,1983,2,788908,67.4,739057,63.2,49851,6.3
Nevada,1983,2,486556,73.1,432089,64.9,54467,11.2
New Hampshire,1983,2,492235,68.7,460334,64.3,31901,6.5
New Jersey,1983,2,3651121,63.5,3321285,57.7,329836,9.0
New Mexico,1983,2,607687,61.8,543783,55.3,63904,10.5
New York,1983,2,7998848,59.2,7235007,53.5,763841,9.5
New York city,1983,2,3054879,54.1,2742008,48.6,312871,10.2
North Carolina,1983,2,2926152,65.5,2635996,59.0,290156,9.9
North Dakota,1983,2,316528,65.4,296144,61.2,20384,6.4
Ohio,1983,2,5104342,63.5,4403213,54.8,701129,13.7
Oklahoma,1983,2,1517649,63.3,1385294,57.8,132355,8.7
Oregon,1983,2,1344575,67.1,1187662,59.2,156913,11.7
Pennsylvania,1983,2,5464774,59.6,4791900,52.3,672874,12.3
Rhode Island,1983,2,480206,65.4,432630,58.9,47576,9.9
South Carolina,1983,2,1485248,63.8,1315792,56.5,169456,11.4
South Dakota,1983,2,334978,66.7,315209,62.8,19769,5.9
Tennessee,1983,2,2163818,61.9,1889909,54.1,273909,12.7
Texas,1983,2,7539850,67.5,6899534,61.7,640316,8.5
Utah,1983,2,683853,65.9,617083,59.5,66770,9.8
Vermont,1983,2,263641,67.6,245057,62.8,18584,7.0
Virginia,1983,2,2703700,66.6,2503030,61.7,200670,7.4
Washington,1983,2,2033822,64.1,1791576,56.4,242246,11.9
West Virginia,1983,2,764759,52.1,623895,42.5,140864,18.4
Wisconsin,1983,2,2417924,68.3,2143984,60.6,273940,11.3
Wyoming,1983,2,257248,71.1,234670,64.8,22578,8.8
Alabama,1983,3,1737472,59.8,1482980,51.1,254492,14.6
Alaska,1983,3,226092,72.2,202511,64.7,23581,10.4
Arizona,1983,3,1377000,63.5,1225383,56.5,151617,11.0
Arkansas,1983,3,1028895,60.1,925122,54.1,103773,10.1
California,1983,3,12243605,65.7,10924179,58.6,1319426,10.8
Los Angeles County,1983,3,3798073,64.5,3394247,57.7,403826,10.6
Colorado,1983,3,1645399,71.5,1507590,65.5,137809,8.4
Connecticut,1983,3,1604387,66.1,1498941,61.8,105446,6.6
Delaware,1983,3,293382,64.6,268820,59.2,24562,8.4
District of Columbia,1983,3,313829,65.0,278488,57.7,35341,11.3
Florida,1983,3,4796569,57.6,4351637,52.3,444932,9.3
Georgia,1983,3,2679039,64.9,2459279,59.6,219760,8.2
Hawaii,1983,3,466645,66.4,437650,62.3,28995,6.2
Idaho,1983,3,450282,65.5,405215,59.0,45067,10.0
Illinois,1983,3,5609287,65.4,4892749,57.1,716538,12.8
Indiana,1983,3,2581234,63.7,2271040,56.0,310194,12.0
Iowa,1983,3,1406991,65.2,1280515,59.3,126476,9.0
Kansas,1983,3,1193945,67.0,1116098,62.7,77847,6.5
Kentucky,1983,3,1693581,62.4,1489294,54.9,204287,12.1
Louisiana,1983,3,1893320,60.1,1664820,52.8,228500,12.1
Maine,1983,3,528563,62.2,481087,56.6,47476,9.0
Maryland,1983,3,2190868,67.6,2021274,62.4,169594,7.7
Massachusetts,1983,3,2960248,66.3,2732483,61.2,227765,7.7
Michigan,1983,3,4261608,63.4,3583715,53.3,677893,15.9
Minnesota,1983,3,2162916,70.2,1975869,64.1,187047,8.6
Mississippi,1983,3,1068095,58.6,932896,51.2,135199,12.7
Missouri,1983,3,2347236,63.1,2100248,56.5,246988,10.5
Montana,1983,3,391980,66.0,356025,59.9,35955,9.2
Nebraska,1983,3,788279,67.3,739139,63.1,49140,6.2
Nevada,1983,3,486263,72.9,432877,64.9,53386,11.0
New Hampshire,1983,3,493403,68.8,462648,64.5,30755,6.2
New Jersey,1983,3,3652302,63.4,3327549,57.8,324753,8.9
New Mexico,1983,3,608929,61.8,545009,55.3,63920,10.5
New York,1983,3,8005867,59.2,7246805,53.6,759062,9.5
New York city,1983,3,3050385,54.0,2740173,48.5,310212,10.2
North Carolina,1983,3,2924198,65.4,2638894,59.0,285304,9.8
North Dakota,1983,3,316828,65.3,296578,61.2,20250,6.4
Ohio,1983,3,5103796,63.5,4411861,54.9,691935,13.6
Oklahoma,1983,3,1520758,63.3,1387481,57.7,133277,8.8
Oregon,1983,3,1343849,67.0,1190836,59.4,153013,11.4
Pennsylvania,1983,3,5458327,59.5,4794953,52.3,663374,12.2
Rhode Island,1983,3,479512,65.3,433821,59.1,45691,9.5
South Carolina,1983,3,1481248,63.5,1314577,56.4,166671,11.3
South Dakota,1983,3,334875,66.7,315491,62.8,19384,5.8
Tennessee,1983,3,2164853,61.9,1894896,54.2,269957,12.5
Texas,1983,3,7554506,67.4,6912132,61.7,642374,8.5
Utah,1983,3,685457,65.9,618201,59.4,67256,9.8
Vermont,1983,3,263848,67.7,245417,62.9,18431,7.0
Virginia,1983,3,2705348,66.6,2512013,61.8,193335,7.1
Washington,1983,3,2033583,64.0,1794455,56.5,239128,11.8
West Virginia,1983,3,763499,52.0,623117,42.4,140382,18.4
Wisconsin,1983,3,2410673,68.1,2145852,60.7,264821,11.0
Wyoming,1983,3,257736,71.2,234569,64.8,23167,9.0
Alabama,1983,4,1740441,59.9,1489054,51.2,251387,14.4
Alaska,1983,4,227478,72.2,204255,64.8,23223,10.2
Arizona,1983,4,1379506,63.4,1233410,56.7,146096,10.6
Arkansas,1983,4,1030222,60.1,927248,54.1,102974,10.0
California,1983,4,12248042,65.7,10955935,58.7,1292107,10.5
Los Angeles County,1983,4,3802645,64.5,3405947,57.8,396698,10.4
Colorado,1983,4,1648400,71.5,1515354,65.7,133046,8.1
Connecticut,1983,4,1606693,66.2,1503774,61.9,102919,6.4
Delaware,1983,4,293495,64.5,269194,59.2,24301,8.3
District of Columbia,1983,4,314295,65.1,279084,57.8,35211,11.2
Florida,1983,4,4820144,57.8,4378636,52.5,441508,9.2
Georgia,1983,4,2679194,64.8,2464001,59.6,215193,8.0
Hawaii,1983,4,467284,66.4,438580,62.3,28704,6.1
Idaho,1983,4,450521,65.6,406825,59.2,43696,9.7
Illinois,1983,4,5604324,65.4,4899243,57.1,705081,12.6
Indiana,1983,4,2574097,63.5,2272324,56.1,301773,11.7
Iowa,1983,4,1407459,65.2,1283568,59.5,123891,8.8
Kansas,1983,4,1192280,66.9,1117361,62.7,74919,6.3
Kentucky,1983,4,1691634,62.3,1490224,54.8,201410,11.9
Louisiana,1983,4,1899459,60.2,1668450,52.9,231009,12.2
Maine,1983,4,530281,62.3,483232,56.8,47049,8.9
Maryland,1983,4,2195102,67.7,2029852,62.6,165250,7.5
Massachusetts,1983,4,2961037,66.3,2739443,61.4,221594,7.5
Michigan,1983,4,4259951,63.4,3598717,53.6,661234,15.5
Minnesota,1983,4,2165253,70.3,1982025,64.3,183228,8.5
Mississippi,1983,4,1068997,58.6,933940,51.2,135057,12.6
Missouri,1983,4,2351610,63.2,2104909,56.6,246701,10.5
Montana,1983,4,392580,66.0,356892,60.0,35688,9.1
Nebraska,1983,4,787756,67.3,739994,63.2,47762,6.1
Nevada,1983,4,486222,72.8,434230,65.0,51992,10.7
New Hampshire,1983,4,494969,68.9,465433,64.8,29536,6.0
New Jersey,1983,4,3658516,63.4,3338910,57.9,319606,8.7
New Mexico,1983,4,610479,61.8,547161,55.4,63318,10.4
New York,1983,4,8021537,59.3,7269024,53.7,752513,9.4
New York city,1983,4,3051562,54.0,2743370,48.5,308192,10.1
North Carolina,1983,4,2925810,65.4,2647428,59.1,278382,9.5
North Dakota,1983,4,317281,65.3,297325,61.2,19956,6.3
Ohio,1983,4,5105462,63.5,4426083,55.1,679379,13.3
Oklahoma,1983,4,1524684,63.3,1391816,57.8,132868,8.7
Oregon,1983,4,1342906,67.0,1193653,59.5,149253,11.1
Pennsylvania,1983,4,5457291,59.5,4807027,52.4,650264,11.9
Rhode Island,1983,4,479312,65.3,435343,59.3,43969,9.2
South Carolina,1983,4,1478362,63.3,1315798,56.4,162564,11.0
South Dakota,1983,4,335069,66.6,316171,62.9,18898,5.6
Tennessee,1983,4,2167126,62.0,1901355,54.4,265771,12.3
Texas,1983,4,7572254,67.4,6931685,61.7,640569,8.5
Utah,1983,4,687266,66.0,620128,59.5,67138,9.8
Vermont,1983,4,264232,67.6,246049,62.9,18183,6.9
Virginia,1983,4,2709350,66.6,2523574,62.0,185776,6.9
Washington,1983,4,2034872,64.0,1798807,56.6,236065,11.6
West Virginia,1983,4,762698,51.9,623564,42.4,139134,18.2
Wisconsin,1983,4,2404580,68.0,2150904,60.8,253676,10.5
Wyoming,1983,4,258026,71.1,234714,64.7,23312,9.0
Alabama,1983,5,1746093,60.0,1497406,51.5,248687,14.2
Alaska,1983,5,228906,72.0,205993,64.8,22913,10.0
Arizona,1983,5,1383210,63.4,1243114,57.0,140096,10.1
Arkansas,1983,5,1032509,60.2,930189,54.2,102320,9.9
California,1983,5,12263379,65.7,11000522,58.9,1262857,10.3
Los Angeles County,1983,5,3810404,64.6,3421757,58.0,388647,10.2
Colorado,1983,5,1652054,71.5,1524496,66.0,127558,7.7
Connecticut,1983,5,1610878,66.3,1510438,62.2,100440,6.2
Delaware,1983,5,293955,64.6,269923,59.3,24032,8.2
District of Columbia,1983,5,314877,65.2,279786,57.9,35091,11.1
Florida,1983,5,4851026,58.0,4413354,52.8,437672,9.0
Georgia,1983,5,2682644,64.8,2471023,59.7,211621,7.9
Hawaii,1983,5,468544,66.4,440259,62.4,28285,6.0
Idaho,1983,5,451247,65.6,408733,59.4,42514,9.4
Illinois,1983,5,5602091,65.3,4910594,57.3,691497,12.3
Indiana,1983,5,2572839,63.5,2277920,56.2,294919,11.5
Iowa,1983,5,1410116,65.3,1289021,59.7,121095,8.6
Kansas,1983,5,1191827,66.8,1119763,62.8,72064,6.0
Kentucky,1983,5,1691731,62.2,1493237,54.9,198494,11.7
Louisiana,1983,5,1906452,60.3,1674288,53.0,232164,12.2
Maine,1983,5,532397,62.5,485951,57.0,46446,8.7
Maryland,1983,5,2200604,67.9,2039907,62.9,160697,7.3
Massachusetts,1983,5,2964853,66.4,2749528,61.6,215325,7.3
Michigan,1983,5,4262474,63.5,3616395,53.8,646079,15.2
Minnesota,1983,5,2169266,70.4,1990200,64.6,179066,8.3
Mississippi,1983,5,1070608,58.7,936706,51.4,133902,12.5
Missouri,1983,5,2357142,63.3,2111562,56.7,245580,10.4
Montana,1983,5,393774,66.1,358325,60.1,35449,9.0
Nebraska,1983,5,787519,67.2,741526,63.3,45993,5.8
Nevada,1983,5,486538,72.7,436044,65.2,50494,10.4
New Hampshire,1983,5,497024,69.1,468639,65.2,28385,5.7
New Jersey,1983,5,3669874,63.6,3355034,58.1,314840,8.6
New Mexico,1983,5,612252,61.8,549974,55.6,62278,10.2
New York,1983,5,8044485,59.4,7299646,53.9,744839,9.3
New York city,1983,5,3058089,54.0,2750843,48.6,307246,10.0
North Carolina,1983,5,2931790,65.4,2660996,59.4,270794,9.2
North Dakota,1983,5,317901,65.3,298356,61.3,19545,6.1
Ohio,1983,5,5109314,63.6,4444464,55.3,664850,13.0
Oklahoma,1983,5,1529032,63.3,1397694,57.9,131338,8.6
Oregon,1983,5,1342185,66.9,1195685,59.6,146500,10.9
Pennsylvania,1983,5,5462729,59.5,4826886,52.6,635843,11.6
Rhode Island,1983,5,479701,65.3,437126,59.5,42575,8.9
South Carolina,1983,5,1476745,63.2,1319464,56.5,157281,10.7
South Dakota,1983,5,335544,66.7,317204,63.1,18340,5.5
Tennessee,1983,5,2171322,62.0,1909206,54.5,262116,12.1
Texas,1983,5,7595543,67.5,6958649,61.8,636894,8.4
Utah,1983,5,689204,66.0,622762,59.6,66442,9.6
Vermont,1983,5,264797,67.7,246901,63.1,17896,6.8
Virginia,1983,5,2716242,66.7,2537153,62.3,179089,6.6
Washington,1983,5,2038301,64.1,1804763,56.7,233538,11.5
West Virginia,1983,5,762650,51.8,625167,42.5,137483,18.0
Wisconsin,1983,5,2400858,67.9,2158087,61.0,242771,10.1
Wyoming,1983,5,258080,71.1,235111,64.8,22969,8.9
Alabama,1983,6,1753368,60.3,1507143,51.8,246225,14.0
Alaska,1983,6,230378,72.0,207646,64.9,22732,9.9
Arizona,1983,6,1387704,63.5,1254035,57.3,133669,9.6
Arkansas,1983,6,1035449,60.3,933588,54.4,101861,9.8
California,1983,6,12285912,65.7,11053889,59.1,1232023,10.0
Los Angeles County,1983,6,3819764,64.6,3440069,58.2,379695,9.9
Colorado,1983,6,1656470,71.6,1535236,66.3,121234,7.3
Connecticut,1983,6,1616369,66.5,1518271,62.5,98098,6.1
Delaware,1983,6,294726,64.6,270958,59.4,23768,8.1
District of Columbia,1983,6,315513,65.3,280554,58.1,34959,11.1
Florida,1983,6,4885773,58.3,4452590,53.1,433183,8.9
Georgia,1983,6,2689117,64.9,2480214,59.9,208903,7.8
Hawaii,1983,6,470261,66.5,442396,62.6,27865,5.9
Idaho,1983,6,452416,65.7,410862,59.6,41554,9.2
Illinois,1983,6,5601866,65.3,4926369,57.4,675497,12.1
Indiana,1983,6,2577336,63.6,2287827,56.4,289509,11.2
Iowa,1983,6,1414494,65.5,1296255,60.0,118239,8.4
Kansas,1983,6,1192322,66.8,1122740,62.9,69582,5.8
Kentucky,1983,6,1693388,62.2,1497752,55.0,195636,11.6
Louisiana,1983,6,1913498,60.5,1682061,53.1,231437,12.1
Maine,1983,6,534726,62.7,489103,57.3,45623,8.5
Maryland,1983,6,2206847,68.0,2050774,63.2,156073,7.1
Massachusetts,1983,6,2970999,66.5,2761731,61.8,209268,7.0
Michigan,1983,6,4267547,63.6,3636206,54.2,631341,14.8
Minnesota,1983,6,2174573,70.5,1999920,64.8,174653,8.0
Mississippi,1983,6,1072380,58.8,940504,51.5,131876,12.3
Missouri,1983,6,2362720,63.4,2119321,56.9,243399,10.3
Montana,1983,6,395374,66.3,360138,60.4,35236,8.9
Nebraska,1983,6,787514,67.1,743403,63.4,44111,5.6
Nevada,1983,6,487148,72.7,438131,65.4,49017,10.1
New Hampshire,1983,6,499544,69.4,472178,65.6,27366,5.5
New Jersey,1983,6,3684273,63.8,3374456,58.4,309817,8.4
New Mexico,1983,6,614059,61.9,553007,55.7,61052,9.9
New York,1983,6,8069852,59.6,7334696,54.2,735156,9.1
New York city,1983,6,3067486,54.1,2760922,48.7,306564,10.0
North Carolina,1983,6,2941224,65.6,2678044,59.7,263180,8.9
North Dakota,1983,6,318642,65.4,299596,61.5,19046,6.0
Ohio,1983,6,5114604,63.7,4465863,55.6,648741,12.7
Oklahoma,1983,6,1533277,63.3,1404434,58.0,128843,8.4
Oregon,1983,6,1341693,66.9,1196844,59.7,144849,10.8
Pennsylvania,1983,6,5472690,59.6,4852018,52.9,620672,11.3
Rhode Island,1983,6,480548,65.4,439121,59.7,41427,8.6
South Carolina,1983,6,1476160,63.1,1325127,56.7,151033,10.2
South Dakota,1983,6,336170,66.7,318432,63.2,17738,5.3
Tennessee,1983,6,2177256,62.2,1918457,54.8,258799,11.9
Texas,1983,6,7623387,67.6,6991604,62.0,631783,8.3
Utah,1983,6,691092,65.9,625852,59.7,65240,9.4
Vermont,1983,6,265478,67.7,247891,63.2,17587,6.6
Virginia,1983,6,2725169,66.8,2551500,62.6,173669,6.4
Washington,1983,6,2043456,64.2,1812181,56.9,231275,11.3
West Virginia,1983,6,763148,51.9,627636,42.7,135512,17.8
Wisconsin,1983,6,2400109,67.8,2166261,61.2,233848,9.7
Wyoming,1983,6,257828,70.8,235712,64.8,22116,8.6
Alabama,1983,7,1760993,60.5,1517530,52.1,243463,13.8
Alaska,1983,7,231786,71.8,209085,64.7,22701,9.8
Arizona,1983,7,1392192,63.5,1265792,57.7,126400,9.1
Arkansas,1983,7,1038671,60.5,937328,54.6,101343,9.8
California,1983,7,12310447,65.8,11111350,59.4,1199097,9.7
Los Angeles County,1983,7,3828611,64.7,3459073,58.4,369538,9.7
Colorado,1983,7,1661507,71.6,1547189,66.7,114318,6.9
Connecticut,1983,7,1622330,66.7,1526477,62.8,95853,5.9
Delaware,1983,7,295758,64.9,272280,59.7,23478,7.9
District of Columbia,1983,7,316028,65.4,281284,58.2,34744,11.0
Florida,1983,7,4920365,58.5,4493251,53.5,427114,8.7
Georgia,1983,7,2697207,65.0,2491148,60.0,206059,7.6
Hawaii,1983,7,472161,66.6,444623,62.7,27538,5.8
Idaho,1983,7,453879,65.8,413128,59.9,40751,9.0
Illinois,1983,7,5601716,65.3,4945373,57.7,656343,11.7
Indiana,1983,7,2585223,63.8,2300729,56.8,284494,11.0
Iowa,1983,7,1419450,65.7,1304076,60.4,115374,8.1
Kansas,1983,7,1193352,66.9,1125782,63.1,67570,5.7
Kentucky,1983,7,1695759,62.3,1503427,55.2,192332,11.3
Louisiana,1983,7,1919533,60.6,1691008,53.3,228525,11.9
Maine,1983,7,536993,62.9,492377,57.7,44616,8.3
Maryland,1983,7,2213170,68.2,2061773,63.5,151397,6.8
Massachusetts,1983,7,2978213,66.6,2774857,62.0,203356,6.8
Michigan,1983,7,4272570,63.7,3657611,54.5,614959,14.4
Minnesota,1983,7,2180293,70.7,2010188,65.2,170105,7.8
Mississippi,1983,7,1073814,58.8,944588,51.7,129226,12.0
Missouri,1983,7,2367122,63.5,2127507,57.1,239615,10.1
Montana,1983,7,397030,66.5,362055,60.6,34975,8.8
Nebraska,1983,7,787612,67.1,745219,63.5,42393,5.4
Nevada,1983,7,487858,72.7,440312,65.6,47546,9.7
New Hampshire,1983,7,502298,69.7,475804,66.0,26494,5.3
New Jersey,1983,7,3699421,64.0,3395697,58.7,303724,8.2
New Mexico,1983,7,615663,61.9,555853,55.9,59810,9.7
New York,1983,7,8092616,59.7,7370162,54.4,722454,8.9
New York city,1983,7,3077151,54.3,2772167,48.9,304984,9.9
North Carolina,1983,7,2952742,65.8,2696301,60.1,256441,8.7
North Dakota,1983,7,319424,65.5,300895,61.7,18529,5.8
Ohio,1983,7,5119518,63.8,4488926,55.9,630592,12.3
Oklahoma,1983,7,1536790,63.3,1411252,58.1,125538,8.2
Oregon,1983,7,1340849,66.8,1197210,59.7,143639,10.7
Pennsylvania,1983,7,5482828,59.7,4878389,53.1,604439,11.0
Rhode Island,1983,7,481504,65.5,441253,60.0,40251,8.4
South Carolina,1983,7,1476314,63.0,1332177,56.9,144137,9.8
South Dakota,1983,7,336855,66.8,319700,63.4,17155,5.1
Tennessee,1983,7,2184197,62.3,1929186,55.0,255011,11.7
Texas,1983,7,7652739,67.7,7027875,62.1,624864,8.2
Utah,1983,7,692721,65.9,629145,59.9,63576,9.2
Vermont,1983,7,266209,67.9,248943,63.5,17266,6.5
Virginia,1983,7,2734421,67.0,2565497,62.8,168924,6.2
Washington,1983,7,2049452,64.3,1820736,57.1,228716,11.2
West Virginia,1983,7,763707,51.9,630612,42.8,133095,17.4
Wisconsin,1983,7,2401982,67.9,2174701,61.5,227281,9.5
Wyoming,1983,7,257355,70.7,236446,65.0,20909,8.1
Alabama,1983,8,1767730,60.7,1527681,52.4,240049,13.6
Alaska,1983,8,232974,71.9,210165,64.9,22809,9.8
Arizona,1983,8,1396222,63.5,1278069,58.1,118153,8.5
Arkansas,1983,8,1041648,60.6,941094,54.7,100554,9.7
California,1983,8,12331225,65.8,11166476,59.5,1164749,9.4
Los Angeles County,1983,8,3834545,64.7,3476245,58.6,358300,9.3
Colorado,1983,8,1666627,71.7,1558855,67.1,107772,6.5
Connecticut,1983,8,1627680,66.9,1533997,63.0,93683,5.8
Delaware,1983,8,296961,65.0,273800,59.9,23161,7.8
District of Columbia,1983,8,316255,65.5,281854,58.4,34401,10.9
Florida,1983,8,4951237,58.7,4532239,53.8,418998,8.5
Georgia,1983,8,2705190,65.1,2502825,60.2,202365,7.5
Hawaii,1983,8,473760,66.7,446460,62.9,27300,5.8
Idaho,1983,8,455372,65.9,415470,60.1,39902,8.8
Illinois,1983,8,5599385,65.3,4964499,57.9,634886,11.3
Indiana,1983,8,2593384,63.9,2314079,57.1,279305,10.8
Iowa,1983,8,1423764,65.9,1311327,60.7,112437,7.9
Kansas,1983,8,1194287,66.9,1128197,63.2,66090,5.5
Kentucky,1983,8,1698154,62.3,1509924,55.4,188230,11.1
Louisiana,1983,8,1923580,60.7,1699963,53.6,223617,11.6
Maine,1983,8,538817,63.0,495294,57.9,43523,8.1
Maryland,1983,8,2218481,68.3,2071708,63.7,146773,6.6
Massachusetts,1983,8,2985227,66.7,2787628,62.3,197599,6.6
Michigan,1983,8,4274763,63.7,3678567,54.8,596196,13.9
Minnesota,1983,8,2185348,70.8,2019503,65.4,165845,7.6
Mississippi,1983,8,1074546,58.8,948245,51.9,126301,11.8
Missouri,1983,8,2369666,63.5,2135251,57.2,234415,9.9
Montana,1983,8,398326,66.7,363732,60.9,34594,8.7
Nebraska,1983,8,787623,67.0,746597,63.5,41026,5.2
Nevada,1983,8,488433,72.6,442418,65.7,46015,9.4
New Hampshire,1983,8,504888,69.9,479116,66.4,25772,5.1
New Jersey,1983,8,3713537,64.2,3417083,59.0,296454,8.0
New Mexico,1983,8,616790,61.9,558230,56.0,58560,9.5
New York,1983,8,8106755,59.8,7399979,54.6,706776,8.7
New York city,1983,8,3084423,54.3,2782556,49.0,301867,9.8
North Carolina,1983,8,2964947,66.0,2713524,60.4,251423,8.5
North Dakota,1983,8,320123,65.6,302064,61.9,18059,5.6
Ohio,1983,8,5121636,63.8,4510819,56.2,610817,11.9
Oklahoma,1983,8,1539173,63.4,1417217,58.4,121956,7.9
Oregon,1983,8,1339257,66.7,1196704,59.6,142553,10.6
Pennsylvania,1983,8,5489400,59.8,4901747,53.4,587653,10.7
Rhode Island,1983,8,482102,65.5,443284,60.2,38818,8.1
South Carolina,1983,8,1476688,63.0,1339494,57.1,137194,9.3
South Dakota,1983,8,337443,67.0,320813,63.7,16630,4.9
Tennessee,1983,8,2191079,62.5,1940739,55.3,250340,11.4
Texas,1983,8,7678715,67.8,7062795,62.3,615920,8.0
Utah,1983,8,693897,66.0,632374,60.2,61523,8.9
Vermont,1983,8,266890,68.1,249925,63.8,16965,6.4
Virginia,1983,8,2741847,67.1,2577793,63.0,164054,6.0
Washington,1983,8,2055414,64.4,1829492,57.4,225922,11.0
West Virginia,1983,8,763786,51.9,633649,43.0,130137,17.0
Wisconsin,1983,8,2404843,67.9,2182708,61.7,222135,9.2
Wyoming,1983,8,256780,70.5,237184,65.2,19596,7.6
Alabama,1983,9,1772535,60.8,1536684,52.7,235851,13.3
Alaska,1983,9,233905,72.0,210884,64.9,23021,9.8
Arizona,1983,9,1399610,63.4,1290474,58.5,109136,7.8
Arkansas,1983,9,1044054,60.7,944723,54.9,99331,9.5
California,1983,9,12345237,65.7,11215098,59.7,1130139,9.2
Los Angeles County,1983,9,3836661,64.6,3490236,58.8,346425,9.0
Colorado,1983,9,1671303,71.9,1568912,67.5,102391,6.1
Connecticut,1983,9,1631821,67.0,1540289,63.3,91532,5.6
Delaware,1983,9,298203,65.3,275414,60.3,22789,7.6
District of Columbia,1983,9,316148,65.5,282229,58.4,33919,10.7
Florida,1983,9,4976578,58.9,4567581,54.1,408997,8.2
Georgia,1983,9,2711658,65.1,2514128,60.4,197530,7.3
Hawaii,1983,9,474644,66.8,447543,62.9,27101,5.7
Idaho,1983,9,456651,66.0,417836,60.4,38815,8.5
Illinois,1983,9,5594730,65.2,4982118,58.0,612612,10.9
Indiana,1983,9,2599401,64.1,2326261,57.3,273140,10.5
Iowa,1983,9,1426662,66.0,1317195,61.0,109467,7.7
Kansas,1983,9,1194641,66.9,1129626,63.2,65015,5.4
Kentucky,1983,9,1700042,62.4,1516813,55.7,183229,10.8
Louisiana,1983,9,1925061,60.7,1707964,53.8,217097,11.3
Maine,1983,9,539933,63.1,497585,58.1,42348,7.8
Maryland,1983,9,2221794,68.3,2079732,63.9,142062,6.4
Massachusetts,1983,9,2991568,66.8,2799663,62.5,191905,6.4
Michigan,1983,9,4273076,63.6,3697228,55.1,575848,13.5
Minnesota,1983,9,2189171,70.9,2027126,65.6,162045,7.4
Mississippi,1983,9,1074321,58.8,950988,52.0,123333,11.5
Missouri,1983,9,2370420,63.5,2142021,57.4,228399,9.6
Montana,1983,9,398984,66.7,364980,61.0,34004,8.5
Nebraska,1983,9,787397,67.0,747350,63.6,40047,5.1
Nevada,1983,9,488768,72.5,444370,65.9,44398,9.1
New Hampshire,1983,9,507018,70.0,481886,66.6,25132,5.0
New Jersey,1983,9,3725534,64.3,3437507,59.3,288027,7.7
New Mexico,1983,9,617280,61.9,560135,56.2,57145,9.3
New York,1983,9,8108669,59.8,7419967,54.7,688702,8.5
New York city,1983,9,3087766,54.4,2790500,49.1,297266,9.6
North Carolina,1983,9,2976247,66.1,2728819,60.6,247428,8.3
North Dakota,1983,9,320632,65.7,302957,62.1,17675,5.5
Ohio,1983,9,5119700,63.8,4529663,56.4,590037,11.5
Oklahoma,1983,9,1540444,63.5,1422033,58.6,118411,7.7
Oregon,1983,9,1336712,66.5,1195740,59.5,140972,10.5
Pennsylvania,1983,9,5490923,59.8,4920061,53.6,570862,10.4
Rhode Island,1983,9,482146,65.5,445024,60.5,37122,7.7
South Carolina,1983,9,1477038,62.9,1346227,57.3,130811,8.9
South Dakota,1983,9,337810,66.9,321646,63.7,16164,4.8
Tennessee,1983,9,2197122,62.6,1952500,55.6,244622,11.1
Texas,1983,9,7696654,67.8,7093046,62.5,603608,7.8
Utah,1983,9,694564,66.1,635377,60.5,59187,8.5
Vermont,1983,9,267386,68.0,250725,63.8,16661,6.2
Virginia,1983,9,2746435,67.1,2587630,63.2,158805,5.8
Washington,1983,9,2060706,64.5,1837660,57.6,223046,10.8
West Virginia,1983,9,762972,51.9,636428,43.3,126544,16.6
Wisconsin,1983,9,2406796,68.0,2189712,61.8,217084,9.0
Wyoming,1983,9,256207,70.4,237807,65.3,18400,7.2
Alabama,1983,10,1774869,60.8,1543891,52.9,230978,13.0
Alaska,1983,10,234683,72.0,211394,64.8,23289,9.9
Arizona,1983,10,1402252,63.4,1302374,58.9,99878,7.1
Arkansas,1983,10,1046005,60.7,948372,55.1,97633,9.3
California,1983,10,12353662,65.6,11256899,59.8,1096763,8.9
Los Angeles County,1983,10,3836128,64.5,3501372,58.9,334756,8.7
Colorado,1983,10,1675464,71.9,1577339,67.7,98125,5.9
Connecticut,1983,10,1634896,67.1,1545585,63.4,89311,5.5
Delaware,1983,10,299344,65.4,277041,60.5,22303,7.5
District of Columbia,1983,10,315865,65.4,282547,58.5,33318,10.5
Florida,1983,10,4996983,59.0,4599416,54.3,397567,8.0
Georgia,1983,10,2715870,65.1,2524218,60.5,191652,7.1
Hawaii,1983,10,474684,66.7,447812,62.9,26872,5.7
Idaho,1983,10,457605,66.0,420167,60.6,37438,8.2
Illinois,1983,10,5589093,65.1,4997781,58.2,591312,10.6
Indiana,1983,10,2601912,64.1,2336333,57.5,265579,10.2
Iowa,1983,10,1427810,66.1,1321196,61.2,106614,7.5
Kansas,1983,10,1194263,66.8,1130237,63.2,64026,5.4
Kentucky,1983,10,1700912,62.4,1523434,55.9,177478,10.4
Louisiana,1983,10,1924041,60.6,1714546,54.0,209495,10.9
Maine,1983,10,540421,63.1,499342,58.3,41079,7.6
Maryland,1983,10,2222809,68.2,2085814,64.0,136995,6.2
Massachusetts,1983,10,2997313,66.9,2811290,62.7,186023,6.2
Michigan,1983,10,4268939,63.6,3713524,55.3,555415,13.0
Minnesota,1983,10,2191839,70.9,2033296,65.8,158543,7.2
Mississippi,1983,10,1073248,58.7,952636,52.1,120612,11.2
Missouri,1983,10,2369813,63.4,2147949,57.5,221864,9.4
Montana,1983,10,399041,66.7,365853,61.2,33188,8.3
Nebraska,1983,10,786986,66.9,747649,63.6,39337,5.0
Nevada,1983,10,488957,72.3,446217,66.0,42740,8.7
New Hampshire,1983,10,508659,70.2,484195,66.8,24464,4.8
New Jersey,1983,10,3735487,64.4,3456672,59.6,278815,7.5
New Mexico,1983,10,617264,61.8,561824,56.2,55440,9.0
New York,1983,10,8099624,59.7,7430518,54.7,669106,8.3
New York city,1983,10,3087303,54.3,2795851,49.2,291452,9.4
North Carolina,1983,10,2986491,66.2,2743048,60.8,243443,8.2
North Dakota,1983,10,320947,65.8,303571,62.2,17376,5.4
Ohio,1983,10,5113829,63.7,4544573,56.6,569256,11.1
Oklahoma,1983,10,1540785,63.5,1426006,58.8,114779,7.4
Oregon,1983,10,1333662,66.3,1195331,59.4,138331,10.4
Pennsylvania,1983,10,5487676,59.8,4933483,53.7,554193,10.1
Rhode Island,1983,10,481820,65.4,446526,60.6,35294,7.3
South Carolina,1983,10,1477357,62.8,1352104,57.5,125253,8.5
South Dakota,1983,10,337931,66.9,322201,63.8,15730,4.7
Tennessee,1983,10,2201962,62.7,1964181,55.9,237781,10.8
Texas,1983,10,7705203,67.8,7118509,62.6,586694,7.6
Utah,1983,10,694945,66.2,638176,60.8,56769,8.2
Vermont,1983,10,267694,68.1,251340,64.0,16354,6.1
Virginia,1983,10,2748818,67.0,2595715,63.3,153103,5.6
Washington,1983,10,2064678,64.6,1844959,57.7,219719,10.6
West Virginia,1983,10,761163,51.7,638839,43.4,122324,16.1
Wisconsin,1983,10,2406459,67.9,2195592,62.0,210867,8.8
Wyoming,1983,10,255781,70.3,238276,65.5,17505,6.8
Alabama,1983,11,1775186,60.8,1549141,53.0,226045,12.7
Alaska,1983,11,235450,71.8,211876,64.6,23574,10.0
Arizona,1983,11,1404297,63.3,1312871,59.2,91426,6.5
Arkansas,1983,11,1047707,60.8,951948,55.2,95759,9.1
California,1983,11,12361253,65.5,11293760,59.9,1067493,8.6
Los Angeles County,1983,11,3834942,64.4,3510348,58.9,324594,8.5
Colorado,1983,11,1678854,72.0,1584260,67.9,94594,5.6
Connecticut,1983,11,1637440,67.1,1550349,63.6,87091,5.3
Delaware,1983,11,300344,65.6,278660,60.8,21684,7.2
District of Columbia,1983,11,315549,65.3,282924,58.6,32625,10.3
Florida,1983,11,5014164,59.0,4628474,54.5,385690,7.7
Georgia,1983,11,2718417,65.0,2532951,60.6,185466,6.8
Hawaii,1983,11,474141,66.5,447491,62.8,26650,5.6
Idaho,1983,11,458188,66.0,422287,60.8,35901,7.8
Illinois,1983,11,5584291,65.0,5010695,58.3,573596,10.3
Indiana,1983,11,2601753,64.1,2344488,57.7,257265,9.9
Iowa,1983,11,1427277,66.1,1323202,61.3,104075,7.3
Kansas,1983,11,1193532,66.7,1130467,63.2,63065,5.3
Kentucky,1983,11,1701019,62.4,1529142,56.1,171877,10.1
Louisiana,1983,11,1921687,60.5,1719684,54.2,202003,10.5
Maine,1983,11,540631,63.0,500828,58.4,39803,7.4
Maryland,1983,11,2222190,68.2,2090324,64.1,131866,5.9
Massachusetts,1983,11,3002659,66.9,2822591,62.9,180068,6.0
Michigan,1983,11,4265116,63.5,3728287,55.5,536829,12.6
Minnesota,1983,11,2194141,71.0,2038796,65.9,155345,7.1
Mississippi,1983,11,1071785,58.6,953330,52.1,118455,11.1
Missouri,1983,11,2368679,63.4,2153378,57.6,215301,9.1
Montana,1983,11,398780,66.6,366484,61.2,32296,8.1
Nebraska,1983,11,786588,66.9,747757,63.6,38831,4.9
Nevada,1983,11,489198,72.2,448017,66.1,41181,8.4
New Hampshire,1983,11,510002,70.2,486271,66.9,23731,4.7
New Jersey,1983,11,3744851,64.5,3474823,59.9,270028,7.2
New Mexico,1983,11,617210,61.7,563594,56.4,53616,8.7
New York,1983,11,8084293,59.5,7434675,54.8,649618,8.0
New York city,1983,11,3083778,54.2,2798683,49.2,285095,9.2
North Carolina,1983,11,2996442,66.4,2757017,61.0,239425,8.0
North Dakota,1983,11,321144,65.7,303983,62.2,17161,5.3
Ohio,1983,11,5105350,63.6,4555066,56.7,550284,10.8
Oklahoma,1983,11,1540745,63.5,1429290,58.9,111455,7.2
Oregon,1983,11,1331115,66.1,1196277,59.4,134838,10.1
Pennsylvania,1983,11,5481730,59.7,4942923,53.8,538807,9.8
Rhode Island,1983,11,481514,65.3,447963,60.8,33551,7.0
South Carolina,1983,11,1477683,62.8,1357118,57.7,120565,8.2
South Dakota,1983,11,337892,66.9,322568,63.9,15324,4.5
Tennessee,1983,11,2205494,62.7,1975149,56.2,230345,10.4
Texas,1983,11,7707479,67.7,7140564,62.7,566915,7.4
Utah,1983,11,695380,66.2,640849,61.0,54531,7.8
Vermont,1983,11,267909,68.2,251847,64.1,16062,6.0
Virginia,1983,11,2750457,67.0,2603082,63.4,147375,5.4
Washington,1983,11,2067115,64.6,1851178,57.8,215937,10.4
West Virginia,1983,11,758830,51.6,640918,43.6,117912,15.5
Wisconsin,1983,11,2403946,67.8,2200706,62.1,203240,8.5
Wyoming,1983,11,255481,70.4,238552,65.7,16929,6.6
Alabama,1983,12,1774964,60.7,1553354,53.1,221610,12.5
Alaska,1983,12,236296,71.8,212424,64.6,23872,10.1
Arizona,1983,12,1406680,63.2,1321980,59.4,84700,6.0
Arkansas,1983,12,1049374,60.8,955260,55.4,94114,9.0
California,1983,12,12374638,65.4,11330300,59.9,1044338,8.4
Los Angeles County,1983,12,3834939,64.3,3518175,59.0,316764,8.3
Colorado,1983,12,1681584,72.0,1589843,68.1,91741,5.5
Connecticut,1983,12,1640458,67.2,1555412,63.7,85046,5.2
Delaware,1983,12,301345,65.7,280382,61.1,20963,7.0
District of Columbia,1983,12,315337,65.3,283455,58.7,31882,10.1
Florida,1983,12,5030863,59.1,4656350,54.7,374513,7.4
Georgia,1983,12,2721200,65.0,2541417,60.7,179783,6.6
Hawaii,1983,12,473590,66.3,447092,62.6,26498,5.6
Idaho,1983,12,458569,66.0,424079,61.0,34490,7.5
Illinois,1983,12,5582542,65.0,5021762,58.4,560780,10.0
Indiana,1983,12,2601782,64.0,2352430,57.9,249352,9.6
Iowa,1983,12,1425963,66.0,1323802,61.3,102161,7.2
Kansas,1983,12,1193283,66.7,1130986,63.2,62297,5.2
Kentucky,1983,12,1701513,62.4,1534012,56.3,167501,9.8
Louisiana,1983,12,1919884,60.4,1723888,54.3,195996,10.2
Maine,1983,12,540986,63.0,502411,58.5,38575,7.1
Maryland,1983,12,2221593,68.1,2094143,64.2,127450,5.7
Massachusetts,1983,12,3008377,67.0,2834061,63.1,174316,5.8
Michigan,1983,12,4264441,63.4,3742662,55.7,521779,12.2
Minnesota,1983,12,2197193,71.0,2044652,66.1,152541,6.9
Mississippi,1983,12,1070783,58.5,953894,52.1,116889,10.9
Missouri,1983,12,2368067,63.3,2158963,57.7,209104,8.8
Montana,1983,12,398581,66.5,367127,61.3,31454,7.9
Nebraska,1983,12,786399,66.8,747942,63.5,38457,4.9
Nevada,1983,12,489707,72.1,449885,66.3,39822,8.1
New Hampshire,1983,12,511315,70.2,488312,67.1,23003,4.5
New Jersey,1983,12,3755982,64.7,3493059,60.2,262923,7.0
New Mexico,1983,12,617577,61.6,565698,56.5,51879,8.4
New York,1983,12,8070649,59.4,7438772,54.8,631877,7.8
New York city,1983,12,3079965,54.1,2800863,49.2,279102,9.1
North Carolina,1983,12,3000081,66.3,2771750,61.3,228331,7.6
North Dakota,1983,12,321397,65.7,304348,62.2,17049,5.3
Ohio,1983,12,5097259,63.5,4562515,56.8,534744,10.5
Oklahoma,1983,12,1540824,63.5,1431971,59.0,108853,7.1
Oregon,1983,12,1330093,66.0,1198801,59.5,131292,9.9
Pennsylvania,1983,12,5476111,59.6,4949949,53.9,526162,9.6
Rhode Island,1983,12,481666,65.3,449573,60.9,32093,6.7
South Carolina,1983,12,1478235,62.7,1361572,57.8,116663,7.9
South Dakota,1983,12,337871,66.8,322900,63.8,14971,4.4
Tennessee,1983,12,2208117,62.7,1985068,56.4,223049,10.1
Texas,1983,12,7709287,67.6,7162049,62.8,547238,7.1
Utah,1983,12,696175,66.3,643571,61.3,52604,7.6
Vermont,1983,12,268175,68.1,252413,64.1,15762,5.9
Virginia,1983,12,2753666,66.9,2611028,63.5,142638,5.2
Washington,1983,12,2068603,64.6,1856382,57.9,212221,10.3
West Virginia,1983,12,756797,51.5,642856,43.7,113941,15.1
Wisconsin,1983,12,2401048,67.7,2205682,62.2,195366,8.1
Wyoming,1983,12,255236,70.3,238647,65.7,16589,6.5
Alabama,1984,1,1775460,60.7,1557955,53.3,217505,12.3
Alaska,1984,1,237307,71.9,213178,64.6,24129,10.2
Arizona,1984,1,1410353,63.2,1330606,59.6,79747,5.7
Arkansas,1984,1,1051032,60.9,958251,55.5,92781,8.8
California,1984,1,12398171,65.4,11372769,60.0,1025402,8.3
Los Angeles County,1984,1,3836640,64.2,3525903,59.0,310737,8.1
Colorado,1984,1,1684480,72.0,1594866,68.2,89614,5.3
Connecticut,1984,1,1644889,67.4,1561780,64.0,83109,5.1
Delaware,1984,1,302468,65.9,282275,61.5,20193,6.7
District of Columbia,1984,1,315362,65.3,284286,58.9,31076,9.9
Florida,1984,1,5049106,59.2,4685019,54.9,364087,7.2
Georgia,1984,1,2725872,65.0,2551121,60.8,174751,6.4
Hawaii,1984,1,473594,66.3,447196,62.6,26398,5.6
Idaho,1984,1,459007,66.0,425634,61.2,33373,7.3
Illinois,1984,1,5584713,65.0,5033958,58.6,550755,9.9
Indiana,1984,1,2604282,64.1,2362121,58.1,242161,9.3
Iowa,1984,1,1424726,65.9,1323822,61.3,100904,7.1
Kansas,1984,1,1194028,66.7,1132401,63.2,61627,5.2
Kentucky,1984,1,1702759,62.4,1538443,56.4,164316,9.6
Louisiana,1984,1,1919875,60.4,1728063,54.4,191812,10.0
Maine,1984,1,541845,63.0,504505,58.7,37340,6.9
Maryland,1984,1,2222409,68.0,2098460,64.2,123949,5.6
Massachusetts,1984,1,3015140,67.1,2846557,63.4,168583,5.6
Michigan,1984,1,4268240,63.5,3758111,55.9,510129,12.0
Minnesota,1984,1,2201627,71.1,2051780,66.3,149847,6.8
Mississippi,1984,1,1070956,58.5,955429,52.2,115527,10.8
Missouri,1984,1,2368422,63.3,2165477,57.8,202945,8.6
Montana,1984,1,398756,66.6,368050,61.4,30706,7.7
Nebraska,1984,1,786503,66.8,748553,63.6,37950,4.8
Nevada,1984,1,490589,72.0,451924,66.4,38665,7.9
New Hampshire,1984,1,512836,70.3,490526,67.3,22310,4.4
New Jersey,1984,1,3769832,64.9,3512624,60.4,257208,6.8
New Mexico,1984,1,618468,61.7,568279,56.7,50189,8.1
New York,1984,1,8064319,59.3,7448740,54.8,615579,7.6
New York city,1984,1,3077803,54.0,2804058,49.2,273745,8.9
North Carolina,1984,1,3005890,66.4,2787871,61.5,218019,7.3
North Dakota,1984,1,321799,65.8,304792,62.3,17007,5.3
Ohio,1984,1,5091856,63.4,4569907,56.9,521949,10.3
Oklahoma,1984,1,1541175,63.5,1434492,59.1,106683,6.9
Oregon,1984,1,1330464,66.0,1202118,59.6,128346,9.6
Pennsylvania,1984,1,5472887,59.6,4957126,54.0,515761,9.4
Rhode Island,1984,1,482502,65.4,451574,61.2,30928,6.4
South Carolina,1984,1,1479105,62.7,1366022,57.9,113083,7.6
South Dakota,1984,1,338081,66.8,323391,63.9,14690,4.3
Tennessee,1984,1,2210387,62.7,1994151,56.6,216236,9.8
Texas,1984,1,7714279,67.5,7186214,62.9,528065,6.8
Utah,1984,1,697420,66.4,646516,61.6,50904,7.3
Vermont,1984,1,268604,68.2,253208,64.3,15396,5.7
Virginia,1984,1,2759975,67.0,2620497,63.6,139478,5.1
Washington,1984,1,2069553,64.5,1861093,58.0,208460,10.1
West Virginia,1984,1,755560,51.4,644895,43.9,110665,14.6
Wisconsin,1984,1,2399347,67.6,2211043,62.3,188304,7.8
Wyoming,1984,1,254955,70.2,238632,65.7,16323,6.4
Alabama,1984,2,1776943,60.7,1563259,53.4,213684,12.0
Alaska,1984,2,238549,72.1,214256,64.7,24293,10.2
Arizona,1984,2,1415246,63.2,1339478,59.8,75768,5.4
Arkansas,1984,2,1052456,60.9,960677,55.6,91779,8.7
California,1984,2,12432300,65.5,11423242,60.2,1009058,8.1
Los Angeles County,1984,2,3840259,64.1,3534185,59.0,306074,8.0
Colorado,1984,2,1688516,72.1,1600133,68.3,88383,5.2
Connecticut,1984,2,1650829,67.5,1569613,64.2,81216,4.9
Delaware,1984,2,303704,66.0,284176,61.8,19528,6.4
District of Columbia,1984,2,315659,65.4,285436,59.1,30223,9.6
Florida,1984,2,5069256,59.2,4714688,55.1,354568,7.0
Georgia,1984,2,2733195,65.0,2562689,61.0,170506,6.2
Hawaii,1984,2,474244,66.3,447953,62.7,26291,5.5
Idaho,1984,2,459639,66.0,427005,61.4,32634,7.1
Illinois,1984,2,5590833,65.0,5049923,58.7,540910,9.7
Indiana,1984,2,2609975,64.1,2374198,58.3,235777,9.0
Iowa,1984,2,1424005,65.9,1323849,61.3,100156,7.0
Kansas,1984,2,1195688,66.7,1134805,63.3,60883,5.1
Kentucky,1984,2,1704394,62.5,1542360,56.5,162034,9.5
Louisiana,1984,2,1921983,60.5,1732583,54.5,189400,9.9
Maine,1984,2,543353,63.1,507229,58.9,36124,6.6
Maryland,1984,2,2225430,68.0,2103977,64.3,121453,5.5
Massachusetts,1984,2,3022773,67.2,2859973,63.6,162800,5.4
Michigan,1984,2,4276934,63.6,3775311,56.1,501623,11.7
Minnesota,1984,2,2207038,71.2,2059862,66.5,147176,6.7
Mississippi,1984,2,1072249,58.5,958028,52.2,114221,10.7
Missouri,1984,2,2369344,63.2,2173071,58.0,196273,8.3
Montana,1984,2,399433,66.6,369278,61.5,30155,7.5
Nebraska,1984,2,786995,66.8,749769,63.6,37226,4.7
Nevada,1984,2,491906,72.0,454109,66.5,37797,7.7
New Hampshire,1984,2,514742,70.4,493050,67.4,21692,4.2
New Jersey,1984,2,3785123,65.1,3533011,60.7,252112,6.7
New Mexico,1984,2,619717,61.7,571137,56.8,48580,7.8
New York,1984,2,8066238,59.3,7464981,54.9,601257,7.5
New York city,1984,2,3078049,54.0,2808242,49.3,269807,8.8
North Carolina,1984,2,3013489,66.4,2804254,61.8,209235,6.9
North Dakota,1984,2,322312,65.9,305314,62.4,16998,5.3
Ohio,1984,2,5090260,63.4,4579275,57.0,510985,10.0
Oklahoma,1984,2,1541849,63.6,1437067,59.2,104782,6.8
Oregon,1984,2,1331631,66.0,1205254,59.7,126377,9.5
Pennsylvania,1984,2,5473095,59.6,4965904,54.0,507191,9.3
Rhode Island,1984,2,483952,65.5,453967,61.4,29985,6.2
South Carolina,1984,2,1480390,62.6,1370946,58.0,109444,7.4
South Dakota,1984,2,338610,66.9,324110,64.1,14500,4.3
Tennessee,1984,2,2212730,62.8,2002509,56.8,210221,9.5
Texas,1984,2,7722769,67.5,7213131,63.0,509638,6.6
Utah,1984,2,699069,66.6,649687,61.9,49382,7.1
Vermont,1984,2,269197,68.3,254235,64.5,14962,5.6
Virginia,1984,2,2768923,67.1,2630862,63.7,138061,5.0
Washington,1984,2,2070364,64.5,1865703,58.1,204661,9.9
West Virginia,1984,2,755242,51.4,647093,44.0,108149,14.3
Wisconsin,1984,2,2399551,67.6,2216727,62.5,182824,7.6
Wyoming,1984,2,254646,70.2,238611,65.7,16035,6.3
Alabama,1984,3,1779442,60.7,1568978,53.5,210464,11.8
Alaska,1984,3,239959,72.3,215622,64.9,24337,10.1
Arizona,1984,3,1420705,63.3,1348510,60.1,72195,5.1
Arkansas,1984,3,1053408,60.9,962265,55.7,91143,8.7
California,1984,3,12475349,65.6,11479163,60.3,996186,8.0
Los Angeles County,1984,3,3846751,64.1,3543624,59.1,303127,7.9
Colorado,1984,3,1694118,72.2,1605775,68.5,88343,5.2
Connecticut,1984,3,1657525,67.8,1577954,64.5,79571,4.8
Delaware,1984,3,304959,66.2,285844,62.0,19115,6.3
District of Columbia,1984,3,316405,65.5,286981,59.4,29424,9.3
Florida,1984,3,5090916,59.3,4743951,55.3,346965,6.8
Georgia,1984,3,2743154,65.2,2575649,61.2,167505,6.1
Hawaii,1984,3,475165,66.4,449013,62.7,26152,5.5
Idaho,1984,3,460501,66.1,428193,61.4,32308,7.0
Illinois,1984,3,5599066,65.1,5068477,58.9,530589,9.5
Indiana,1984,3,2618026,64.3,2387811,58.7,230215,8.8
Iowa,1984,3,1424044,65.9,1324418,61.3,99626,7.0
Kansas,1984,3,1198128,66.8,1137837,63.4,60291,5.0
Kentucky,1984,3,1706241,62.5,1545752,56.7,160489,9.4
Louisiana,1984,3,1926174,60.6,1737477,54.6,188697,9.8
Maine,1984,3,545188,63.2,510116,59.2,35072,6.4
Maryland,1984,3,2230938,68.1,2110666,64.4,120272,5.4
Massachusetts,1984,3,3030940,67.3,2873522,63.8,157418,5.2
Michigan,1984,3,4289943,63.7,3793629,56.4,496314,11.6
Minnesota,1984,3,2212709,71.4,2067830,66.7,144879,6.5
Mississippi,1984,3,1074641,58.6,961254,52.4,113387,10.6
Missouri,1984,3,2370439,63.2,2181083,58.2,189356,8.0
Montana,1984,3,400602,66.8,370675,61.8,29927,7.5
Nebraska,1984,3,787826,66.8,751426,63.7,36400,4.6
Nevada,1984,3,493658,72.2,456320,66.7,37338,7.6
New Hampshire,1984,3,516994,70.6,495730,67.7,21264,4.1
New Jersey,1984,3,3799814,65.3,3552120,61.0,247694,6.5
New Mexico,1984,3,621150,61.7,573931,57.0,47219,7.6
New York,1984,3,8075279,59.3,7484054,55.0,591225,7.3
New York city,1984,3,3081560,54.0,2813052,49.3,268508,8.7
North Carolina,1984,3,3021684,66.5,2819030,62.0,202654,6.7
North Dakota,1984,3,322891,66.0,305851,62.5,17040,5.3
Ohio,1984,3,5093241,63.4,4591145,57.1,502096,9.9
Oklahoma,1984,3,1543152,63.6,1439672,59.3,103480,6.7
Oregon,1984,3,1333361,66.0,1208116,59.8,125245,9.4
Pennsylvania,1984,3,5477073,59.6,4975981,54.1,501092,9.1
Rhode Island,1984,3,485661,65.6,456539,61.7,29122,6.0
South Carolina,1984,3,1482405,62.7,1376350,58.2,106055,7.2
South Dakota,1984,3,339354,66.9,324932,64.1,14422,4.2
Tennessee,1984,3,2215609,62.8,2010072,57.0,205537,9.3
Texas,1984,3,7734209,67.5,7240584,63.2,493625,6.4
Utah,1984,3,701047,66.8,652938,62.2,48109,6.9
Vermont,1984,3,269788,68.3,255316,64.6,14472,5.4
Virginia,1984,3,2779466,67.3,2641261,63.9,138205,5.0
Washington,1984,3,2071824,64.4,1870673,58.2,201151,9.7
West Virginia,1984,3,755763,51.4,649306,44.2,106457,14.1
Wisconsin,1984,3,2401306,67.6,2222193,62.6,179113,7.5
Wyoming,1984,3,254444,70.1,238685,65.8,15759,6.2
Alabama,1984,4,1782498,60.8,1574780,53.7,207718,11.7
Alaska,1984,4,241343,72.5,217085,65.2,24258,10.1
Arizona,1984,4,1425892,63.3,1357067,60.3,68825,4.8
Arkansas,1984,4,1053441,60.9,962844,55.6,90597,8.6
California,1984,4,12521157,65.7,11535006,60.5,986151,7.9
Los Angeles County,1984,4,3855297,64.2,3553773,59.2,301524,7.8
Colorado,1984,4,1700474,72.4,1611195,68.6,89279,5.3
Connecticut,1984,4,1663842,68.0,1585588,64.8,78254,4.7
Delaware,1984,4,306115,66.4,287144,62.3,18971,6.2
District of Columbia,1984,4,317486,65.7,288733,59.8,28753,9.1
Florida,1984,4,5112295,59.4,4770849,55.5,341446,6.7
Georgia,1984,4,2754289,65.3,2588488,61.4,165801,6.0
Hawaii,1984,4,475837,66.4,449888,62.7,25949,5.5
Idaho,1984,4,461477,66.1,429141,61.5,32336,7.0
Illinois,1984,4,5605496,65.1,5086105,59.1,519391,9.3
Indiana,1984,4,2626027,64.5,2400811,58.9,225216,8.6
Iowa,1984,4,1424379,65.9,1325339,61.3,99040,7.0
Kansas,1984,4,1200828,66.9,1140874,63.6,59954,5.0
Kentucky,1984,4,1707607,62.6,1548499,56.7,159108,9.3
Louisiana,1984,4,1931291,60.7,1742217,54.8,189074,9.8
Maine,1984,4,546904,63.4,512613,59.4,34291,6.3
Maryland,1984,4,2237908,68.3,2117643,64.6,120265,5.4
Massachusetts,1984,4,3038607,67.5,2886057,64.1,152550,5.0
Michigan,1984,4,4303650,63.9,3811332,56.6,492318,11.4
Minnesota,1984,4,2217364,71.5,2074502,66.9,142862,6.4
Mississippi,1984,4,1077780,58.7,964595,52.5,113185,10.5
Missouri,1984,4,2371272,63.2,2188590,58.3,182682,7.7
Montana,1984,4,402010,66.9,372001,61.9,30009,7.5
Nebraska,1984,4,788719,66.9,753122,63.9,35597,4.5
Nevada,1984,4,495665,72.3,458380,66.8,37285,7.5
New Hampshire,1984,4,519316,70.8,498238,67.9,21078,4.1
New Jersey,1984,4,3811103,65.4,3567234,61.2,243869,6.4
New Mexico,1984,4,622714,61.8,576398,57.2,46316,7.4
New York,1984,4,8087066,59.4,7501278,55.1,585788,7.2
New York city,1984,4,3086736,54.0,2816901,49.3,269835,8.7
North Carolina,1984,4,3028485,66.5,2830443,62.2,198042,6.5
North Dakota,1984,4,323436,66.1,306322,62.6,17114,5.3
Ohio,1984,4,5099174,63.5,4604840,57.3,494334,9.7
Oklahoma,1984,4,1544893,63.7,1441946,59.4,102947,6.7
Oregon,1984,4,1335145,66.1,1210619,59.9,124526,9.3
Pennsylvania,1984,4,5482652,59.6,4985796,54.2,496856,9.1
Rhode Island,1984,4,487119,65.8,458988,62.0,28131,5.8
South Carolina,1984,4,1484930,62.7,1381609,58.3,103321,7.0
South Dakota,1984,4,340100,67.1,325649,64.2,14451,4.2
Tennessee,1984,4,2218702,62.8,2016696,57.1,202006,9.1
Texas,1984,4,7745403,67.5,7264933,63.3,480470,6.2
Utah,1984,4,703065,67.0,656030,62.5,47035,6.7
Vermont,1984,4,270190,68.4,256254,64.9,13936,5.2
Virginia,1984,4,2790124,67.4,2651015,64.0,139109,5.0
Washington,1984,4,2074046,64.4,1876094,58.3,197952,9.5
West Virginia,1984,4,756592,51.5,651284,44.3,105308,13.9
Wisconsin,1984,4,2403674,67.7,2226895,62.7,176779,7.4
Wyoming,1984,4,254350,70.1,238835,65.8,15515,6.1
Alabama,1984,5,1785534,60.8,1580120,53.8,205414,11.5
Alaska,1984,5,242552,72.4,218418,65.2,24134,10.0
Arizona,1984,5,1430901,63.4,1364918,60.4,65983,4.6
Arkansas,1984,5,1052515,60.8,962485,55.6,90030,8.6
California,1984,5,12566309,65.8,11586906,60.7,979403,7.8
Los Angeles County,1984,5,3865655,64.2,3564497,59.2,301158,7.8
Colorado,1984,5,1706336,72.6,1615378,68.7,90958,5.3
Connecticut,1984,5,1669297,68.2,1591971,65.0,77326,4.6
Delaware,1984,5,307170,66.5,288147,62.4,19023,6.2
District of Columbia,1984,5,318703,66.0,290408,60.1,28295,8.9
Florida,1984,5,5132545,59.5,4794495,55.6,338050,6.6
Georgia,1984,5,2765220,65.4,2599873,61.5,165347,6.0
Hawaii,1984,5,476039,66.3,450301,62.7,25738,5.4
Idaho,1984,5,462556,66.2,429904,61.5,32652,7.1
Illinois,1984,5,5609093,65.1,5099991,59.2,509102,9.1
Indiana,1984,5,2631885,64.6,2410796,59.2,221089,8.4
Iowa,1984,5,1424387,65.9,1325784,61.3,98603,6.9
Kansas,1984,5,1203324,67.0,1143513,63.7,59811,5.0
Kentucky,1984,5,1708139,62.6,1550500,56.8,157639,9.2
Louisiana,1984,5,1936392,60.8,1745906,54.9,190486,9.8
Maine,1984,5,548374,63.5,514576,59.6,33798,6.2
Maryland,1984,5,2245085,68.4,2124137,64.7,120948,5.4
Massachusetts,1984,5,3044962,67.5,2896629,64.3,148333,4.9
Michigan,1984,5,4315430,64.1,3826763,56.8,488667,11.3
Minnesota,1984,5,2219933,71.5,2078887,67.0,141046,6.4
Mississippi,1984,5,1081171,58.9,967543,52.7,113628,10.5
Missouri,1984,5,2372042,63.2,2195419,58.5,176623,7.4
Montana,1984,5,403348,67.1,373055,62.1,30293,7.5
Nebraska,1984,5,789713,66.9,754691,64.0,35022,4.4
Nevada,1984,5,497792,72.4,460222,66.9,37570,7.5
New Hampshire,1984,5,521476,70.9,500346,68.1,21130,4.1
New Jersey,1984,5,3818030,65.5,3577061,61.3,240969,6.3
New Mexico,1984,5,624464,61.8,578420,57.3,46044,7.4
New York,1984,5,8099223,59.5,7514190,55.2,585033,7.2
New York city,1984,5,3092752,54.1,2819217,49.3,273535,8.8
North Carolina,1984,5,3032733,66.5,2837533,62.2,195200,6.4
North Dakota,1984,5,323913,66.1,306701,62.6,17212,5.3
Ohio,1984,5,5106407,63.5,4618896,57.5,487511,9.5
Oklahoma,1984,5,1546798,63.8,1443645,59.5,103153,6.7
Oregon,1984,5,1336504,66.1,1212449,59.9,124055,9.3
Pennsylvania,1984,5,5487678,59.7,4993710,54.3,493968,9.0
Rhode Island,1984,5,488101,65.9,461145,62.2,26956,5.5
South Carolina,1984,5,1487824,62.7,1386147,58.4,101677,6.8
South Dakota,1984,5,340738,67.2,326154,64.3,14584,4.3
Tennessee,1984,5,2222180,62.9,2022720,57.2,199460,9.0
Texas,1984,5,7889976,68.6,7419143,64.5,470833,6.0
Utah,1984,5,705021,67.2,658854,62.8,46167,6.5
Vermont,1984,5,270421,68.5,256999,65.1,13422,5.0
Virginia,1984,5,2800030,67.5,2659769,64.2,140261,5.0
Washington,1984,5,2076724,64.4,1881488,58.4,195236,9.4
West Virginia,1984,5,757571,51.6,652873,44.4,104698,13.8
Wisconsin,1984,5,2405961,67.7,2230323,62.8,175638,7.3
Wyoming,1984,5,254417,70.3,239021,66.0,15396,6.1
Alabama,1984,6,1787806,60.9,1584542,53.9,203264,11.4
Alaska,1984,6,243529,72.5,219481,65.3,24048,9.9
Arizona,1984,6,1435993,63.4,1371865,60.6,64128,4.5
Arkansas,1984,6,1050830,60.6,961336,55.4,89494,8.5
California,1984,6,12607944,65.9,11632800,60.8,975144,7.7
Los Angeles County,1984,6,3877257,64.3,3575693,59.3,301564,7.8
Colorado,1984,6,1710664,72.7,1617513,68.7,93151,5.4
Connecticut,1984,6,1673382,68.3,1596635,65.2,76747,4.6
Delaware,1984,6,308082,66.7,288924,62.5,19158,6.2
District of Columbia,1984,6,319900,66.2,291864,60.4,28036,8.8
Florida,1984,6,5150951,59.6,4814777,55.7,336174,6.5
Georgia,1984,6,2774796,65.6,2608972,61.6,165824,6.0
Hawaii,1984,6,475657,66.2,450107,62.6,25550,5.4
Idaho,1984,6,463569,66.2,430477,61.5,33092,7.1
Illinois,1984,6,5610589,65.1,5109336,59.3,501253,8.9
Indiana,1984,6,2634502,64.6,2416533,59.3,217969,8.3
Iowa,1984,6,1423774,65.9,1325456,61.3,98318,6.9
Kansas,1984,6,1205260,67.1,1145489,63.7,59771,5.0
Kentucky,1984,6,1707620,62.6,1551784,56.8,155836,9.1
Louisiana,1984,6,1940758,60.9,1747861,54.9,192897,9.9
Maine,1984,6,549430,63.5,515954,59.6,33476,6.1
Maryland,1984,6,2251172,68.5,2129572,64.8,121600,5.4
Massachusetts,1984,6,3049478,67.6,2904736,64.4,144742,4.7
Michigan,1984,6,4323633,64.2,3838531,57.0,485102,11.2
Minnesota,1984,6,2220288,71.5,2081041,67.0,139247,6.3
Mississippi,1984,6,1084501,59.0,969916,52.8,114585,10.6
Missouri,1984,6,2372740,63.2,2201322,58.6,171418,7.2
Montana,1984,6,404369,67.2,373781,62.1,30588,7.6
Nebraska,1984,6,790790,67.0,756019,64.1,34771,4.4
Nevada,1984,6,499822,72.5,461807,67.0,38015,7.6
New Hampshire,1984,6,523230,71.0,501870,68.1,21360,4.1
New Jersey,1984,6,3820525,65.5,3581590,61.4,238935,6.3
New Mexico,1984,6,626328,62.0,579988,57.4,46340,7.4
New York,1984,6,8108605,59.5,7521459,55.2,587146,7.2
New York city,1984,6,3098349,54.2,2819898,49.3,278451,9.0
North Carolina,1984,6,3037603,66.5,2840710,62.2,196893,6.5
North Dakota,1984,6,324277,66.2,306953,62.6,17324,5.3
Ohio,1984,6,5113004,63.6,4631563,57.6,481441,9.4
Oklahoma,1984,6,1548304,63.8,1444447,59.6,103857,6.7
Oregon,1984,6,1337091,66.1,1213410,60.0,123681,9.3
Pennsylvania,1984,6,5491534,59.7,4999536,54.4,491998,9.0
Rhode Island,1984,6,488619,65.9,462927,62.5,25692,5.3
South Carolina,1984,6,1491158,62.8,1389859,58.5,101299,6.8
South Dakota,1984,6,341203,67.2,326411,64.3,14792,4.3
Tennessee,1984,6,2226092,62.9,2028653,57.3,197439,8.9
Texas,1984,6,7936311,68.9,7471187,64.9,465124,5.9
Utah,1984,6,706843,67.4,661328,63.1,45515,6.4
Vermont,1984,6,270532,68.3,257556,65.0,12976,4.8
Virginia,1984,6,2808927,67.7,2667605,64.2,141322,5.0
Washington,1984,6,2079097,64.4,1886165,58.5,192932,9.3
West Virginia,1984,6,758475,51.7,653876,44.5,104599,13.8
Wisconsin,1984,6,2406996,67.7,2231990,62.8,175006,7.3
Wyoming,1984,6,254653,70.3,239169,66.1,15484,6.1
Alabama,1984,7,1788839,60.8,1587926,54.0,200913,11.2
Alaska,1984,7,244329,72.5,220338,65.4,23991,9.8
Arizona,1984,7,1441250,63.5,1377529,60.7,63721,4.4
Arkansas,1984,7,1048542,60.4,959605,55.3,88937,8.5
California,1984,7,12643147,65.9,11671911,60.9,971236,7.7
Los Angeles County,1984,7,3889484,64.4,3587491,59.4,301993,7.8
Colorado,1984,7,1712944,72.7,1617674,68.6,95270,5.6
Connecticut,1984,7,1675765,68.3,1599364,65.2,76401,4.6
Delaware,1984,7,308805,66.7,289559,62.5,19246,6.2
District of Columbia,1984,7,321033,66.5,293152,60.7,27881,8.7
Florida,1984,7,5166657,59.6,4831767,55.8,334890,6.5
Georgia,1984,7,2782338,65.6,2615618,61.7,166720,6.0
Hawaii,1984,7,474644,65.9,449247,62.4,25397,5.4
Idaho,1984,7,464291,66.2,430811,61.5,33480,7.2
Illinois,1984,7,5610464,65.1,5114218,59.3,496246,8.8
Indiana,1984,7,2634538,64.6,2418580,59.3,215958,8.2
Iowa,1984,7,1422405,65.8,1324210,61.2,98195,6.9
Kansas,1984,7,1206336,67.1,1146707,63.8,59629,4.9
Kentucky,1984,7,1705895,62.5,1552309,56.8,153586,9.0
Louisiana,1984,7,1943521,61.0,1747615,54.9,195906,10.1
Maine,1984,7,549953,63.5,516803,59.7,33150,6.0
Maryland,1984,7,2255306,68.6,2133711,64.9,121595,5.4
Massachusetts,1984,7,3051800,67.6,2910222,64.5,141578,4.6
Michigan,1984,7,4326932,64.2,3845466,57.0,481466,11.1
Minnesota,1984,7,2219207,71.4,2081877,67.0,137330,6.2
Mississippi,1984,7,1087548,59.1,971841,52.8,115707,10.6
Missouri,1984,7,2373379,63.1,2206025,58.7,167354,7.1
Montana,1984,7,404881,67.3,374207,62.2,30674,7.6
Nebraska,1984,7,791660,67.0,756978,64.1,34682,4.4
Nevada,1984,7,501602,72.6,463165,67.0,38437,7.7
New Hampshire,1984,7,524468,71.1,502802,68.1,21666,4.1
New Jersey,1984,7,3818563,65.4,3581502,61.3,237061,6.2
New Mexico,1984,7,628220,62.0,581175,57.4,47045,7.5
New York,1984,7,8112320,59.5,7523709,55.2,588611,7.3
New York city,1984,7,3101427,54.2,2818986,49.2,282441,9.1
North Carolina,1984,7,3031984,66.3,2840848,62.1,191136,6.3
North Dakota,1984,7,324447,66.2,307034,62.7,17413,5.4
Ohio,1984,7,5117460,63.7,4641583,57.8,475877,9.3
Oklahoma,1984,7,1548762,63.9,1444249,59.6,104513,6.7
Oregon,1984,7,1336956,66.0,1213559,59.9,123397,9.2
Pennsylvania,1984,7,5494500,59.7,5004359,54.4,490141,8.9
Rhode Island,1984,7,488794,65.9,464346,62.6,24448,5.0
South Carolina,1984,7,1494688,62.9,1392924,58.6,101764,6.8
South Dakota,1984,7,341426,67.2,326430,64.3,14996,4.4
Tennessee,1984,7,2229953,63.0,2034822,57.5,195131,8.8
Texas,1984,7,7950160,68.9,7487337,64.9,462823,5.8
Utah,1984,7,708548,67.6,663477,63.3,45071,6.4
Vermont,1984,7,270588,68.3,257963,65.1,12625,4.7
Virginia,1984,7,2816763,67.7,2674518,64.3,142245,5.0
Washington,1984,7,2080267,64.4,1889519,58.5,190748,9.2
West Virginia,1984,7,759063,51.7,654120,44.6,104943,13.8
Wisconsin,1984,7,2405654,67.7,2231787,62.8,173867,7.2
Wyoming,1984,7,254974,70.4,239224,66.1,15750,6.2
Alabama,1984,8,1789158,60.8,1590801,54.1,198357,11.1
Alaska,1984,8,245045,72.5,221105,65.4,23940,9.8
Arizona,1984,8,1446448,63.5,1381314,60.6,65134,4.5
Arkansas,1984,8,1046129,60.3,957763,55.2,88366,8.4
California,1984,8,12674302,65.9,11706943,60.9,967359,7.6
Los Angeles County,1984,8,3903100,64.6,3600903,59.6,302197,7.7
Colorado,1984,8,1713130,72.6,1616506,68.5,96624,5.6
Connecticut,1984,8,1676966,68.3,1600724,65.2,76242,4.5
Delaware,1984,8,309428,66.7,290206,62.5,19222,6.2
District of Columbia,1984,8,322171,66.7,294417,61.0,27754,8.6
Florida,1984,8,5181075,59.6,4847184,55.8,333891,6.4
Georgia,1984,8,2788512,65.6,2620713,61.6,167799,6.0
Hawaii,1984,8,473402,65.7,448007,62.1,25395,5.4
Idaho,1984,8,464661,66.3,430884,61.5,33777,7.3
Illinois,1984,8,5611409,65.1,5116431,59.4,494978,8.8
Indiana,1984,8,2634066,64.6,2419024,59.3,215042,8.2
Iowa,1984,8,1420651,65.7,1322206,61.2,98445,6.9
Kansas,1984,8,1206892,67.2,1147513,63.9,59379,4.9
Kentucky,1984,8,1703332,62.3,1552159,56.8,151173,8.9
Louisiana,1984,8,1944847,61.0,1745473,54.8,199374,10.3
Maine,1984,8,550139,63.5,517432,59.7,32707,5.9
Maryland,1984,8,2257714,68.6,2136976,64.9,120738,5.3
Massachusetts,1984,8,3052255,67.6,2913529,64.5,138726,4.5
Michigan,1984,8,4326996,64.1,3848652,57.1,478344,11.1
Minnesota,1984,8,2217991,71.4,2082334,67.0,135657,6.1
Mississippi,1984,8,1090322,59.2,973725,52.9,116597,10.7
Missouri,1984,8,2374644,63.2,2209987,58.8,164657,6.9
Montana,1984,8,404986,67.3,374430,62.2,30556,7.5
Nebraska,1984,8,792212,67.1,757591,64.2,34621,4.4
Nevada,1984,8,503169,72.5,464391,66.9,38778,7.7
New Hampshire,1984,8,525317,71.0,503337,68.0,21980,4.2
New Jersey,1984,8,3813476,65.3,3578733,61.3,234743,6.2
New Mexico,1984,8,630152,62.1,582112,57.4,48040,7.6
New York,1984,8,8113461,59.5,7525735,55.2,587726,7.2
New York city,1984,8,3102218,54.2,2818123,49.2,284095,9.2
North Carolina,1984,8,3034851,66.2,2839746,62.0,195105,6.4
North Dakota,1984,8,324488,66.2,307009,62.7,17479,5.4
Ohio,1984,8,5120046,63.7,4648643,57.8,471403,9.2
Oklahoma,1984,8,1548313,63.9,1443483,59.6,104830,6.8
Oregon,1984,8,1336147,66.0,1213130,59.9,123017,9.2
Pennsylvania,1984,8,5496955,59.8,5009674,54.5,487281,8.9
Rhode Island,1984,8,488990,65.8,465560,62.7,23430,4.8
South Carolina,1984,8,1498573,62.9,1396062,58.6,102511,6.8
South Dakota,1984,8,341477,67.2,326337,64.2,15140,4.4
Tennessee,1984,8,2233357,63.0,2041160,57.6,192197,8.6
Texas,1984,8,7953957,68.8,7489843,64.8,464114,5.8
Utah,1984,8,710363,67.7,665444,63.4,44919,6.3
Vermont,1984,8,270727,68.2,258348,65.1,12379,4.6
Virginia,1984,8,2824186,67.8,2680981,64.4,143205,5.1
Washington,1984,8,2080289,64.4,1891690,58.5,188599,9.1
West Virginia,1984,8,759456,51.7,653723,44.5,105733,13.9
Wisconsin,1984,8,2402144,67.5,2230256,62.7,171888,7.2
Wyoming,1984,8,255257,70.5,239169,66.1,16088,6.3
Alabama,1984,9,1789576,60.8,1594044,54.1,195532,10.9
Alaska,1984,9,245698,72.7,221821,65.6,23877,9.7
Arizona,1984,9,1451558,63.5,1383219,60.5,68339,4.7
Arkansas,1984,9,1044008,60.1,956059,55.0,87949,8.4
California,1984,9,12705370,66.0,11741730,61.0,963640,7.6
Los Angeles County,1984,9,3918465,64.8,3616501,59.8,301964,7.7
Colorado,1984,9,1712043,72.5,1614750,68.4,97293,5.7
Connecticut,1984,9,1677825,68.3,1601582,65.2,76243,4.5
Delaware,1984,9,310032,66.7,290933,62.6,19099,6.2
District of Columbia,1984,9,323261,66.9,295657,61.2,27604,8.5
Florida,1984,9,5196282,59.7,4863195,55.8,333087,6.4
Georgia,1984,9,2794692,65.6,2625595,61.6,169097,6.1
Hawaii,1984,9,472535,65.4,446962,61.9,25573,5.4
Idaho,1984,9,464737,66.3,430762,61.4,33975,7.3
Illinois,1984,9,5615184,65.1,5117981,59.4,497203,8.9
Indiana,1984,9,2634935,64.6,2419660,59.3,215275,8.2
Iowa,1984,9,1418842,65.7,1319601,61.1,99241,7.0
Kansas,1984,9,1207690,67.2,1148446,63.9,59244,4.9
Kentucky,1984,9,1700706,62.2,1551565,56.8,149141,8.8
Louisiana,1984,9,1945580,61.0,1742295,54.7,203285,10.4
Maine,1984,9,550333,63.4,518120,59.7,32213,5.9
Maryland,1984,9,2259361,68.5,2139914,64.9,119447,5.3
Massachusetts,1984,9,3051568,67.5,2915444,64.5,136124,4.5
Michigan,1984,9,4326772,64.1,3850944,57.0,475828,11.0
Minnesota,1984,9,2217458,71.3,2082957,67.0,134501,6.1
Mississippi,1984,9,1092956,59.3,976019,52.9,116937,10.7
Missouri,1984,9,2377380,63.2,2214083,58.9,163297,6.9
Montana,1984,9,404861,67.3,374516,62.2,30345,7.5
Nebraska,1984,9,792609,67.2,757995,64.3,34614,4.4
Nevada,1984,9,504590,72.4,465616,66.8,38974,7.7
New Hampshire,1984,9,525939,71.0,503668,68.0,22271,4.2
New Jersey,1984,9,3807599,65.2,3575831,61.2,231768,6.1
New Mexico,1984,9,632117,62.3,582955,57.4,49162,7.8
New York,1984,9,8115887,59.5,7532033,55.2,583854,7.2
New York city,1984,9,3102274,54.2,2819185,49.2,283089,9.1
North Carolina,1984,9,3037156,66.2,2839379,61.8,197777,6.5
North Dakota,1984,9,324535,66.4,307020,62.8,17515,5.4
Ohio,1984,9,5120598,63.7,4652232,57.8,468366,9.1
Oklahoma,1984,9,1547606,63.9,1442440,59.6,105166,6.8
Oregon,1984,9,1334494,65.9,1211848,59.8,122646,9.2
Pennsylvania,1984,9,5499183,59.8,5015810,54.5,483373,8.8
Rhode Island,1984,9,489536,65.9,466683,62.8,22853,4.7
South Carolina,1984,9,1503101,63.0,1400034,58.7,103067,6.9
South Dakota,1984,9,341527,67.2,326289,64.2,15238,4.5
Tennessee,1984,9,2235746,63.0,2046663,57.6,189083,8.5
Texas,1984,9,7957503,68.7,7487566,64.7,469937,5.9
Utah,1984,9,712480,67.8,667432,63.5,45048,6.3
Vermont,1984,9,271112,68.3,258860,65.2,12252,4.5
Virginia,1984,9,2831352,67.9,2687073,64.5,144279,5.1
Washington,1984,9,2079910,64.3,1893141,58.5,186769,9.0
West Virginia,1984,9,759861,51.8,652952,44.5,106909,14.1
Wisconsin,1984,9,2397902,67.4,2228313,62.6,169589,7.1
Wyoming,1984,9,255409,70.8,238991,66.2,16418,6.4
Alabama,1984,10,1790785,60.7,1598410,54.2,192375,10.7
Alaska,1984,10,246294,72.7,222492,65.6,23802,9.7
Arizona,1984,10,1456802,63.5,1384104,60.4,72698,5.0
Arkansas,1984,10,1042527,60.0,954787,54.9,87740,8.4
California,1984,10,12739684,66.0,11780495,61.0,959189,7.5
Los Angeles County,1984,10,3935027,65.0,3634198,60.0,300829,7.6
Colorado,1984,10,1710854,72.3,1612994,68.2,97860,5.7
Connecticut,1984,10,1679425,68.4,1603089,65.2,76336,4.5
Delaware,1984,10,310664,66.8,291764,62.7,18900,6.1
District of Columbia,1984,10,324224,67.1,296816,61.5,27408,8.5
Florida,1984,10,5213774,59.7,4881518,55.9,332256,6.4
Georgia,1984,10,2802372,65.6,2631814,61.6,170558,6.1
Hawaii,1984,10,472388,65.3,446640,61.8,25748,5.5
Idaho,1984,10,464670,66.3,430622,61.4,34048,7.3
Illinois,1984,10,5621985,65.2,5121727,59.4,500258,8.9
Indiana,1984,10,2639045,64.7,2422647,59.3,216398,8.2
Iowa,1984,10,1417231,65.6,1316805,61.0,100426,7.1
Kansas,1984,10,1209642,67.4,1150173,64.0,59469,4.9
Kentucky,1984,10,1699025,62.1,1551225,56.7,147800,8.7
Louisiana,1984,10,1946865,61.0,1739405,54.5,207460,10.7
Maine,1984,10,550844,63.5,519072,59.8,31772,5.8
Maryland,1984,10,2261183,68.5,2143239,64.9,117944,5.2
Massachusetts,1984,10,3051010,67.5,2917298,64.5,133712,4.4
Michigan,1984,10,4328341,64.1,3855447,57.1,472894,10.9
Minnesota,1984,10,2218284,71.3,2084555,67.0,133729,6.0
Mississippi,1984,10,1095752,59.3,979091,53.0,116661,10.6
Missouri,1984,10,2382309,63.3,2219335,59.0,162974,6.8
Montana,1984,10,404612,67.2,374497,62.2,30115,7.4
Nebraska,1984,10,793176,67.3,758443,64.4,34733,4.4
Nevada,1984,10,505953,72.4,466983,66.8,38970,7.7
New Hampshire,1984,10,526555,70.9,504058,67.8,22497,4.3
New Jersey,1984,10,3803619,65.1,3575406,61.2,228213,6.0
New Mexico,1984,10,634134,62.4,583932,57.5,50202,7.9
New York,1984,10,8121672,59.5,7544702,55.3,576970,7.1
New York city,1984,10,3103086,54.2,2823110,49.3,279976,9.0
North Carolina,1984,10,3040928,66.1,2841798,61.8,199130,6.5
North Dakota,1984,10,324731,66.4,307207,62.8,17524,5.4
Ohio,1984,10,5119599,63.6,4653536,57.8,466063,9.1
Oklahoma,1984,10,1547724,64.0,1441744,59.6,105980,6.8
Oregon,1984,10,1332324,65.8,1209767,59.7,122557,9.2
Pennsylvania,1984,10,5502275,59.8,5023786,54.6,478489,8.7
Rhode Island,1984,10,490598,65.9,467797,62.9,22801,4.6
South Carolina,1984,10,1508441,63.1,1405510,58.8,102931,6.8
South Dakota,1984,10,341761,67.4,326442,64.4,15319,4.5
Tennessee,1984,10,2236765,62.9,2050603,57.7,186162,8.3
Texas,1984,10,7965952,68.7,7485937,64.6,480015,6.0
Utah,1984,10,714937,68.0,669653,63.7,45284,6.3
Vermont,1984,10,271800,68.3,259571,65.2,12229,4.5
Virginia,1984,10,2838249,68.0,2692620,64.5,145629,5.1
Washington,1984,10,2079879,64.3,1894415,58.5,185464,8.9
West Virginia,1984,10,760304,51.8,652203,44.5,108101,14.2
Wisconsin,1984,10,2394766,67.3,2226959,62.6,167807,7.0
Wyoming,1984,10,255389,70.7,238728,66.1,16661,6.5
Alabama,1984,11,1793233,60.8,1604282,54.4,188951,10.5
Alaska,1984,11,246909,72.8,223161,65.8,23748,9.6
Arizona,1984,11,1462302,63.6,1385092,60.2,77210,5.3
Arkansas,1984,11,1042109,59.9,954493,54.9,87616,8.4
California,1984,11,12779441,66.1,11825891,61.1,953550,7.5
Los Angeles County,1984,11,3952013,65.2,3653330,60.3,298683,7.6
Colorado,1984,11,1710713,72.3,1612230,68.1,98483,5.8
Connecticut,1984,11,1682466,68.4,1606074,65.3,76392,4.5
Delaware,1984,11,311359,66.8,292683,62.8,18676,6.0
District of Columbia,1984,11,324958,67.3,297762,61.6,27196,8.4
Florida,1984,11,5234392,59.8,4902847,56.0,331545,6.3
Georgia,1984,11,2812538,65.7,2640307,61.6,172231,6.1
Hawaii,1984,11,473003,65.3,447275,61.8,25728,5.4
Idaho,1984,11,464769,66.4,430669,61.5,34100,7.3
Illinois,1984,11,5631952,65.3,5130409,59.5,501543,8.9
Indiana,1984,11,2647577,64.8,2430158,59.5,217419,8.2
Iowa,1984,11,1416501,65.7,1314726,61.0,101775,7.2
Kansas,1984,11,1213186,67.6,1153182,64.2,60004,4.9
Kentucky,1984,11,1698867,62.1,1551898,56.7,146969,8.7
Louisiana,1984,11,1949608,61.1,1738176,54.5,211432,10.8
Maine,1984,11,551828,63.5,520326,59.9,31502,5.7
Maryland,1984,11,2263833,68.5,2147550,64.9,116283,5.1
Massachusetts,1984,11,3051641,67.5,2920274,64.6,131367,4.3
Michigan,1984,11,4332999,64.1,3864101,57.2,468898,10.8
Minnesota,1984,11,2220555,71.4,2087310,67.1,133245,6.0
Mississippi,1984,11,1099243,59.5,983213,53.2,116030,10.6
Missouri,1984,11,2389699,63.5,2226543,59.2,163156,6.8
Montana,1984,11,404434,67.1,374463,62.1,29971,7.4
Nebraska,1984,11,794292,67.5,759253,64.5,35039,4.4
Nevada,1984,11,507454,72.3,468587,66.8,38867,7.7
New Hampshire,1984,11,527428,70.8,504794,67.8,22634,4.3
New Jersey,1984,11,3803458,65.0,3578904,61.2,224554,5.9
New Mexico,1984,11,636285,62.6,585254,57.5,51031,8.0
New York,1984,11,8132791,59.6,7564121,55.4,568670,7.0
New York city,1984,11,3106774,54.2,2830500,49.4,276274,8.9
North Carolina,1984,11,3047168,66.1,2848523,61.8,198645,6.5
North Dakota,1984,11,325206,66.5,307657,62.9,17549,5.4
Ohio,1984,11,5119000,63.6,4655368,57.8,463632,9.1
Oklahoma,1984,11,1549264,64.1,1442083,59.7,107181,6.9
Oregon,1984,11,1330236,65.7,1207575,59.6,122661,9.2
Pennsylvania,1984,11,5507378,59.9,5034974,54.7,472404,8.6
Rhode Island,1984,11,492158,66.2,468964,63.0,23194,4.7
South Carolina,1984,11,1514626,63.2,1412857,59.0,101769,6.7
South Dakota,1984,11,342314,67.5,326895,64.5,15419,4.5
Tennessee,1984,11,2237478,62.8,2053922,57.7,183556,8.2
Texas,1984,11,7981200,68.7,7489162,64.5,492038,6.2
Utah,1984,11,717711,68.2,672253,63.8,45458,6.3
Vermont,1984,11,272748,68.5,260472,65.4,12276,4.5
Virginia,1984,11,2845147,68.1,2697781,64.6,147366,5.2
Washington,1984,11,2080922,64.3,1896584,58.6,184338,8.9
West Virginia,1984,11,760791,51.9,651900,44.5,108891,14.3
Wisconsin,1984,11,2393922,67.2,2226669,62.5,167253,7.0
Wyoming,1984,11,255214,70.9,238478,66.2,16736,6.6
Alabama,1984,12,1796526,60.8,1611019,54.6,185507,10.3
Alaska,1984,12,247567,72.8,223844,65.8,23723,9.6
Arizona,1984,12,1467740,63.6,1386603,60.1,81137,5.5
Arkansas,1984,12,1042814,59.9,955345,54.9,87469,8.4
California,1984,12,12822733,66.1,11875139,61.3,947594,7.4
Los Angeles County,1984,12,3967619,65.4,3671517,60.5,296102,7.5
Colorado,1984,12,1712073,72.2,1613165,68.1,98908,5.8
Connecticut,1984,12,1686741,68.6,1610344,65.5,76397,4.5
Delaware,1984,12,312045,66.8,293571,62.9,18474,5.9
District of Columbia,1984,12,325369,67.4,298347,61.8,27022,8.3
Florida,1984,12,5257208,59.9,4926159,56.2,331049,6.3
Georgia,1984,12,2824745,65.8,2650275,61.7,174470,6.2
Hawaii,1984,12,474145,65.4,448704,61.9,25441,5.4
Idaho,1984,12,465253,66.5,430984,61.6,34269,7.4
Illinois,1984,12,5644198,65.4,5143234,59.6,500964,8.9
Indiana,1984,12,2659861,65.1,2442232,59.8,217629,8.2
Iowa,1984,12,1417073,65.7,1314040,60.9,103033,7.3
Kansas,1984,12,1217905,67.8,1157243,64.5,60662,5.0
Kentucky,1984,12,1699891,62.1,1553436,56.8,146455,8.6
Louisiana,1984,12,1953769,61.2,1739070,54.5,214699,11.0
Maine,1984,12,553209,63.6,521740,60.0,31469,5.7
Maryland,1984,12,2267048,68.5,2152520,65.0,114528,5.1
Massachusetts,1984,12,3053651,67.5,2924427,64.7,129224,4.2
Michigan,1984,12,4340118,64.2,3876355,57.3,463763,10.7
Minnesota,1984,12,2223444,71.4,2090529,67.2,132915,6.0
Mississippi,1984,12,1103531,59.6,988118,53.4,115413,10.5
Missouri,1984,12,2399050,63.7,2235443,59.4,163607,6.8
Montana,1984,12,404518,67.1,374486,62.1,30032,7.4
Nebraska,1984,12,796082,67.7,760519,64.7,35563,4.5
Nevada,1984,12,509192,72.2,470370,66.7,38822,7.6
New Hampshire,1984,12,528692,70.9,506051,67.8,22641,4.3
New Jersey,1984,12,3806678,65.1,3585313,61.3,221365,5.8
New Mexico,1984,12,638645,62.7,586902,57.7,51743,8.1
New York,1984,12,8148926,59.7,7587372,55.6,561554,6.9
New York city,1984,12,3113784,54.3,2840150,49.5,273634,8.8
North Carolina,1984,12,3055988,66.2,2859611,61.9,196377,6.4
North Dakota,1984,12,325951,66.8,308351,63.2,17600,5.4
Ohio,1984,12,5120146,63.6,4659463,57.9,460683,9.0
Oklahoma,1984,12,1552039,64.3,1443554,59.8,108485,7.0
Oregon,1984,12,1328586,65.6,1206050,59.6,122536,9.2
Pennsylvania,1984,12,5514223,60.0,5048566,54.9,465657,8.4
Rhode Island,1984,12,493994,66.3,470177,63.1,23817,4.8
South Carolina,1984,12,1521254,63.4,1421472,59.2,99782,6.6
South Dakota,1984,12,343143,67.7,327592,64.6,15551,4.5
Tennessee,1984,12,2239056,62.8,2057481,57.7,181575,8.1
Texas,1984,12,8001786,68.8,7497758,64.5,504028,6.3
Utah,1984,12,720666,68.4,675165,64.1,45501,6.3
Vermont,1984,12,273841,68.6,261481,65.5,12360,4.5
Virginia,1984,12,2851716,68.2,2702387,64.6,149329,5.2
Washington,1984,12,2083439,64.3,1900407,58.7,183032,8.8
West Virginia,1984,12,761110,51.9,652171,44.5,108939,14.3
Wisconsin,1984,12,2395210,67.2,2227318,62.5,167892,7.0
Wyoming,1984,12,254988,70.8,238329,66.2,16659,6.5
Alabama,1985,1,1799624,60.9,1617064,54.7,182560,10.1
Alaska,1985,1,248179,73.0,224421,66.0,23758,9.6
Arizona,1985,1,1472220,63.6,1387874,60.0,84346,5.7
Arkansas,1985,1,1044414,60.0,957043,55.0,87371,8.4
California,1985,1,12863443,66.2,11919980,61.4,943463,7.3
Los Angeles County,1985,1,3979385,65.5,3685424,60.7,293961,7.4
Colorado,1985,1,1714353,72.3,1615225,68.1,99128,5.8
Connecticut,1985,1,1691149,68.7,1614645,65.6,76504,4.5
Delaware,1985,1,312634,66.8,294347,62.9,18287,5.8
District of Columbia,1985,1,325402,67.4,298459,61.8,26943,8.3
Florida,1985,1,5279170,60.0,4948179,56.3,330991,6.3
Georgia,1985,1,2837182,65.9,2659469,61.8,177713,6.3
Hawaii,1985,1,475466,65.6,450463,62.1,25003,5.3
Idaho,1985,1,465931,66.6,431325,61.6,34606,7.4
Illinois,1985,1,5655540,65.6,5155209,59.8,500331,8.8
Indiana,1985,1,2673647,65.5,2456308,60.1,217339,8.1
Iowa,1985,1,1418613,65.8,1314518,61.0,104095,7.3
Kansas,1985,1,1222773,68.2,1161386,64.7,61387,5.0
Kentucky,1985,1,1701031,62.1,1554602,56.8,146429,8.6
Louisiana,1985,1,1958439,61.4,1741240,54.6,217199,11.1
Maine,1985,1,554635,63.7,522977,60.0,31658,5.7
Maryland,1985,1,2269896,68.5,2156981,65.1,112915,5.0
Massachusetts,1985,1,3056322,67.6,2928595,64.7,127727,4.2
Michigan,1985,1,4347581,64.2,3889268,57.5,458313,10.5
Minnesota,1985,1,2225704,71.5,2093135,67.2,132569,6.0
Mississippi,1985,1,1107918,59.8,992827,53.6,115091,10.4
Missouri,1985,1,2409014,64.0,2244536,59.6,164478,6.8
Montana,1985,1,404799,67.1,374492,62.1,30307,7.5
Nebraska,1985,1,798288,67.9,761811,64.8,36477,4.6
Nevada,1985,1,511049,72.2,472101,66.7,38948,7.6
New Hampshire,1985,1,530239,70.9,507727,67.9,22512,4.2
New Jersey,1985,1,3811442,65.1,3592034,61.4,219408,5.8
New Mexico,1985,1,641150,62.9,588591,57.8,52559,8.2
New York,1985,1,8166112,59.8,7608114,55.7,557998,6.8
New York city,1985,1,3121969,54.4,2849109,49.7,272860,8.7
North Carolina,1985,1,3066433,66.3,2873305,62.1,193128,6.3
North Dakota,1985,1,326800,67.0,309124,63.3,17676,5.4
Ohio,1985,1,5122410,63.6,4664836,57.9,457574,8.9
Oklahoma,1985,1,1554925,64.4,1445117,59.9,109808,7.1
Oregon,1985,1,1327550,65.6,1205613,59.5,121937,9.2
Pennsylvania,1985,1,5521081,60.0,5061175,55.0,459906,8.3
Rhode Island,1985,1,495654,66.5,471231,63.3,24423,4.9
South Carolina,1985,1,1527654,63.5,1429784,59.5,97870,6.4
South Dakota,1985,1,344036,67.9,328288,64.8,15748,4.6
Tennessee,1985,1,2241610,62.8,2061163,57.7,180447,8.0
Texas,1985,1,8023844,68.9,7507955,64.4,515889,6.4
Utah,1985,1,723495,68.5,678070,64.2,45425,6.3
Vermont,1985,1,274883,68.9,262418,65.8,12465,4.5
Virginia,1985,1,2857017,68.3,2705694,64.7,151323,5.3
Washington,1985,1,2087229,64.4,1905494,58.8,181735,8.7
West Virginia,1985,1,760929,51.9,652777,44.5,108152,14.2
Wisconsin,1985,1,2397329,67.3,2228055,62.5,169274,7.1
Wyoming,1985,1,254783,70.8,238254,66.2,16529,6.5
Alabama,1985,2,1801567,60.9,1621366,54.8,180201,10.0
Alaska,1985,2,248578,72.9,224662,65.9,23916,9.6
Arizona,1985,2,1475124,63.5,1387802,59.8,87322,5.9
Arkansas,1985,2,1046633,60.0,959109,55.0,87524,8.4
California,1985,2,12895830,66.2,11953332,61.4,942498,7.3
Los Angeles County,1985,2,3985852,65.6,3693192,60.8,292660,7.3
Colorado,1985,2,1716142,72.3,1616928,68.1,99214,5.8
Connecticut,1985,2,1694519,68.8,1617705,65.7,76814,4.5
Delaware,1985,2,313164,66.9,295115,63.1,18049,5.8
District of Columbia,1985,2,325043,67.2,298078,61.6,26965,8.3
Florida,1985,2,5296804,60.1,4965421,56.3,331383,6.3
Georgia,1985,2,2847888,66.0,2666132,61.8,181756,6.4
Hawaii,1985,2,476698,65.7,452070,62.3,24628,5.2
Idaho,1985,2,466541,66.6,431384,61.6,35157,7.5
Illinois,1985,2,5662345,65.6,5160860,59.8,501485,8.9
Indiana,1985,2,2685987,65.7,2468959,60.4,217028,8.1
Iowa,1985,2,1420407,65.9,1315391,61.1,105016,7.4
Kansas,1985,2,1226780,68.4,1164689,65.0,62091,5.1
Kentucky,1985,2,1701313,62.1,1554281,56.7,147032,8.6
Louisiana,1985,2,1962502,61.5,1743235,54.6,219267,11.2
Maine,1985,2,555579,63.8,523635,60.1,31944,5.7
Maryland,1985,2,2271610,68.4,2160021,65.1,111589,4.9
Massachusetts,1985,2,3058246,67.6,2931122,64.8,127124,4.2
Michigan,1985,2,4352906,64.3,3899211,57.6,453695,10.4
Minnesota,1985,2,2226706,71.5,2094330,67.3,132376,5.9
Mississippi,1985,2,1111797,59.9,996603,53.7,115194,10.4
Missouri,1985,2,2417980,64.2,2252479,59.8,165501,6.8
Montana,1985,2,405015,67.2,374366,62.1,30649,7.6
Nebraska,1985,2,800415,68.1,762712,64.9,37703,4.7
Nevada,1985,2,512792,72.1,473542,66.6,39250,7.7
New Hampshire,1985,2,531846,70.9,509548,67.9,22298,4.2
New Jersey,1985,2,3816025,65.2,3596952,61.5,219073,5.7
New Mexico,1985,2,643613,63.0,590011,57.8,53602,8.3
New York,1985,2,8179548,59.9,7621705,55.8,557843,6.8
New York city,1985,2,3128272,54.5,2855398,49.8,272874,8.7
North Carolina,1985,2,3076821,66.4,2886941,62.3,189880,6.2
North Dakota,1985,2,327601,67.1,309825,63.5,17776,5.4
Ohio,1985,2,5124229,63.6,4668617,57.9,455612,8.9
Oklahoma,1985,2,1556780,64.6,1445717,60.0,111063,7.1
Oregon,1985,2,1326871,65.6,1205829,59.6,121042,9.1
Pennsylvania,1985,2,5526457,60.1,5070184,55.1,456273,8.3
Rhode Island,1985,2,496778,66.6,471940,63.3,24838,5.0
South Carolina,1985,2,1533210,63.6,1436057,59.6,97153,6.3
South Dakota,1985,2,344810,68.1,328755,65.0,16055,4.7
Tennessee,1985,2,2244804,62.8,2064600,57.7,180204,8.0
Texas,1985,2,8043474,68.9,7515524,64.4,527950,6.6
Utah,1985,2,725933,68.7,680624,64.4,45309,6.2
Vermont,1985,2,275769,68.9,263165,65.8,12604,4.6
Virginia,1985,2,2860710,68.3,2707252,64.6,153458,5.4
Washington,1985,2,2091531,64.5,1910938,58.9,180593,8.6
West Virginia,1985,2,760119,51.9,653344,44.6,106775,14.0
Wisconsin,1985,2,2398743,67.3,2227800,62.5,170943,7.1
Wyoming,1985,2,254604,70.9,238106,66.3,16498,6.5
Alabama,1985,3,1801810,60.9,1623864,54.9,177946,9.9
Alaska,1985,3,248676,72.9,224506,65.8,24170,9.7
Arizona,1985,3,1476564,63.4,1386295,59.5,90269,6.1
Arkansas,1985,3,1049121,60.2,961148,55.1,87973,8.4
California,1985,3,12916514,66.2,11973521,61.4,942993,7.3
Los Angeles County,1985,3,3986447,65.5,3694933,60.7,291514,7.3
Colorado,1985,3,1716430,72.2,1617066,68.0,99364,5.8
Connecticut,1985,3,1696246,68.8,1619103,65.7,77143,4.5
Delaware,1985,3,313739,66.9,295997,63.1,17742,5.7
District of Columbia,1985,3,324269,67.0,297289,61.4,26980,8.3
Florida,1985,3,5308320,60.1,4976887,56.3,331433,6.2
Georgia,1985,3,2855666,66.0,2670077,61.7,185589,6.5
Hawaii,1985,3,477706,65.7,453248,62.3,24458,5.1
Idaho,1985,3,466922,66.7,431139,61.6,35783,7.7
Illinois,1985,3,5663207,65.6,5158942,59.8,504265,8.9
Indiana,1985,3,2694937,65.9,2478356,60.6,216581,8.0
Iowa,1985,3,1421503,66.0,1315927,61.1,105576,7.4
Kansas,1985,3,1229169,68.6,1166623,65.1,62546,5.1
Kentucky,1985,3,1700224,62.0,1552297,56.6,147927,8.7
Louisiana,1985,3,1965215,61.5,1744147,54.6,221068,11.2
Maine,1985,3,555683,63.7,523610,60.0,32073,5.8
Maryland,1985,3,2272030,68.4,2161715,65.0,110315,4.9
Massachusetts,1985,3,3058297,67.6,2931200,64.7,127097,4.2
Michigan,1985,3,4354609,64.3,3904646,57.6,449963,10.3
Minnesota,1985,3,2226659,71.5,2094350,67.2,132309,5.9
Mississippi,1985,3,1114805,60.0,999369,53.8,115436,10.4
Missouri,1985,3,2424606,64.3,2258689,59.9,165917,6.8
Montana,1985,3,404987,67.2,374127,62.0,30860,7.6
Nebraska,1985,3,802048,68.3,763078,65.0,38970,4.9
Nevada,1985,3,514146,72.0,474582,66.5,39564,7.7
New Hampshire,1985,3,533328,71.0,511349,68.1,21979,4.1
New Jersey,1985,3,3818959,65.2,3599725,61.5,219234,5.7
New Mexico,1985,3,645654,63.2,590947,57.8,54707,8.5
New York,1985,3,8185507,59.9,7627467,55.8,558040,6.8
New York city,1985,3,3129800,54.5,2858162,49.8,271638,8.7
North Carolina,1985,3,3085094,66.4,2898095,62.4,186999,6.1
North Dakota,1985,3,328200,67.4,310345,63.7,17855,5.4
Ohio,1985,3,5124310,63.5,4669438,57.9,454872,8.9
Oklahoma,1985,3,1556710,64.6,1445010,60.0,111700,7.2
Oregon,1985,3,1325860,65.5,1205914,59.6,119946,9.0
Pennsylvania,1985,3,5529612,60.1,5075495,55.2,454117,8.2
Rhode Island,1985,3,497295,66.7,472342,63.3,24953,5.0
South Carolina,1985,3,1537835,63.7,1439675,59.6,98160,6.4
South Dakota,1985,3,345393,68.3,328966,65.0,16427,4.8
Tennessee,1985,3,2247870,62.8,2067466,57.7,180404,8.0
Texas,1985,3,8057774,68.9,7518458,64.3,539316,6.7
Utah,1985,3,727806,68.8,682655,64.5,45151,6.2
Vermont,1985,3,276498,69.1,263730,65.9,12768,4.6
Virginia,1985,3,2862751,68.2,2707104,64.5,155647,5.4
Washington,1985,3,2095498,64.6,1916211,59.0,179287,8.6
West Virginia,1985,3,758587,51.8,653581,44.6,105006,13.8
Wisconsin,1985,3,2398533,67.2,2226280,62.4,172253,7.2
Wyoming,1985,3,254416,70.9,237781,66.2,16635,6.5
Alabama,1985,4,1800578,60.8,1625007,54.8,175571,9.8
Alaska,1985,4,248626,72.7,224191,65.6,24435,9.8
Arizona,1985,4,1477859,63.3,1384816,59.3,93043,6.3
Arkansas,1985,4,1051607,60.3,962929,55.2,88678,8.4
California,1985,4,12926628,66.1,11983223,61.3,943405,7.3
Los Angeles County,1985,4,3982633,65.4,3692741,60.6,289892,7.3
Colorado,1985,4,1715609,72.1,1615745,67.9,99864,5.8
Connecticut,1985,4,1696463,68.8,1619163,65.7,77300,4.6
Delaware,1985,4,314438,66.9,297045,63.2,17393,5.5
District of Columbia,1985,4,323312,66.8,296403,61.2,26909,8.3
Florida,1985,4,5314854,60.0,4984018,56.3,330836,6.2
Georgia,1985,4,2860937,66.0,2672560,61.6,188377,6.6
Hawaii,1985,4,478468,65.7,453932,62.4,24536,5.1
Idaho,1985,4,466997,66.7,430701,61.5,36296,7.8
Illinois,1985,4,5659258,65.6,5151135,59.7,508123,9.0
Indiana,1985,4,2700112,66.0,2484295,60.8,215817,8.0
Iowa,1985,4,1421708,66.1,1316017,61.2,105691,7.4
Kansas,1985,4,1229787,68.6,1167135,65.1,62652,5.1
Kentucky,1985,4,1698237,61.9,1549234,56.5,149003,8.8
Louisiana,1985,4,1966585,61.6,1743896,54.6,222689,11.3
Maine,1985,4,554950,63.6,523060,59.9,31890,5.7
Maryland,1985,4,2271720,68.2,2162783,65.0,108937,4.8
Massachusetts,1985,4,3056292,67.5,2929007,64.7,127285,4.2
Michigan,1985,4,4353626,64.2,3906299,57.6,447327,10.3
Minnesota,1985,4,2226403,71.5,2094015,67.2,132388,5.9
Mississippi,1985,4,1116991,60.0,1001315,53.8,115676,10.4
Missouri,1985,4,2428601,64.4,2263197,60.0,165404,6.8
Montana,1985,4,404725,67.1,373854,62.0,30871,7.6
Nebraska,1985,4,803013,68.5,762954,65.0,40059,5.0
Nevada,1985,4,515042,71.9,475330,66.4,39712,7.7
New Hampshire,1985,4,534557,71.0,513028,68.1,21529,4.0
New Jersey,1985,4,3819923,65.2,3601315,61.5,218608,5.7
New Mexico,1985,4,647005,63.2,591389,57.8,55616,8.6
New York,1985,4,8250657,60.3,7694005,56.3,556652,6.7
New York city,1985,4,3192242,55.6,2923878,50.9,268364,8.4
North Carolina,1985,4,3090421,66.4,2906179,62.5,184242,6.0
North Dakota,1985,4,328523,67.5,310635,63.8,17888,5.4
Ohio,1985,4,5123271,63.5,4667913,57.9,455358,8.9
Oklahoma,1985,4,1554891,64.6,1443519,60.0,111372,7.2
Oregon,1985,4,1324378,65.4,1205675,59.6,118703,9.0
Pennsylvania,1985,4,5531223,60.1,5078672,55.2,452551,8.2
Rhode Island,1985,4,497379,66.6,472592,63.3,24787,5.0
South Carolina,1985,4,1542083,63.7,1441277,59.6,100806,6.5
South Dakota,1985,4,345747,68.3,328982,65.0,16765,4.8
Tennessee,1985,4,2249989,62.7,2069408,57.7,180581,8.0
Texas,1985,4,8066167,68.9,7516526,64.2,549641,6.8
Utah,1985,4,729294,68.9,684302,64.6,44992,6.2
Vermont,1985,4,277136,69.1,264202,65.9,12934,4.7
Virginia,1985,4,2863230,68.2,2705540,64.4,157690,5.5
Washington,1985,4,2098718,64.6,1921062,59.1,177656,8.5
West Virginia,1985,4,756597,51.7,653396,44.6,103201,13.6
Wisconsin,1985,4,2396583,67.1,2223779,62.3,172804,7.2
Wyoming,1985,4,254261,71.0,237308,66.3,16953,6.7
Alabama,1985,5,1798990,60.7,1625773,54.8,173217,9.6
Alaska,1985,5,248605,72.7,223978,65.5,24627,9.9
Arizona,1985,5,1479866,63.1,1384266,59.1,95600,6.5
Arkansas,1985,5,1053902,60.4,964407,55.2,89495,8.5
California,1985,5,12932221,66.0,11988652,61.2,943569,7.3
Los Angeles County,1985,5,3978491,65.3,3690727,60.5,287764,7.2
Colorado,1985,5,1714209,72.0,1613528,67.7,100681,5.9
Connecticut,1985,5,1695974,68.7,1618751,65.6,77223,4.6
Delaware,1985,5,315303,66.9,298291,63.3,17012,5.4
District of Columbia,1985,5,322482,66.6,295766,61.1,26716,8.3
Florida,1985,5,5319250,59.9,4989582,56.2,329668,6.2
Georgia,1985,5,2865075,65.9,2675343,61.5,189732,6.6
Hawaii,1985,5,479141,65.7,454304,62.3,24837,5.2
Idaho,1985,5,466776,66.8,430154,61.5,36622,7.8
Illinois,1985,5,5653192,65.5,5140381,59.6,512811,9.1
Indiana,1985,5,2702231,66.1,2487798,60.8,214433,7.9
Iowa,1985,5,1421510,66.1,1315936,61.2,105574,7.4
Kansas,1985,5,1229235,68.6,1166658,65.1,62577,5.1
Kentucky,1985,5,1696230,61.8,1545911,56.3,150319,8.9
Louisiana,1985,5,1967221,61.6,1743087,54.5,224134,11.4
Maine,1985,5,553720,63.4,522277,59.8,31443,5.7
Maryland,1985,5,2271563,68.2,2164097,64.9,107466,4.7
Massachusetts,1985,5,3052991,67.4,2925485,64.6,127506,4.2
Michigan,1985,5,4352041,64.1,3906033,57.6,446008,10.2
Minnesota,1985,5,2227194,71.5,2094237,67.2,132957,6.0
Mississippi,1985,5,1118824,60.0,1002826,53.8,115998,10.4
Missouri,1985,5,2430944,64.4,2266598,60.1,164346,6.8
Montana,1985,5,404325,66.9,373541,61.8,30784,7.6
Nebraska,1985,5,803322,68.5,762512,65.1,40810,5.1
Nevada,1985,5,515586,71.7,475943,66.2,39643,7.7
New Hampshire,1985,5,535563,70.9,514604,68.2,20959,3.9
New Jersey,1985,5,3819900,65.2,3603067,61.5,216833,5.7
New Mexico,1985,5,647795,63.3,591558,57.8,56237,8.7
New York,1985,5,8281437,60.5,7727728,56.5,553709,6.7
New York city,1985,5,3219317,56.0,2955689,51.4,263628,8.2
North Carolina,1985,5,3094039,66.4,2912707,62.5,181332,5.9
North Dakota,1985,5,328639,67.5,310732,63.8,17907,5.4
Ohio,1985,5,5123031,63.5,4665684,57.8,457347,8.9
Oklahoma,1985,5,1552501,64.6,1442140,60.0,110361,7.1
Oregon,1985,5,1322697,65.4,1205510,59.6,117187,8.9
Pennsylvania,1985,5,5533021,60.1,5082044,55.2,450977,8.2
Rhode Island,1985,5,497281,66.6,472870,63.3,24411,4.9
South Carolina,1985,5,1546298,63.8,1441798,59.5,104500,6.8
South Dakota,1985,5,345887,68.4,328895,65.0,16992,4.9
Tennessee,1985,5,2250777,62.7,2070392,57.6,180385,8.0
Texas,1985,5,8070857,68.8,7511252,64.1,559605,6.9
Utah,1985,5,730657,68.9,685755,64.6,44902,6.1
Vermont,1985,5,277762,69.3,264694,66.0,13068,4.7
Virginia,1985,5,2862887,68.1,2703730,64.3,159157,5.6
Washington,1985,5,2101245,64.7,1925430,59.2,175815,8.4
West Virginia,1985,5,754527,51.5,652974,44.6,101553,13.5
Wisconsin,1985,5,2393524,67.0,2221113,62.2,172411,7.2
Wyoming,1985,5,254113,71.0,236735,66.1,17378,6.8
Alabama,1985,6,1798404,60.6,1627270,54.8,171134,9.5
Alaska,1985,6,248712,72.5,224011,65.3,24701,9.9
Arizona,1985,6,1482987,63.1,1385297,58.9,97690,6.6
Arkansas,1985,6,1055832,60.4,965602,55.3,90230,8.5
California,1985,6,12940405,65.9,11997098,61.1,943307,7.3
Los Angeles County,1985,6,3977517,65.2,3692241,60.5,285276,7.2
Colorado,1985,6,1712563,71.8,1610892,67.5,101671,5.9
Connecticut,1985,6,1696121,68.7,1619272,65.6,76849,4.5
Delaware,1985,6,316348,67.2,299740,63.6,16608,5.2
District of Columbia,1985,6,321877,66.5,295472,61.0,26405,8.2
Florida,1985,6,5324745,59.8,4996878,56.1,327867,6.2
Georgia,1985,6,2869460,65.8,2680011,61.5,189449,6.6
Hawaii,1985,6,480021,65.8,454745,62.3,25276,5.3
Idaho,1985,6,466389,66.7,429637,61.5,36752,7.9
Illinois,1985,6,5648239,65.4,5130266,59.4,517973,9.2
Indiana,1985,6,2702836,66.1,2490544,60.9,212292,7.9
Iowa,1985,6,1421488,66.1,1315916,61.2,105572,7.4
Kansas,1985,6,1228462,68.6,1165973,65.1,62489,5.1
Kentucky,1985,6,1695005,61.7,1543085,56.2,151920,9.0
Louisiana,1985,6,1967780,61.6,1742380,54.5,225400,11.5
Maine,1985,6,552619,63.2,521709,59.7,30910,5.6
Maryland,1985,6,2272384,68.1,2166413,64.9,105971,4.7
Massachusetts,1985,6,3049627,67.3,2922069,64.5,127558,4.2
Michigan,1985,6,4352397,64.1,3907007,57.5,445390,10.2
Minnesota,1985,6,2229629,71.5,2095500,67.2,134129,6.0
Mississippi,1985,6,1120630,60.0,1004312,53.8,116318,10.4
Missouri,1985,6,2433287,64.5,2270199,60.2,163088,6.7
Montana,1985,6,403920,66.9,373230,61.8,30690,7.6
Nebraska,1985,6,803377,68.6,762151,65.1,41226,5.1
Nevada,1985,6,516039,71.5,476651,66.0,39388,7.6
New Hampshire,1985,6,536643,71.0,516342,68.3,20301,3.8
New Jersey,1985,6,3820877,65.2,3606439,61.5,214438,5.6
New Mexico,1985,6,648486,63.3,591881,57.7,56605,8.7
New York,1985,6,8300178,60.7,7750231,56.6,549947,6.6
New York city,1985,6,3230546,56.2,2972002,51.7,258544,8.0
North Carolina,1985,6,3098364,66.4,2920210,62.5,178154,5.7
North Dakota,1985,6,328744,67.6,310800,64.0,17944,5.5
Ohio,1985,6,5125612,63.5,4664920,57.8,460692,9.0
Oklahoma,1985,6,1550933,64.6,1441729,60.0,109204,7.0
Oregon,1985,6,1321422,65.3,1206097,59.6,115325,8.7
Pennsylvania,1985,6,5536034,60.2,5087222,55.3,448812,8.1
Rhode Island,1985,6,497310,66.5,473378,63.3,23932,4.8
South Carolina,1985,6,1550237,63.8,1442081,59.4,108156,7.0
South Dakota,1985,6,345897,68.5,328826,65.1,17071,4.9
Tennessee,1985,6,2250461,62.6,2070792,57.6,179669,8.0
Texas,1985,6,8075558,68.8,7505901,63.9,569657,7.1
Utah,1985,6,732135,68.9,687303,64.7,44832,6.1
Vermont,1985,6,278477,69.3,265327,66.0,13150,4.7
Virginia,1985,6,2862709,68.0,2703058,64.2,159651,5.6
Washington,1985,6,2103737,64.7,1929710,59.3,174027,8.3
West Virginia,1985,6,752610,51.4,652596,44.6,100014,13.3
Wisconsin,1985,6,2391062,66.9,2219545,62.1,171517,7.2
Wyoming,1985,6,253965,71.1,236146,66.1,17819,7.0
Alabama,1985,7,1799526,60.6,1629958,54.9,169568,9.4
Alaska,1985,7,248978,72.6,224265,65.4,24713,9.9
Arizona,1985,7,1487453,63.1,1388268,58.9,99185,6.7
Arkansas,1985,7,1057280,60.5,966457,55.3,90823,8.6
California,1985,7,12955986,65.8,12013707,61.1,942279,7.3
Los Angeles County,1985,7,3980726,65.2,3698242,60.5,282484,7.1
Colorado,1985,7,1710710,71.7,1607993,67.4,102717,6.0
Connecticut,1985,7,1698045,68.7,1621879,65.6,76166,4.5
Delaware,1985,7,317460,67.3,301270,63.8,16190,5.1
District of Columbia,1985,7,321480,66.4,295473,61.0,26007,8.1
Florida,1985,7,5333127,59.8,5007556,56.1,325571,6.1
Georgia,1985,7,2874844,65.8,2687122,61.5,187722,6.5
Hawaii,1985,7,481312,65.8,455620,62.3,25692,5.3
Idaho,1985,7,466108,66.7,429361,61.4,36747,7.9
Illinois,1985,7,5647292,65.4,5124267,59.4,523025,9.3
Indiana,1985,7,2703343,66.1,2493809,61.0,209534,7.8
Iowa,1985,7,1421908,66.2,1316113,61.3,105795,7.4
Kansas,1985,7,1228468,68.6,1165702,65.1,62766,5.1
Kentucky,1985,7,1695091,61.7,1541240,56.1,153851,9.1
Louisiana,1985,7,1969129,61.6,1742382,54.5,226747,11.5
Maine,1985,7,552226,63.1,521763,59.6,30463,5.5
Maryland,1985,7,2274558,68.1,2170010,64.9,104548,4.6
Massachusetts,1985,7,3047336,67.2,2919954,64.4,127382,4.2
Michigan,1985,7,4356070,64.1,3912128,57.6,443942,10.2
Minnesota,1985,7,2233647,71.6,2097911,67.3,135736,6.1
Mississippi,1985,7,1122703,60.1,1005937,53.8,116766,10.4
Missouri,1985,7,2436946,64.6,2275107,60.3,161839,6.6
Montana,1985,7,403637,66.8,372900,61.7,30737,7.6
Nebraska,1985,7,803777,68.7,762265,65.2,41512,5.2
Nevada,1985,7,516661,71.3,477610,65.9,39051,7.6
New Hampshire,1985,7,538163,71.0,518567,68.4,19596,3.6
New Jersey,1985,7,3824686,65.2,3612260,61.6,212426,5.6
New Mexico,1985,7,649517,63.3,592734,57.8,56783,8.7
New York,1985,7,8318404,60.8,7771516,56.8,546888,6.6
New York city,1985,7,3236653,56.3,2982021,51.9,254632,7.9
North Carolina,1985,7,3105884,66.4,2930822,62.7,175062,5.6
North Dakota,1985,7,329029,67.7,311015,64.0,18014,5.5
Ohio,1985,7,5132039,63.5,4667202,57.8,464837,9.1
Oklahoma,1985,7,1551297,64.6,1442655,60.1,108642,7.0
Oregon,1985,7,1321361,65.3,1207955,59.7,113406,8.6
Pennsylvania,1985,7,5541052,60.2,5095129,55.4,445923,8.0
Rhode Island,1985,7,497757,66.5,474287,63.4,23470,4.7
South Carolina,1985,7,1553629,63.9,1442790,59.3,110839,7.1
South Dakota,1985,7,345931,68.5,328869,65.1,17062,4.9
Tennessee,1985,7,2249878,62.5,2071165,57.5,178713,7.9
Texas,1985,7,8082709,68.7,7503257,63.8,579452,7.2
Utah,1985,7,733857,69.0,689114,64.8,44743,6.1
Vermont,1985,7,279352,69.5,266181,66.2,13171,4.7
Virginia,1985,7,2863476,68.0,2704304,64.2,159172,5.6
Washington,1985,7,2106732,64.7,1934190,59.4,172542,8.2
West Virginia,1985,7,750997,51.3,652477,44.6,98520,13.1
Wisconsin,1985,7,2390565,66.9,2219633,62.1,170932,7.2
Wyoming,1985,7,253803,71.1,235603,66.0,18200,7.2
Alabama,1985,8,1802236,60.6,1634061,55.0,168175,9.3
Alaska,1985,8,249456,72.5,224773,65.3,24683,9.9
Arizona,1985,8,1493229,63.2,1393648,59.0,99581,6.7
Arkansas,1985,8,1058212,60.5,967224,55.3,90988,8.6
California,1985,8,12978993,65.9,12041877,61.1,937116,7.2
Los Angeles County,1985,8,3987389,65.1,3708680,60.6,278709,7.0
Colorado,1985,8,1709019,71.5,1605467,67.2,103552,6.1
Connecticut,1985,8,1701993,68.9,1626987,65.8,75006,4.4
Delaware,1985,8,318431,67.3,302722,64.0,15709,4.9
District of Columbia,1985,8,321216,66.4,295733,61.1,25483,7.9
Florida,1985,8,5345064,59.8,5022728,56.2,322336,6.0
Georgia,1985,8,2881404,65.8,2696892,61.6,184512,6.4
Hawaii,1985,8,482911,66.0,457054,62.4,25857,5.4
Idaho,1985,8,466118,66.6,429443,61.3,36675,7.9
Illinois,1985,8,5650549,65.4,5125848,59.3,524701,9.3
Indiana,1985,8,2704520,66.1,2498791,61.1,205729,7.6
Iowa,1985,8,1423017,66.3,1317132,61.3,105885,7.4
Kansas,1985,8,1229622,68.6,1166317,65.1,63305,5.1
Kentucky,1985,8,1696241,61.7,1540680,56.1,155561,9.2
Louisiana,1985,8,1971530,61.6,1743727,54.5,227803,11.6
Maine,1985,8,552799,63.1,522636,59.7,30163,5.5
Maryland,1985,8,2278040,68.1,2175079,65.0,102961,4.5
Massachusetts,1985,8,3047172,67.2,2920547,64.4,126625,4.2
Michigan,1985,8,4361494,64.1,3922680,57.7,438814,10.1
Minnesota,1985,8,2238574,71.7,2101629,67.3,136945,6.1
Mississippi,1985,8,1125261,60.2,1007999,53.9,117262,10.4
Missouri,1985,8,2442244,64.6,2281947,60.4,160297,6.6
Montana,1985,8,403529,66.8,372646,61.7,30883,7.7
Nebraska,1985,8,804859,68.7,763132,65.2,41727,5.2
Nevada,1985,8,517570,71.3,478946,66.0,38624,7.5
New Hampshire,1985,8,540314,71.1,521479,68.6,18835,3.5
New Jersey,1985,8,3831820,65.3,3620653,61.7,211167,5.5
New Mexico,1985,8,651126,63.3,594397,57.8,56729,8.7
New York,1985,8,8338976,60.9,7795437,56.9,543539,6.5
New York city,1985,8,3241838,56.3,2989977,52.0,251861,7.8
North Carolina,1985,8,3116850,66.6,2945594,62.9,171256,5.5
North Dakota,1985,8,329551,67.8,311478,64.1,18073,5.5
Ohio,1985,8,5141580,63.6,4674457,57.9,467123,9.1
Oklahoma,1985,8,1553826,64.7,1445137,60.2,108689,7.0
Oregon,1985,8,1322925,65.3,1211428,59.8,111497,8.4
Pennsylvania,1985,8,5548859,60.3,5107164,55.5,441695,8.0
Rhode Island,1985,8,498628,66.6,475677,63.5,22951,4.6
South Carolina,1985,8,1556265,63.9,1444439,59.3,111826,7.2
South Dakota,1985,8,346119,68.4,329123,65.0,16996,4.9
Tennessee,1985,8,2250388,62.4,2073028,57.5,177360,7.9
Texas,1985,8,8091972,68.7,7505810,63.7,586162,7.2
Utah,1985,8,735764,69.2,691310,65.0,44454,6.0
Vermont,1985,8,280372,69.7,267282,66.5,13090,4.7
Virginia,1985,8,2865556,67.9,2707910,64.2,157646,5.5
Washington,1985,8,2110251,64.7,1939370,59.5,170881,8.1
West Virginia,1985,8,749528,51.3,652791,44.7,96737,12.9
Wisconsin,1985,8,2392320,66.9,2221693,62.1,170627,7.1
Wyoming,1985,8,253626,71.0,235171,65.9,18455,7.3
Alabama,1985,9,1806241,60.7,1639287,55.1,166954,9.2
Alaska,1985,9,250166,72.5,225510,65.4,24656,9.9
Arizona,1985,9,1499970,63.3,1401162,59.1,98808,6.6
Arkansas,1985,9,1058809,60.5,968138,55.3,90671,8.6
California,1985,9,13007219,65.9,12079990,61.2,927229,7.1
Los Angeles County,1985,9,3996272,65.1,3722015,60.7,274257,6.9
Colorado,1985,9,1707698,71.4,1603572,67.0,104126,6.1
Connecticut,1985,9,1707297,69.0,1633926,66.0,73371,4.3
Delaware,1985,9,319124,67.5,303942,64.3,15182,4.8
District of Columbia,1985,9,321138,66.5,296288,61.3,24850,7.7
Florida,1985,9,5360345,59.8,5041856,56.2,318489,5.9
Georgia,1985,9,2888696,65.9,2708414,61.8,180282,6.2
Hawaii,1985,9,484585,66.1,458851,62.6,25734,5.3
Idaho,1985,9,466437,66.5,429749,61.3,36688,7.9
Illinois,1985,9,5656711,65.5,5134715,59.4,521996,9.2
Indiana,1985,9,2707022,66.1,2506227,61.2,200795,7.4
Iowa,1985,9,1425015,66.4,1319409,61.5,105606,7.4
Kansas,1985,9,1231606,68.6,1167761,65.1,63845,5.2
Kentucky,1985,9,1697857,61.8,1541185,56.1,156672,9.2
Louisiana,1985,9,1974708,61.7,1746127,54.5,228581,11.6
Maine,1985,9,554232,63.3,524239,59.8,29993,5.4
Maryland,1985,9,2282297,68.1,2181145,65.1,101152,4.4
Massachusetts,1985,9,3049414,67.2,2924167,64.4,125247,4.1
Michigan,1985,9,4366112,64.2,3936606,57.8,429506,9.8
Minnesota,1985,9,2243355,71.7,2105948,67.3,137407,6.1
Mississippi,1985,9,1128388,60.4,1010639,54.1,117749,10.4
Missouri,1985,9,2448742,64.7,2290249,60.5,158493,6.5
Montana,1985,9,403624,66.9,372563,61.8,31061,7.7
Nebraska,1985,9,806532,68.8,764676,65.2,41856,5.2
Nevada,1985,9,518707,71.3,480619,66.1,38088,7.3
New Hampshire,1985,9,543047,71.3,524989,68.9,18058,3.3
New Jersey,1985,9,3841693,65.3,3630694,61.8,210999,5.5
New Mexico,1985,9,653272,63.3,596749,57.8,56523,8.7
New York,1985,9,8360850,61.1,7820905,57.1,539945,6.5
New York city,1985,9,3246822,56.4,2996833,52.0,249989,7.7
North Carolina,1985,9,3129942,66.8,2963316,63.2,166626,5.3
North Dakota,1985,9,330245,68.0,312131,64.2,18114,5.5
Ohio,1985,9,5153659,63.8,4687505,58.0,466154,9.0
Oklahoma,1985,9,1557715,64.8,1448762,60.3,108953,7.0
Oregon,1985,9,1326237,65.4,1216268,59.9,109969,8.3
Pennsylvania,1985,9,5559219,60.4,5123010,55.6,436209,7.8
Rhode Island,1985,9,499744,66.7,477444,63.7,22300,4.5
South Carolina,1985,9,1557978,64.0,1446892,59.4,111086,7.1
South Dakota,1985,9,346494,68.5,329590,65.1,16904,4.9
Tennessee,1985,9,2253167,62.5,2077270,57.6,175897,7.8
Texas,1985,9,8102385,68.7,7513079,63.7,589306,7.3
Utah,1985,9,737721,69.2,693788,65.1,43933,6.0
Vermont,1985,9,281441,69.8,268537,66.6,12904,4.6
Virginia,1985,9,2868726,67.9,2713488,64.2,155238,5.4
Washington,1985,9,2114279,64.7,1945500,59.6,168779,8.0
West Virginia,1985,9,748148,51.2,653479,44.7,94669,12.7
Wisconsin,1985,9,2395636,67.0,2225324,62.2,170312,7.1
Wyoming,1985,9,253478,70.8,234880,65.6,18598,7.3
Alabama,1985,10,1811150,60.8,1644727,55.2,166423,9.2
Alaska,1985,10,251000,72.8,226269,65.6,24731,9.9
Arizona,1985,10,1507199,63.5,1409642,59.4,97557,6.5
Arkansas,1985,10,1059385,60.5,969190,55.4,90195,8.5
California,1985,10,13037902,65.9,12121770,61.3,916132,7.0
Los Angeles County,1985,10,4005988,65.2,3735662,60.8,270326,6.7
Colorado,1985,10,1706529,71.3,1601853,66.9,104676,6.1
Connecticut,1985,10,1712693,69.2,1641133,66.3,71560,4.2
Delaware,1985,10,319540,67.4,304823,64.3,14717,4.6
District of Columbia,1985,10,321174,66.5,296953,61.5,24221,7.5
Florida,1985,10,5378200,59.9,5062884,56.3,315316,5.9
Georgia,1985,10,2896140,66.0,2719942,62.0,176198,6.1
Hawaii,1985,10,486172,66.2,460693,62.8,25479,5.2
Idaho,1985,10,467012,66.6,430103,61.4,36909,7.9
Illinois,1985,10,5664471,65.5,5147179,59.5,517292,9.1
Indiana,1985,10,2711061,66.2,2515420,61.4,195641,7.2
Iowa,1985,10,1427818,66.5,1322680,61.6,105138,7.4
Kansas,1985,10,1233757,68.7,1169390,65.1,64367,5.2
Kentucky,1985,10,1699246,61.8,1541854,56.1,157392,9.3
Louisiana,1985,10,1978025,61.7,1748665,54.6,229360,11.6
Maine,1985,10,556136,63.4,526232,60.0,29904,5.4
Maryland,1985,10,2286928,68.2,2187201,65.2,99727,4.4
Massachusetts,1985,10,3053235,67.2,2929544,64.5,123691,4.1
Michigan,1985,10,4368239,64.1,3950116,58.0,418123,9.6
Minnesota,1985,10,2246841,71.8,2109431,67.4,137410,6.1
Mississippi,1985,10,1131728,60.6,1013398,54.2,118330,10.5
Missouri,1985,10,2455523,64.8,2298683,60.7,156840,6.4
Montana,1985,10,403963,67.0,372632,61.8,31331,7.8
Nebraska,1985,10,808448,69.0,766459,65.4,41989,5.2
Nevada,1985,10,519937,71.5,482421,66.4,37516,7.2
New Hampshire,1985,10,546076,71.6,528692,69.3,17384,3.2
New Jersey,1985,10,3852254,65.4,3640491,61.9,211763,5.5
New Mexico,1985,10,655679,63.4,599259,58.0,56420,8.6
New York,1985,10,8381270,61.2,7843211,57.3,538059,6.4
New York city,1985,10,3251202,56.4,3001948,52.1,249254,7.7
North Carolina,1985,10,3142791,67.0,2980713,63.5,162078,5.2
North Dakota,1985,10,330969,68.1,312802,64.4,18167,5.5
Ohio,1985,10,5166697,63.9,4704518,58.2,462179,8.9
Oklahoma,1985,10,1561850,64.9,1452298,60.4,109552,7.0
Oregon,1985,10,1330716,65.5,1221448,60.1,109268,8.2
Pennsylvania,1985,10,5571154,60.5,5140330,55.8,430824,7.7
Rhode Island,1985,10,500896,66.8,479309,63.9,21587,4.3
South Carolina,1985,10,1559019,64.0,1449510,59.5,109509,7.0
South Dakota,1985,10,347002,68.4,330160,65.1,16842,4.9
Tennessee,1985,10,2258442,62.6,2083180,57.7,175262,7.8
Texas,1985,10,8112668,68.7,7521052,63.7,591616,7.3
Utah,1985,10,739569,69.3,696200,65.2,43369,5.9
Vermont,1985,10,282445,70.1,269794,66.9,12651,4.5
Virginia,1985,10,2872203,67.8,2719763,64.2,152440,5.3
Washington,1985,10,2119266,64.7,1952451,59.6,166815,7.9
West Virginia,1985,10,746966,51.1,654242,44.8,92724,12.4
Wisconsin,1985,10,2399474,67.1,2229629,62.3,169845,7.1
Wyoming,1985,10,253315,70.8,234654,65.5,18661,7.4
Alabama,1985,11,1816377,60.9,1649453,55.3,166924,9.2
Alaska,1985,11,251869,72.8,226868,65.6,25001,9.9
Arizona,1985,11,1514690,63.6,1418064,59.6,96626,6.4
Arkansas,1985,11,1060090,60.5,970202,55.3,89888,8.5
California,1985,11,13067807,66.0,12161186,61.4,906621,6.9
Los Angeles County,1985,11,4015331,65.2,3747817,60.8,267514,6.7
Colorado,1985,11,1705400,71.1,1599656,66.7,105744,6.2
Connecticut,1985,11,1717012,69.3,1647139,66.5,69873,4.1
Delaware,1985,11,319724,67.3,305321,64.3,14403,4.5
District of Columbia,1985,11,321239,66.6,297559,61.7,23680,7.4
Florida,1985,11,5397134,59.9,5083644,56.4,313490,5.8
Georgia,1985,11,2903347,66.0,2730228,62.1,173119,6.0
Hawaii,1985,11,487551,66.2,462307,62.8,25244,5.2
Idaho,1985,11,467647,66.6,430418,61.3,37229,8.0
Illinois,1985,11,5671201,65.6,5159319,59.7,511882,9.0
Indiana,1985,11,2715770,66.2,2524235,61.6,191535,7.1
Iowa,1985,11,1430763,66.7,1326155,61.8,104608,7.3
Kansas,1985,11,1235458,68.7,1170648,65.1,64810,5.2
Kentucky,1985,11,1699826,61.8,1541832,56.0,157994,9.3
Louisiana,1985,11,1980494,61.7,1750068,54.6,230426,11.6
Maine,1985,11,558028,63.6,528171,60.2,29857,5.4
Maryland,1985,11,2291848,68.2,2192706,65.3,99142,4.3
Massachusetts,1985,11,3057421,67.3,2935069,64.6,122352,4.0
Michigan,1985,11,4367207,64.1,3960356,58.1,406851,9.3
Minnesota,1985,11,2248216,71.7,2111153,67.3,137063,6.1
Mississippi,1985,11,1134673,60.7,1015526,54.4,119147,10.5
Missouri,1985,11,2461491,64.9,2306079,60.8,155412,6.3
Montana,1985,11,404377,67.1,372764,61.8,31613,7.8
Nebraska,1985,11,810200,69.1,768062,65.5,42138,5.2
Nevada,1985,11,521086,71.6,484165,66.5,36921,7.1
New Hampshire,1985,11,548969,71.8,532064,69.6,16905,3.1
New Jersey,1985,11,3861058,65.5,3648545,61.9,212513,5.5
New Mexico,1985,11,657940,63.4,601357,58.0,56583,8.6
New York,1985,11,8396228,61.3,7857703,57.4,538525,6.4
New York city,1985,11,3253590,56.4,3004044,52.1,249546,7.7
North Carolina,1985,11,3152901,67.2,2994010,63.8,158891,5.0
North Dakota,1985,11,331533,68.2,313302,64.5,18231,5.5
Ohio,1985,11,5178174,64.0,4722387,58.4,455787,8.8
Oklahoma,1985,11,1565472,65.0,1454660,60.4,110812,7.1
Oregon,1985,11,1335342,65.6,1225753,60.2,109589,8.2
Pennsylvania,1985,11,5583450,60.6,5156742,56.0,426708,7.6
Rhode Island,1985,11,501801,66.9,480935,64.1,20866,4.2
South Carolina,1985,11,1560055,64.0,1452016,59.5,108039,6.9
South Dakota,1985,11,347529,68.5,330707,65.2,16822,4.8
Tennessee,1985,11,2264730,62.7,2088842,57.9,175888,7.8
Texas,1985,11,8122447,68.7,7526209,63.6,596238,7.3
Utah,1985,11,741131,69.4,698242,65.4,42889,5.8
Vermont,1985,11,283333,70.1,270921,67.1,12412,4.4
Virginia,1985,11,2875067,67.8,2725344,64.2,149723,5.2
Washington,1985,11,2125529,64.8,1959762,59.7,165767,7.8
West Virginia,1985,11,745925,51.1,654732,44.8,91193,12.2
Wisconsin,1985,11,2402795,67.1,2233656,62.4,169139,7.0
Wyoming,1985,11,253209,70.7,234396,65.5,18813,7.4
Alabama,1985,12,1821688,61.1,1653092,55.4,168596,9.3
Alaska,1985,12,252806,72.9,227281,65.5,25525,10.1
Arizona,1985,12,1522245,63.8,1425711,59.7,96534,6.3
Arkansas,1985,12,1061022,60.5,971101,55.4,89921,8.5
California,1985,12,13095486,66.0,12194718,61.5,900768,6.9
Los Angeles County,1985,12,4024208,65.2,3758194,60.9,266014,6.6
Colorado,1985,12,1704095,71.0,1596191,66.5,107904,6.3
Connecticut,1985,12,1719637,69.4,1651096,66.6,68541,4.0
Delaware,1985,12,319816,67.3,305508,64.3,14308,4.5
District of Columbia,1985,12,321357,66.7,298046,61.8,23311,7.3
Florida,1985,12,5416113,60.0,5102742,56.5,313371,5.8
Georgia,1985,12,2910482,66.1,2738976,62.2,171506,5.9
Hawaii,1985,12,488532,66.3,463447,62.9,25085,5.1
Idaho,1985,12,468137,66.6,430594,61.3,37543,8.0
Illinois,1985,12,5674821,65.6,5168785,59.7,506036,8.9
Indiana,1985,12,2719883,66.3,2530553,61.7,189330,7.0
Iowa,1985,12,1433173,66.8,1329094,62.0,104079,7.3
Kansas,1985,12,1236565,68.6,1171311,65.0,65254,5.3
Kentucky,1985,12,1699710,61.8,1541181,56.0,158529,9.3
Louisiana,1985,12,1981526,61.7,1749426,54.5,232100,11.7
Maine,1985,12,559458,63.7,529610,60.3,29848,5.3
Maryland,1985,12,2297233,68.3,2197848,65.4,99385,4.3
Massachusetts,1985,12,3060739,67.3,2939164,64.7,121575,4.0
Michigan,1985,12,4364644,64.0,3966288,58.1,398356,9.1
Minnesota,1985,12,2247541,71.6,2111102,67.3,136439,6.1
Mississippi,1985,12,1137029,60.9,1016501,54.4,120528,10.6
Missouri,1985,12,2466060,65.0,2311800,60.9,154260,6.3
Montana,1985,12,404636,67.2,372792,61.9,31844,7.9
Nebraska,1985,12,811491,69.1,769250,65.5,42241,5.2
Nevada,1985,12,522057,71.6,485763,66.6,36294,7.0
New Hampshire,1985,12,551355,71.9,534670,69.7,16685,3.0
New Jersey,1985,12,3867140,65.5,3654387,61.9,212753,5.5
New Mexico,1985,12,659719,63.4,602705,58.0,57014,8.6
New York,1985,12,8404000,61.3,7862496,57.4,541504,6.4
New York city,1985,12,3253317,56.4,3002582,52.0,250735,7.7
North Carolina,1985,12,3158756,67.2,3000730,63.8,158026,5.0
North Dakota,1985,12,331841,68.3,313498,64.5,18343,5.5
Ohio,1985,12,5186491,64.1,4737881,58.6,448610,8.6
Oklahoma,1985,12,1568462,65.1,1455335,60.4,113127,7.2
Oregon,1985,12,1339591,65.7,1228690,60.3,110901,8.3
Pennsylvania,1985,12,5595300,60.7,5171186,56.1,424114,7.6
Rhode Island,1985,12,502240,66.9,482057,64.2,20183,4.0
South Carolina,1985,12,1561983,64.0,1454761,59.6,107222,6.9
South Dakota,1985,12,347965,68.5,331126,65.2,16839,4.8
Tennessee,1985,12,2270533,62.9,2093034,57.9,177499,7.8
Texas,1985,12,8133399,68.7,7527321,63.5,606078,7.5
Utah,1985,12,742345,69.4,699746,65.5,42599,5.7
Vermont,1985,12,284040,70.3,271779,67.3,12261,4.3
Virginia,1985,12,2877085,67.7,2729635,64.2,147450,5.1
Washington,1985,12,2133031,64.9,1967016,59.8,166015,7.8
West Virginia,1985,12,745147,51.0,654874,44.9,90273,12.1
Wisconsin,1985,12,2405055,67.2,2236587,62.5,168468,7.0
Wyoming,1985,12,253166,70.7,234007,65.4,19159,7.6
Alabama,1986,1,1827550,61.2,1656221,55.5,171329,9.4
Alaska,1986,1,253761,72.9,227481,65.4,26280,10.4
Arizona,1986,1,1530252,63.9,1432668,59.9,97584,6.4
Arkansas,1986,1,1062220,60.5,971894,55.4,90326,8.5
California,1986,1,13123458,66.0,12223689,61.5,899769,6.9
Los Angeles County,1986,1,4034239,65.2,3768265,60.9,265974,6.6
Colorado,1986,1,1702618,70.9,1591492,66.3,111126,6.5
Connecticut,1986,1,1720985,69.4,1653314,66.7,67671,3.9
Delaware,1986,1,320083,67.2,305624,64.2,14459,4.5
District of Columbia,1986,1,321426,66.7,298242,61.9,23184,7.2
Florida,1986,1,5436192,60.1,5120980,56.6,315212,5.8
Georgia,1986,1,2918617,66.2,2747072,62.3,171545,5.9
Hawaii,1986,1,489068,66.3,464079,62.9,24989,5.1
Idaho,1986,1,468603,66.6,430702,61.2,37901,8.1
Illinois,1986,1,5676186,65.6,5175608,59.8,500578,8.8
Indiana,1986,1,2723029,66.3,2533914,61.7,189115,6.9
Iowa,1986,1,1435094,67.0,1331436,62.1,103658,7.2
Kansas,1986,1,1237401,68.6,1171577,64.9,65824,5.3
Kentucky,1986,1,1699804,61.7,1540860,55.9,158944,9.4
Louisiana,1986,1,1981243,61.7,1746590,54.4,234653,11.8
Maine,1986,1,560319,63.7,530439,60.3,29880,5.3
Maryland,1986,1,2303710,68.4,2203345,65.4,100365,4.4
Massachusetts,1986,1,3062352,67.3,2940817,64.6,121535,4.0
Michigan,1986,1,4363463,63.9,3968780,58.1,394683,9.0
Minnesota,1986,1,2245812,71.5,2110084,67.2,135728,6.0
Mississippi,1986,1,1139396,61.0,1016621,54.4,122775,10.8
Missouri,1986,1,2469921,65.0,2316094,61.0,153827,6.2
Montana,1986,1,404712,67.2,372654,61.9,32058,7.9
Nebraska,1986,1,812267,69.1,770099,65.5,42168,5.2
Nevada,1986,1,522929,71.6,487278,66.8,35651,6.8
New Hampshire,1986,1,553177,71.9,536482,69.8,16695,3.0
New Jersey,1986,1,3871223,65.5,3658818,61.9,212405,5.5
New Mexico,1986,1,661004,63.4,603279,57.8,57725,8.7
New York,1986,1,8407317,61.4,7860804,57.4,546513,6.5
New York city,1986,1,3251718,56.3,2998961,51.9,252757,7.8
North Carolina,1986,1,3160643,67.2,3001254,63.8,159389,5.0
North Dakota,1986,1,331952,68.3,313412,64.5,18540,5.6
Ohio,1986,1,5192444,64.2,4749480,58.7,442964,8.5
Oklahoma,1986,1,1571401,65.1,1454673,60.3,116728,7.4
Oregon,1986,1,1343638,65.9,1230720,60.3,112918,8.4
Pennsylvania,1986,1,5606682,60.8,5183928,56.2,422754,7.5
Rhode Island,1986,1,502343,66.9,482689,64.3,19654,3.9
South Carolina,1986,1,1565379,64.1,1458335,59.7,107044,6.8
South Dakota,1986,1,348282,68.6,331423,65.2,16859,4.8
Tennessee,1986,1,2275368,63.0,2095639,58.0,179729,7.9
Texas,1986,1,8148538,68.7,7525466,63.4,623072,7.6
Utah,1986,1,743409,69.4,700792,65.4,42617,5.7
Vermont,1986,1,284621,70.5,272386,67.4,12235,4.3
Virginia,1986,1,2879271,67.6,2733243,64.2,146028,5.1
Washington,1986,1,2141638,65.0,1974069,59.9,167569,7.8
West Virginia,1986,1,745018,51.1,654866,44.9,90152,12.1
Wisconsin,1986,1,2406828,67.2,2238584,62.5,168244,7.0
Wyoming,1986,1,253143,70.5,233457,65.0,19686,7.8
Alabama,1986,2,1834254,61.4,1659603,55.5,174651,9.5
Alaska,1986,2,254666,73.2,227520,65.4,27146,10.7
Arizona,1986,2,1539165,64.2,1439501,60.0,99664,6.5
Arkansas,1986,2,1063682,60.6,972755,55.4,90927,8.5
California,1986,2,13155800,66.1,12252758,61.5,903042,6.9
Los Angeles County,1986,2,4046908,65.3,3779623,61.0,267285,6.6
Colorado,1986,2,1701643,70.8,1586711,66.0,114932,6.8
Connecticut,1986,2,1722326,69.4,1655105,66.7,67221,3.9
Delaware,1986,2,320695,67.2,305912,64.1,14783,4.6
District of Columbia,1986,2,321470,66.8,298181,62.0,23289,7.2
Florida,1986,2,5459024,60.2,5140574,56.7,318450,5.8
Georgia,1986,2,2928766,66.3,2755808,62.4,172958,5.9
Hawaii,1986,2,489378,66.2,464485,62.9,24893,5.1
Idaho,1986,2,469251,66.7,430998,61.2,38253,8.2
Illinois,1986,2,5678217,65.6,5182025,59.8,496192,8.7
Indiana,1986,2,2725812,66.4,2535692,61.7,190120,7.0
Iowa,1986,2,1436818,67.1,1333521,62.3,103297,7.2
Kansas,1986,2,1238546,68.6,1171953,64.9,66593,5.4
Kentucky,1986,2,1700858,61.7,1541704,56.0,159154,9.4
Louisiana,1986,2,1980013,61.6,1742168,54.2,237845,12.0
Maine,1986,2,560954,63.7,531025,60.3,29929,5.3
Maryland,1986,2,2311807,68.6,2210017,65.5,101790,4.4
Massachusetts,1986,2,3062660,67.3,2940505,64.6,122155,4.0
Michigan,1986,2,4366114,63.9,3970258,58.1,395856,9.1
Minnesota,1986,2,2244534,71.3,2109682,67.1,134852,6.0
Mississippi,1986,2,1142252,61.1,1016551,54.4,125701,11.0
Missouri,1986,2,2474409,65.0,2319854,61.0,154555,6.2
Montana,1986,2,404708,67.2,372445,61.9,32263,8.0
Nebraska,1986,2,812618,69.1,770751,65.5,41867,5.2
Nevada,1986,2,523921,71.7,488911,66.9,35010,6.7
New Hampshire,1986,2,554555,71.9,537797,69.8,16758,3.0
New Jersey,1986,2,3874876,65.5,3663521,61.9,211355,5.5
New Mexico,1986,2,662087,63.4,603391,57.7,58696,8.9
New York,1986,2,8410923,61.4,7858631,57.3,552292,6.6
New York city,1986,2,3250302,56.2,2995121,51.8,255181,7.9
North Carolina,1986,2,3161270,67.1,2998762,63.7,162508,5.1
North Dakota,1986,2,331947,68.2,313143,64.3,18804,5.7
Ohio,1986,2,5198075,64.3,4758310,58.8,439765,8.5
Oklahoma,1986,2,1574696,65.2,1453562,60.2,121134,7.7
Oregon,1986,2,1347823,66.0,1232946,60.3,114877,8.5
Pennsylvania,1986,2,5617046,60.9,5195522,56.3,421524,7.5
Rhode Island,1986,2,502418,66.8,483039,64.2,19379,3.9
South Carolina,1986,2,1570252,64.2,1463218,59.8,107034,6.8
South Dakota,1986,2,348524,68.5,331695,65.2,16829,4.8
Tennessee,1986,2,2279169,63.0,2097093,58.0,182076,8.0
Texas,1986,2,8146129,68.6,7499770,63.1,646359,7.9
Utah,1986,2,744617,69.5,701675,65.5,42942,5.8
Vermont,1986,2,285202,70.4,272897,67.4,12305,4.3
Virginia,1986,2,2882738,67.6,2737387,64.2,145351,5.0
Washington,1986,2,2151223,65.2,1981001,60.0,170222,7.9
West Virginia,1986,2,745624,51.1,654977,44.9,90647,12.2
Wisconsin,1986,2,2409087,67.2,2240641,62.5,168446,7.0
Wyoming,1986,2,253209,70.5,232844,64.9,20365,8.0
Alabama,1986,3,1841290,61.6,1663497,55.6,177793,9.7
Alaska,1986,3,255467,73.2,227485,65.2,27982,11.0
Arizona,1986,3,1548653,64.4,1446251,60.1,102402,6.6
Arkansas,1986,3,1065362,60.6,973945,55.4,91417,8.6
California,1986,3,13193983,66.2,12285798,61.6,908185,6.9
Los Angeles County,1986,3,4062308,65.4,3792807,61.0,269501,6.6
Colorado,1986,3,1701376,70.7,1582893,65.7,118483,7.0
Connecticut,1986,3,1724516,69.5,1657525,66.8,66991,3.9
Delaware,1986,3,321617,67.4,306511,64.3,15106,4.7
District of Columbia,1986,3,321475,66.8,297940,61.9,23535,7.3
Florida,1986,3,5484778,60.3,5162788,56.8,321990,5.9
Georgia,1986,3,2940949,66.5,2765913,62.5,175036,6.0
Hawaii,1986,3,489744,66.2,465008,62.8,24736,5.1
Idaho,1986,3,470173,66.7,431561,61.2,38612,8.2
Illinois,1986,3,5682224,65.6,5189537,59.9,492687,8.7
Indiana,1986,3,2728734,66.4,2537549,61.7,191185,7.0
Iowa,1986,3,1438616,67.2,1335691,62.4,102925,7.2
Kansas,1986,3,1240243,68.6,1172825,64.8,67418,5.4
Kentucky,1986,3,1702765,61.8,1543687,56.0,159078,9.3
Louisiana,1986,3,1977717,61.5,1736808,54.0,240909,12.2
Maine,1986,3,561740,63.8,531755,60.4,29985,5.3
Maryland,1986,3,2321223,68.8,2217983,65.7,103240,4.4
Massachusetts,1986,3,3062538,67.2,2939444,64.5,123094,4.0
Michigan,1986,3,4372617,64.0,3973042,58.1,399575,9.1
Minnesota,1986,3,2244531,71.3,2111051,67.0,133480,5.9
Mississippi,1986,3,1145478,61.3,1016640,54.4,128838,11.2
Missouri,1986,3,2480265,65.1,2323980,61.0,156285,6.3
Montana,1986,3,404611,67.3,372194,61.9,32417,8.0
Nebraska,1986,3,812619,69.0,771294,65.5,41325,5.1
Nevada,1986,3,525255,71.8,490811,67.1,34444,6.6
New Hampshire,1986,3,555670,71.9,538945,69.7,16725,3.0
New Jersey,1986,3,3879390,65.5,3669588,61.9,209802,5.4
New Mexico,1986,3,663371,63.3,603538,57.6,59833,9.0
New York,1986,3,8416566,61.4,7859591,57.3,556975,6.6
New York city,1986,3,3249284,56.1,2992380,51.7,256904,7.9
North Carolina,1986,3,3163456,67.1,2997047,63.6,166409,5.3
North Dakota,1986,3,331897,68.2,312827,64.2,19070,5.7
Ohio,1986,3,5204326,64.3,4765709,58.9,438617,8.4
Oklahoma,1986,3,1578485,65.3,1452460,60.1,126025,8.0
Oregon,1986,3,1352345,66.1,1236120,60.4,116225,8.6
Pennsylvania,1986,3,5625676,61.0,5206623,56.4,419053,7.4
Rhode Island,1986,3,502702,66.8,483298,64.3,19404,3.9
South Carolina,1986,3,1576022,64.4,1469430,60.1,106592,6.8
South Dakota,1986,3,348727,68.4,331993,65.1,16734,4.8
Tennessee,1986,3,2282350,63.1,2098663,58.0,183687,8.0
Texas,1986,3,8149366,68.5,7477271,62.9,672095,8.2
Utah,1986,3,746155,69.5,702652,65.5,43503,5.8
Vermont,1986,3,285859,70.6,273450,67.5,12409,4.3
Virginia,1986,3,2887863,67.6,2742970,64.2,144893,5.0
Washington,1986,3,2161150,65.4,1987627,60.1,173523,8.0
West Virginia,1986,3,746718,51.2,655354,44.9,91364,12.2
Wisconsin,1986,3,2412375,67.3,2243604,62.6,168771,7.0
Wyoming,1986,3,253318,70.6,232263,64.7,21055,8.3
Alabama,1986,4,1848011,61.7,1667939,55.7,180072,9.7
Alaska,1986,4,256048,73.2,227376,65.0,28672,11.2
Arizona,1986,4,1557573,64.6,1452045,60.3,105528,6.8
Arkansas,1986,4,1067254,60.7,975610,55.5,91644,8.6
California,1986,4,13237362,66.3,12324785,61.7,912577,6.9
Los Angeles County,1986,4,4079562,65.5,3807331,61.2,272231,6.7
Colorado,1986,4,1701308,70.6,1579947,65.6,121361,7.1
Connecticut,1986,4,1727693,69.6,1660905,66.9,66788,3.9
Delaware,1986,4,322724,67.5,307482,64.3,15242,4.7
District of Columbia,1986,4,321512,67.0,297710,62.0,23802,7.4
Florida,1986,4,5512436,60.5,5187490,56.9,324946,5.9
Georgia,1986,4,2954307,66.7,2777338,62.7,176969,6.0
Hawaii,1986,4,490378,66.2,465909,62.9,24469,5.0
Idaho,1986,4,471376,66.8,432305,61.2,39071,8.3
Illinois,1986,4,5688350,65.6,5198587,60.0,489763,8.6
Indiana,1986,4,2732050,66.4,2540648,61.8,191402,7.0
Iowa,1986,4,1440380,67.3,1337915,62.5,102465,7.1
Kansas,1986,4,1242600,68.6,1174454,64.9,68146,5.5
Kentucky,1986,4,1705155,61.8,1546450,56.1,158705,9.3
Louisiana,1986,4,1974811,61.3,1731206,53.8,243605,12.3
Maine,1986,4,562842,63.9,532768,60.5,30074,5.3
Maryland,1986,4,2331297,69.0,2226776,65.9,104521,4.5
Massachusetts,1986,4,3062699,67.2,2938660,64.5,124039,4.0
Michigan,1986,4,4381089,64.0,3978131,58.1,402958,9.2
Minnesota,1986,4,2246242,71.2,2114675,67.0,131567,5.9
Mississippi,1986,4,1148830,61.5,1017161,54.5,131669,11.5
Missouri,1986,4,2487632,65.3,2329115,61.1,158517,6.4
Montana,1986,4,404390,67.3,371900,61.9,32490,8.0
Nebraska,1986,4,812466,69.0,771888,65.6,40578,5.0
Nevada,1986,4,526988,72.0,492980,67.3,34008,6.5
New Hampshire,1986,4,556785,71.9,540263,69.8,16522,3.0
New Jersey,1986,4,3885340,65.5,3677361,62.0,207979,5.4
New Mexico,1986,4,665056,63.3,604057,57.5,60999,9.2
New York,1986,4,8424189,61.5,7865801,57.4,558388,6.6
New York city,1986,4,3248118,56.1,2991529,51.7,256589,7.9
North Carolina,1986,4,3168411,67.2,2998278,63.6,170133,5.4
North Dakota,1986,4,331864,68.1,312609,64.2,19255,5.8
Ohio,1986,4,5211093,64.4,4772079,59.0,439014,8.4
Oklahoma,1986,4,1582486,65.4,1451414,60.0,131072,8.3
Oregon,1986,4,1357222,66.2,1240543,60.5,116679,8.6
Pennsylvania,1986,4,5632515,61.0,5217700,56.5,414815,7.4
Rhode Island,1986,4,503319,66.8,483619,64.2,19700,3.9
South Carolina,1986,4,1582036,64.6,1476589,60.3,105447,6.7
South Dakota,1986,4,348979,68.4,332374,65.2,16605,4.8
Tennessee,1986,4,2285637,63.1,2101474,58.1,184163,8.1
Texas,1986,4,8156094,68.5,7459814,62.6,696280,8.5
Utah,1986,4,747997,69.6,703770,65.5,44227,5.9
Vermont,1986,4,286604,70.6,274107,67.5,12497,4.4
Virginia,1986,4,2894740,67.6,2750217,64.3,144523,5.0
Washington,1986,4,2170478,65.5,1993784,60.2,176694,8.1
West Virginia,1986,4,747972,51.3,655983,45.0,91989,12.3
Wisconsin,1986,4,2416778,67.4,2247870,62.7,168908,7.0
Wyoming,1986,4,253302,70.6,231712,64.5,21590,8.5
Alabama,1986,5,1853587,61.8,1672576,55.8,181011,9.8
Alaska,1986,5,256261,73.0,227139,64.7,29122,11.4
Arizona,1986,5,1565157,64.8,1456592,60.3,108565,6.9
Arkansas,1986,5,1069348,60.8,977788,55.6,91560,8.6
California,1986,5,13282235,66.4,12368747,61.8,913488,6.9
Los Angeles County,1986,5,4096367,65.7,3821713,61.3,274654,6.7
Colorado,1986,5,1701372,70.5,1577561,65.4,123811,7.3
Connecticut,1986,5,1731302,69.7,1664882,67.0,66420,3.8
Delaware,1986,5,323779,67.6,308699,64.4,15080,4.7
District of Columbia,1986,5,321702,67.0,297725,62.0,23977,7.5
Florida,1986,5,5540669,60.7,5213854,57.1,326815,5.9
Georgia,1986,5,2967500,66.9,2789394,62.9,178106,6.0
Hawaii,1986,5,491253,66.1,467198,62.9,24055,4.9
Idaho,1986,5,472614,66.8,433045,61.3,39569,8.4
Illinois,1986,5,5694922,65.7,5208839,60.1,486083,8.5
Indiana,1986,5,2735893,66.5,2545575,61.9,190318,7.0
Iowa,1986,5,1441741,67.4,1340189,62.6,101552,7.0
Kansas,1986,5,1245346,68.7,1176768,64.9,68578,5.5
Kentucky,1986,5,1707421,61.9,1549369,56.2,158052,9.3
Louisiana,1986,5,1972024,61.2,1726161,53.6,245863,12.5
Maine,1986,5,564135,64.0,533973,60.5,30162,5.3
Maryland,1986,5,2341159,69.2,2235590,66.0,105569,4.5
Massachusetts,1986,5,3063493,67.2,2938850,64.4,124643,4.1
Michigan,1986,5,4389314,64.1,3985764,58.2,403550,9.2
Minnesota,1986,5,2249317,71.2,2120331,67.1,128986,5.7
Mississippi,1986,5,1151865,61.7,1018241,54.5,133624,11.6
Missouri,1986,5,2495969,65.4,2335228,61.2,160741,6.4
Montana,1986,5,404120,67.2,371688,61.8,32432,8.0
Nebraska,1986,5,812332,69.0,772613,65.6,39719,4.9
Nevada,1986,5,529017,72.2,495347,67.6,33670,6.4
New Hampshire,1986,5,557982,71.9,541905,69.8,16077,2.9
New Jersey,1986,5,3892167,65.5,3686563,62.1,205604,5.3
New Mexico,1986,5,666940,63.3,605007,57.4,61933,9.3
New York,1986,5,8431816,61.5,7877404,57.5,554412,6.6
New York city,1986,5,3245979,56.0,2992779,51.6,253200,7.8
North Carolina,1986,5,3175359,67.3,3002719,63.6,172640,5.4
North Dakota,1986,5,331822,68.1,312564,64.2,19258,5.8
Ohio,1986,5,5217189,64.4,4777575,59.0,439614,8.4
Oklahoma,1986,5,1585696,65.5,1450284,59.9,135412,8.5
Oregon,1986,5,1362101,66.4,1246173,60.7,115928,8.5
Pennsylvania,1986,5,5636390,61.0,5227981,56.6,408409,7.2
Rhode Island,1986,5,504217,67.0,484088,64.3,20129,4.0
South Carolina,1986,5,1587887,64.8,1484270,60.6,103617,6.5
South Dakota,1986,5,349322,68.4,332864,65.1,16458,4.7
Tennessee,1986,5,2289145,63.2,2105473,58.1,183672,8.0
Texas,1986,5,8163166,68.4,7447615,62.4,715551,8.8
Utah,1986,5,749970,69.7,704974,65.5,44996,6.0
Vermont,1986,5,287377,70.8,274842,67.7,12535,4.4
Virginia,1986,5,2902921,67.7,2758688,64.4,144233,5.0
Washington,1986,5,2178547,65.6,1999569,60.2,178978,8.2
West Virginia,1986,5,748903,51.4,656698,45.1,92205,12.3
Wisconsin,1986,5,2421933,67.5,2253425,62.8,168508,7.0
Wyoming,1986,5,253027,70.3,231131,64.2,21896,8.7
Alabama,1986,6,1857645,61.9,1676854,55.9,180791,9.7
Alaska,1986,6,256093,73.0,226811,64.6,29282,11.4
Arizona,1986,6,1571723,64.9,1460384,60.3,111339,7.1
Arkansas,1986,6,1071771,60.9,980382,55.7,91389,8.5
California,1986,6,13326888,66.5,12416031,62.0,910857,6.8
Los Angeles County,1986,6,4111866,65.8,3835451,61.4,276415,6.7
Colorado,1986,6,1702079,70.5,1575844,65.3,126235,7.4
Connecticut,1986,6,1734737,69.8,1668887,67.1,65850,3.8
Delaware,1986,6,324592,67.8,309979,64.7,14613,4.5
District of Columbia,1986,6,322194,67.3,298144,62.2,24050,7.5
Florida,1986,6,5569000,60.8,5240958,57.3,328042,5.9
Georgia,1986,6,2979890,67.1,2801437,63.1,178453,6.0
Hawaii,1986,6,492244,66.2,468743,63.0,23501,4.8
Idaho,1986,6,473689,67.0,433620,61.3,40069,8.5
Illinois,1986,6,5700154,65.7,5219387,60.1,480767,8.4
Indiana,1986,6,2740343,66.5,2552163,62.0,188180,6.9
Iowa,1986,6,1442748,67.4,1342761,62.8,99987,6.9
Kansas,1986,6,1248265,68.7,1179671,65.0,68594,5.5
Kentucky,1986,6,1709128,61.9,1551697,56.2,157431,9.2
Louisiana,1986,6,1970384,61.1,1722449,53.4,247935,12.6
Maine,1986,6,565466,64.1,535228,60.7,30238,5.3
Maryland,1986,6,2350416,69.4,2243861,66.2,106555,4.5
Massachusetts,1986,6,3065119,67.2,2940343,64.5,124776,4.1
Michigan,1986,6,4396624,64.2,3995725,58.3,400899,9.1
Minnesota,1986,6,2253188,71.3,2127079,67.3,126109,5.6
Mississippi,1986,6,1154327,61.8,1019711,54.6,134616,11.7
Missouri,1986,6,2504629,65.6,2342035,61.3,162594,6.5
Montana,1986,6,403929,67.3,371636,61.9,32293,8.0
Nebraska,1986,6,812440,68.9,773501,65.6,38939,4.8
Nevada,1986,6,531263,72.4,497844,67.8,33419,6.3
New Hampshire,1986,6,559161,71.9,543779,69.9,15382,2.8
New Jersey,1986,6,3899473,65.6,3697037,62.2,202436,5.2
New Mexico,1986,6,668818,63.3,606296,57.4,62522,9.3
New York,1986,6,8437555,61.5,7892708,57.6,544847,6.5
New York city,1986,6,3242569,55.9,2995720,51.6,246849,7.6
North Carolina,1986,6,3182956,67.3,3009380,63.7,173576,5.5
North Dakota,1986,6,331739,68.1,312684,64.2,19055,5.7
Ohio,1986,6,5222188,64.5,4782921,59.1,439267,8.4
Oklahoma,1986,6,1587690,65.5,1449329,59.8,138361,8.7
Oregon,1986,6,1366412,66.5,1252366,60.9,114046,8.3
Pennsylvania,1986,6,5637256,61.0,5236869,56.7,400387,7.1
Rhode Island,1986,6,505295,67.0,484691,64.3,20604,4.1
South Carolina,1986,6,1593367,65.0,1491836,60.8,101531,6.4
South Dakota,1986,6,349798,68.5,333482,65.3,16316,4.7
Tennessee,1986,6,2292909,63.3,2110061,58.2,182848,8.0
Texas,1986,6,8168629,68.4,7439417,62.3,729212,8.9
Utah,1986,6,752000,69.8,706204,65.6,45796,6.1
Vermont,1986,6,288165,70.8,275633,67.7,12532,4.3
Virginia,1986,6,2912178,67.8,2767959,64.4,144219,5.0
Washington,1986,6,2185350,65.7,2005137,60.3,180213,8.2
West Virginia,1986,6,749331,51.5,657353,45.1,91978,12.3
Wisconsin,1986,6,2427447,67.6,2260035,63.0,167412,6.9
Wyoming,1986,6,252482,70.1,230469,64.0,22013,8.7
Alabama,1986,7,1860219,62.0,1680422,56.0,179797,9.7
Alaska,1986,7,255677,72.6,226498,64.3,29179,11.4
Arizona,1986,7,1577344,65.0,1463627,60.3,113717,7.2
Arkansas,1986,7,1074453,61.0,983087,55.8,91366,8.5
California,1986,7,13370510,66.6,12464295,62.1,906215,6.8
Los Angeles County,1986,7,4126209,65.9,3848518,61.4,277691,6.7
Colorado,1986,7,1703536,70.5,1574491,65.1,129045,7.6
Connecticut,1986,7,1737642,69.8,1672531,67.2,65111,3.7
Delaware,1986,7,325177,67.7,311240,64.8,13937,4.3
District of Columbia,1986,7,322957,67.4,298898,62.4,24059,7.4
Florida,1986,7,5597129,61.0,5268334,57.4,328795,5.9
Georgia,1986,7,2991212,67.2,2813045,63.2,178167,6.0
Hawaii,1986,7,493302,66.2,470425,63.1,22877,4.6
Idaho,1986,7,474379,67.0,433916,61.3,40463,8.5
Illinois,1986,7,5703187,65.7,5229465,60.2,473722,8.3
Indiana,1986,7,2745145,66.6,2559707,62.1,185438,6.8
Iowa,1986,7,1443717,67.5,1345778,62.9,97939,6.8
Kansas,1986,7,1251185,68.8,1183095,65.1,68090,5.4
Kentucky,1986,7,1709742,61.9,1552718,56.2,157024,9.2
Louisiana,1986,7,1970313,61.1,1720383,53.3,249930,12.7
Maine,1986,7,566761,64.2,536463,60.8,30298,5.3
Maryland,1986,7,2359062,69.5,2251336,66.4,107726,4.6
Massachusetts,1986,7,3067561,67.2,2943206,64.5,124355,4.1
Michigan,1986,7,4403400,64.2,4007337,58.4,396063,9.0
Minnesota,1986,7,2256687,71.3,2133377,67.4,123310,5.5
Mississippi,1986,7,1155859,61.9,1021187,54.7,134672,11.7
Missouri,1986,7,2512751,65.7,2349197,61.4,163554,6.5
Montana,1986,7,403874,67.3,371730,62.0,32144,8.0
Nebraska,1986,7,812943,68.9,774589,65.6,38354,4.7
Nevada,1986,7,533549,72.6,500330,68.1,33219,6.2
New Hampshire,1986,7,560204,71.8,545655,70.0,14549,2.6
New Jersey,1986,7,3906459,65.6,3708242,62.3,198217,5.1
New Mexico,1986,7,670537,63.3,607725,57.4,62812,9.4
New York,1986,7,8440030,61.5,7909184,57.7,530846,6.3
New York city,1986,7,3238272,55.8,2999865,51.7,238407,7.4
North Carolina,1986,7,3190053,67.4,3016841,63.8,173212,5.4
North Dakota,1986,7,331611,68.1,312909,64.3,18702,5.6
Ohio,1986,7,5226195,64.5,4788847,59.1,437348,8.4
Oklahoma,1986,7,1588370,65.5,1448803,59.7,139567,8.8
Oregon,1986,7,1369430,66.5,1258316,61.1,111114,8.1
Pennsylvania,1986,7,5635466,61.0,5243779,56.7,391687,7.0
Rhode Island,1986,7,506453,67.2,485369,64.4,21084,4.2
South Carolina,1986,7,1598104,65.1,1498548,61.1,99556,6.2
South Dakota,1986,7,350368,68.4,334209,65.3,16159,4.6
Tennessee,1986,7,2296564,63.3,2114351,58.3,182213,7.9
Texas,1986,7,8172001,68.3,7433205,62.1,738796,9.0
Utah,1986,7,753913,69.9,707292,65.6,46621,6.2
Vermont,1986,7,288962,71.0,276448,67.9,12514,4.3
Virginia,1986,7,2922022,67.9,2777606,64.6,144416,4.9
Washington,1986,7,2191190,65.7,2010646,60.3,180544,8.2
West Virginia,1986,7,749145,51.5,657837,45.2,91308,12.2
Wisconsin,1986,7,2433136,67.8,2267505,63.1,165631,6.8
Wyoming,1986,7,251716,69.9,229712,63.8,22004,8.7
Alabama,1986,8,1861412,61.9,1682856,56.0,178556,9.6
Alaska,1986,8,255116,72.7,226191,64.4,28925,11.3
Arizona,1986,8,1581947,64.9,1466267,60.2,115680,7.3
Arkansas,1986,8,1077020,61.1,985371,55.9,91649,8.5
California,1986,8,13410882,66.7,12509310,62.2,901572,6.7
Los Angeles County,1986,8,4138214,66.0,3859675,61.5,278539,6.7
Colorado,1986,8,1705656,70.5,1573252,65.0,132404,7.8
Connecticut,1986,8,1739809,69.9,1675458,67.3,64351,3.7
Delaware,1986,8,325664,67.7,312477,65.0,13187,4.0
District of Columbia,1986,8,323799,67.6,299742,62.6,24057,7.4
Florida,1986,8,5623662,61.1,5294474,57.6,329188,5.9
Georgia,1986,8,3000847,67.3,2823316,63.3,177531,5.9
Hawaii,1986,8,494377,66.2,472113,63.2,22264,4.5
Idaho,1986,8,474568,67.0,433933,61.3,40635,8.6
Illinois,1986,8,5703859,65.7,5237735,60.3,466124,8.2
Indiana,1986,8,2749647,66.7,2566589,62.3,183058,6.7
Iowa,1986,8,1444598,67.6,1348788,63.1,95810,6.6
Kansas,1986,8,1253979,68.9,1186676,65.2,67303,5.4
Kentucky,1986,8,1709125,61.9,1552161,56.2,156964,9.2
Louisiana,1986,8,1971197,61.1,1719444,53.3,251753,12.8
Maine,1986,8,567896,64.2,537590,60.8,30306,5.3
Maryland,1986,8,2366873,69.7,2257729,66.4,109144,4.6
Massachusetts,1986,8,3070162,67.2,2946628,64.5,123534,4.0
Michigan,1986,8,4410616,64.2,4020004,58.6,390612,8.9
Minnesota,1986,8,2258906,71.3,2137987,67.5,120919,5.4
Mississippi,1986,8,1156184,61.9,1022073,54.7,134111,11.6
Missouri,1986,8,2519658,65.8,2356054,61.5,163604,6.5
Montana,1986,8,403933,67.3,371894,62.0,32039,7.9
Nebraska,1986,8,813736,69.0,775758,65.7,37978,4.7
Nevada,1986,8,535747,72.6,502654,68.1,33093,6.2
New Hampshire,1986,8,561119,71.8,547351,70.0,13768,2.5
New Jersey,1986,8,3911809,65.6,3718941,62.4,192868,4.9
New Mexico,1986,8,672010,63.4,609036,57.5,62974,9.4
New York,1986,8,8438876,61.5,7923797,57.8,515079,6.1
New York city,1986,8,3234121,55.7,3004445,51.7,229676,7.1
North Carolina,1986,8,3196521,67.5,3024164,63.8,172357,5.4
North Dakota,1986,8,331445,68.1,313150,64.3,18295,5.5
Ohio,1986,8,5229833,64.5,4795482,59.2,434351,8.3
Oklahoma,1986,8,1587465,65.5,1448411,59.8,139054,8.8
Oregon,1986,8,1371134,66.6,1263596,61.3,107538,7.8
Pennsylvania,1986,8,5631113,60.9,5247871,56.7,383242,6.8
Rhode Island,1986,8,507568,67.2,486071,64.4,21497,4.2
South Carolina,1986,8,1601797,65.2,1503828,61.2,97969,6.1
South Dakota,1986,8,350911,68.5,334924,65.4,15987,4.6
Tennessee,1986,8,2299457,63.3,2117534,58.3,181923,7.9
Texas,1986,8,8185040,68.4,7438263,62.2,746777,9.1
Utah,1986,8,755508,70.0,708051,65.6,47457,6.3
Vermont,1986,8,289728,71.0,277209,67.9,12519,4.3
Virginia,1986,8,2931754,68.0,2787028,64.7,144726,4.9
Washington,1986,8,2196579,65.8,2016198,60.4,180381,8.2
West Virginia,1986,8,748396,51.4,658029,45.2,90367,12.1
Wisconsin,1986,8,2439012,67.9,2275479,63.3,163533,6.7
Wyoming,1986,8,250843,69.9,228870,63.8,21973,8.8
Alabama,1986,9,1861591,61.9,1684084,56.0,177507,9.5
Alaska,1986,9,254500,72.5,225880,64.4,28620,11.2
Arizona,1986,9,1585503,64.9,1468182,60.1,117321,7.4
Arkansas,1986,9,1079062,61.1,986946,55.9,92116,8.5
California,1986,9,13446724,66.7,12548948,62.3,897776,6.7
Los Angeles County,1986,9,4147144,66.0,3868482,61.6,278662,6.7
Colorado,1986,9,1707802,70.5,1571972,64.9,135830,8.0
Connecticut,1986,9,1741278,69.9,1677550,67.3,63728,3.7
Delaware,1986,9,326198,67.7,313742,65.1,12456,3.8
District of Columbia,1986,9,324502,67.9,300429,62.9,24073,7.4
Florida,1986,9,5647986,61.3,5318670,57.7,329316,5.8
Georgia,1986,9,3008738,67.3,2831891,63.4,176847,5.9
Hawaii,1986,9,495397,66.2,473704,63.3,21693,4.4
Idaho,1986,9,474338,66.9,433790,61.2,40548,8.5
Illinois,1986,9,5702810,65.6,5243864,60.3,458946,8.0
Indiana,1986,9,2752774,66.7,2570871,62.3,181903,6.6
Iowa,1986,9,1445459,67.6,1351655,63.2,93804,6.5
Kansas,1986,9,1256583,69.0,1189994,65.4,66589,5.3
Kentucky,1986,9,1707556,61.8,1550435,56.1,157121,9.2
Louisiana,1986,9,1972110,61.2,1719053,53.4,253057,12.8
Maine,1986,9,568811,64.2,538580,60.8,30231,5.3
Maryland,1986,9,2373744,69.8,2263242,66.5,110502,4.7
Massachusetts,1986,9,3072271,67.2,2949750,64.6,122521,4.0
Michigan,1986,9,4419168,64.3,4033613,58.7,385555,8.7
Minnesota,1986,9,2260128,71.3,2140855,67.5,119273,5.3
Mississippi,1986,9,1155466,61.8,1022008,54.7,133458,11.6
Missouri,1986,9,2525171,65.9,2362055,61.6,163116,6.5
Montana,1986,9,404073,67.3,372035,62.0,32038,7.9
Nebraska,1986,9,814637,69.0,776854,65.8,37783,4.6
Nevada,1986,9,537861,72.7,504720,68.2,33141,6.2
New Hampshire,1986,9,562057,71.7,548870,70.0,13187,2.3
New Jersey,1986,9,3914550,65.6,3727972,62.5,186578,4.8
New Mexico,1986,9,673155,63.4,609999,57.4,63156,9.4
New York,1986,9,8435265,61.5,7935441,57.8,499824,5.9
New York city,1986,9,3230859,55.6,3008646,51.8,222213,6.9
North Carolina,1986,9,3202774,67.5,3031293,63.9,171481,5.4
North Dakota,1986,9,331274,68.2,313346,64.5,17928,5.4
Ohio,1986,9,5233942,64.5,4802813,59.2,431129,8.2
Oklahoma,1986,9,1584994,65.4,1447837,59.8,137157,8.7
Oregon,1986,9,1371981,66.5,1268437,61.5,103544,7.5
Pennsylvania,1986,9,5625144,60.8,5249840,56.7,375304,6.7
Rhode Island,1986,9,508425,67.3,486765,64.4,21660,4.3
South Carolina,1986,9,1604785,65.2,1507788,61.3,96997,6.0
South Dakota,1986,9,351329,68.5,335513,65.4,15816,4.5
Tennessee,1986,9,2301500,63.3,2120013,58.3,181487,7.9
Texas,1986,9,8173170,68.3,7419112,62.0,754058,9.2
Utah,1986,9,756682,70.1,708376,65.6,48306,6.4
Vermont,1986,9,290419,71.2,277859,68.1,12560,4.3
Virginia,1986,9,2941090,68.1,2796181,64.8,144909,4.9
Washington,1986,9,2201973,65.8,2021881,60.5,180092,8.2
West Virginia,1986,9,747322,51.4,658029,45.3,89293,11.9
Wisconsin,1986,9,2445093,68.0,2283511,63.5,161582,6.6
Wyoming,1986,9,249986,69.8,227970,63.7,22016,8.8
Alabama,1986,10,1861374,61.8,1684820,56.0,176554,9.5
Alaska,1986,10,253889,72.5,225581,64.5,28308,11.1
Arizona,1986,10,1588207,64.8,1469810,60.0,118397,7.5
Arkansas,1986,10,1080195,61.2,987725,55.9,92470,8.6
California,1986,10,13477934,66.7,12584328,62.3,893606,6.6
Los Angeles County,1986,10,4153432,66.0,3875726,61.6,277706,6.7
Colorado,1986,10,1709525,70.6,1570664,64.8,138861,8.1
Connecticut,1986,10,1742137,69.9,1678928,67.3,63209,3.6
Delaware,1986,10,326865,67.7,315071,65.2,11794,3.6
District of Columbia,1986,10,325014,68.0,300944,63.0,24070,7.4
Florida,1986,10,5670781,61.4,5341652,57.8,329129,5.8
Georgia,1986,10,3015428,67.3,2839195,63.4,176233,5.8
Hawaii,1986,10,496410,66.2,475232,63.4,21178,4.3
Idaho,1986,10,473803,66.8,433554,61.2,40249,8.5
Illinois,1986,10,5700687,65.5,5248416,60.3,452271,7.9
Indiana,1986,10,2753410,66.7,2571678,62.3,181732,6.6
Iowa,1986,10,1446917,67.7,1354962,63.4,91955,6.4
Kansas,1986,10,1258724,69.1,1192736,65.5,65988,5.2
Kentucky,1986,10,1705547,61.7,1548423,56.0,157124,9.2
Louisiana,1986,10,1972131,61.3,1718646,53.4,253485,12.9
Maine,1986,10,569614,64.2,539588,60.8,30026,5.3
Maryland,1986,10,2379619,69.8,2268339,66.6,111280,4.7
Massachusetts,1986,10,3073505,67.2,2952186,64.6,121319,3.9
Michigan,1986,10,4429579,64.4,4048176,58.9,381403,8.6
Minnesota,1986,10,2261184,71.2,2142636,67.5,118548,5.2
Mississippi,1986,10,1154312,61.7,1021434,54.6,132878,11.5
Missouri,1986,10,2529333,65.9,2366905,61.7,162428,6.4
Montana,1986,10,404218,67.5,372147,62.1,32071,7.9
Nebraska,1986,10,815445,69.1,777753,65.9,37692,4.6
Nevada,1986,10,539910,72.7,506563,68.2,33347,6.2
New Hampshire,1986,10,563227,71.7,550359,70.0,12868,2.3
New Jersey,1986,10,3915322,65.6,3735312,62.6,180010,4.6
New Mexico,1986,10,673919,63.4,610609,57.4,63310,9.4
New York,1986,10,8431745,61.4,7946109,57.9,485636,5.8
New York city,1986,10,3229060,55.5,3012713,51.8,216347,6.7
North Carolina,1986,10,3209050,67.6,3038743,64.0,170307,5.3
North Dakota,1986,10,331122,68.1,313476,64.5,17646,5.3
Ohio,1986,10,5238855,64.6,4810820,59.3,428035,8.2
Oklahoma,1986,10,1581289,65.4,1447021,59.8,134268,8.5
Oregon,1986,10,1372548,66.5,1273231,61.7,99317,7.2
Pennsylvania,1986,10,5617941,60.7,5250581,56.7,367360,6.5
Rhode Island,1986,10,508918,67.3,487408,64.5,21510,4.2
South Carolina,1986,10,1607536,65.2,1510826,61.3,96710,6.0
South Dakota,1986,10,351562,68.5,335916,65.5,15646,4.5
Tennessee,1986,10,2303288,63.3,2123029,58.3,180259,7.8
Texas,1986,10,8194607,68.4,7435506,62.1,759101,9.3
Utah,1986,10,757454,70.1,708360,65.6,49094,6.5
Vermont,1986,10,291003,71.1,278393,68.1,12610,4.3
Virginia,1986,10,2949962,68.2,2805256,64.8,144706,4.9
Washington,1986,10,2207628,65.9,2027880,60.5,179748,8.1
West Virginia,1986,10,746249,51.3,658065,45.3,88184,11.8
Wisconsin,1986,10,2451364,68.1,2291278,63.7,160086,6.5
Wyoming,1986,10,249294,69.8,227084,63.6,22210,8.9
Alabama,1986,11,1861124,61.7,1685756,55.9,175368,9.4
Alaska,1986,11,253222,72.6,225220,64.5,28002,11.1
Arizona,1986,11,1590292,64.7,1471560,59.9,118732,7.5
Arkansas,1986,11,1080342,61.1,987769,55.9,92573,8.6
California,1986,11,13505030,66.8,12616408,62.4,888622,6.6
Los Angeles County,1986,11,4157760,66.0,3881738,61.6,276022,6.6
Colorado,1986,11,1710463,70.5,1569234,64.7,141229,8.3
Connecticut,1986,11,1742699,69.9,1679923,67.4,62776,3.6
Delaware,1986,11,327713,67.7,316457,65.4,11256,3.4
District of Columbia,1986,11,325398,68.2,301407,63.2,23991,7.4
Florida,1986,11,5692402,61.4,5363721,57.9,328681,5.8
Georgia,1986,11,3020879,67.3,2845214,63.4,175665,5.8
Hawaii,1986,11,497537,66.2,476811,63.5,20726,4.2
Idaho,1986,11,473141,66.7,433222,61.1,39919,8.4
Illinois,1986,11,5698653,65.5,5251353,60.3,447300,7.8
Indiana,1986,11,2751534,66.6,2569567,62.2,181967,6.6
Iowa,1986,11,1449116,67.8,1358765,63.6,90351,6.2
Kansas,1986,11,1260168,69.1,1194564,65.5,65604,5.2
Kentucky,1986,11,1703716,61.6,1546933,55.9,156783,9.2
Louisiana,1986,11,1970571,61.3,1717624,53.4,252947,12.8
Maine,1986,11,570484,64.2,540853,60.9,29631,5.2
Maryland,1986,11,2384242,69.9,2273041,66.6,111201,4.7
Massachusetts,1986,11,3073694,67.2,2953651,64.6,120043,3.9
Michigan,1986,11,4441220,64.5,4062611,59.0,378609,8.5
Minnesota,1986,11,2262824,71.2,2144175,67.5,118649,5.2
Mississippi,1986,11,1153136,61.6,1020919,54.6,132217,11.5
Missouri,1986,11,2532602,66.0,2370302,61.7,162300,6.4
Montana,1986,11,404282,67.5,372197,62.1,32085,7.9
Nebraska,1986,11,815731,69.1,778222,66.0,37509,4.6
Nevada,1986,11,541845,72.7,508201,68.2,33644,6.2
New Hampshire,1986,11,564742,71.7,552008,70.1,12734,2.3
New Jersey,1986,11,3915385,65.6,3741189,62.6,174196,4.4
New Mexico,1986,11,674287,63.4,610879,57.4,63408,9.4
New York,1986,11,8430015,61.4,7957039,57.9,472976,5.6
New York city,1986,11,3228669,55.5,3016926,51.9,211743,6.6
North Carolina,1986,11,3215970,67.6,3046995,64.1,168975,5.3
North Dakota,1986,11,330996,68.1,313522,64.5,17474,5.3
Ohio,1986,11,5243746,64.6,4818469,59.3,425277,8.1
Oklahoma,1986,11,1576768,65.2,1445816,59.8,130952,8.3
Oregon,1986,11,1373358,66.4,1277997,61.8,95361,6.9
Pennsylvania,1986,11,5609899,60.6,5250362,56.7,359537,6.4
Rhode Island,1986,11,509221,67.3,488011,64.5,21210,4.2
South Carolina,1986,11,1610240,65.2,1513030,61.3,97210,6.0
South Dakota,1986,11,351602,68.5,336091,65.5,15511,4.4
Tennessee,1986,11,2305174,63.2,2126851,58.3,178323,7.7
Texas,1986,11,8211332,68.5,7450494,62.2,760838,9.3
Utah,1986,11,757864,70.1,708070,65.5,49794,6.6
Vermont,1986,11,291451,71.3,278834,68.2,12617,4.3
Virginia,1986,11,2958059,68.2,2814007,64.9,144052,4.9
Washington,1986,11,2213403,66.0,2034052,60.6,179351,8.1
West Virginia,1986,11,745412,51.3,658203,45.3,87209,11.7
Wisconsin,1986,11,2457528,68.3,2298548,63.8,158980,6.5
Wyoming,1986,11,248724,69.9,226245,63.6,22479,9.0
Alabama,1986,12,1861334,61.7,1687738,55.9,173596,9.3
Alaska,1986,12,252450,72.3,224778,64.4,27672,11.0
Arizona,1986,12,1592429,64.6,1474252,59.8,118177,7.4
Arkansas,1986,12,1080184,61.1,987836,55.8,92348,8.5
California,1986,12,13532050,66.8,12650246,62.4,881804,6.5
Los Angeles County,1986,12,4162025,66.0,3888059,61.6,273966,6.6
Colorado,1986,12,1710878,70.5,1568275,64.6,142603,8.3
Connecticut,1986,12,1743584,69.9,1681268,67.4,62316,3.6
Delaware,1986,12,328771,67.8,317902,65.5,10869,3.3
District of Columbia,1986,12,325742,68.3,301976,63.3,23766,7.3
Florida,1986,12,5714434,61.5,5386564,58.0,327870,5.7
Georgia,1986,12,3025365,67.3,2850769,63.4,174596,5.8
Hawaii,1986,12,499085,66.3,478712,63.6,20373,4.1
Idaho,1986,12,472662,66.7,433041,61.1,39621,8.4
Illinois,1986,12,5699403,65.5,5254569,60.3,444834,7.8
Indiana,1986,12,2749087,66.5,2567166,62.1,181921,6.6
Iowa,1986,12,1452012,67.9,1363068,63.8,88944,6.1
Kansas,1986,12,1261022,69.1,1195707,65.6,65315,5.2
Kentucky,1986,12,1702696,61.5,1546755,55.9,155941,9.2
Louisiana,1986,12,1967640,61.2,1716444,53.4,251196,12.8
Maine,1986,12,571727,64.3,542715,61.0,29012,5.1
Maryland,1986,12,2388058,69.9,2277780,66.6,110278,4.6
Massachusetts,1986,12,3073925,67.2,2955314,64.6,118611,3.9
Michigan,1986,12,4453597,64.6,4076733,59.2,376864,8.5
Minnesota,1986,12,2265802,71.3,2146632,67.5,119170,5.3
Mississippi,1986,12,1152245,61.6,1021120,54.5,131125,11.4
Missouri,1986,12,2536054,66.0,2372903,61.7,163151,6.4
Montana,1986,12,404327,67.5,372337,62.2,31990,7.9
Nebraska,1986,12,815401,69.1,778286,66.0,37115,4.6
Nevada,1986,12,543785,72.7,509792,68.2,33993,6.3
New Hampshire,1986,12,566687,71.7,554049,70.1,12638,2.2
New Jersey,1986,12,3916733,65.5,3747174,62.7,169559,4.3
New Mexico,1986,12,674454,63.3,611065,57.4,63389,9.4
New York,1986,12,8431729,61.4,7970654,58.0,461075,5.5
New York city,1986,12,3229629,55.5,3022416,51.9,207213,6.4
North Carolina,1986,12,3224206,67.7,3057013,64.2,167193,5.2
North Dakota,1986,12,330926,68.2,313560,64.7,17366,5.2
Ohio,1986,12,5248829,64.6,4826664,59.4,422165,8.0
Oklahoma,1986,12,1572339,65.1,1444751,59.8,127588,8.1
Oregon,1986,12,1374717,66.4,1282763,62.0,91954,6.7
Pennsylvania,1986,12,5603762,60.5,5251885,56.7,351877,6.3
Rhode Island,1986,12,509623,67.2,488695,64.5,20928,4.1
South Carolina,1986,12,1613276,65.3,1515018,61.3,98258,6.1
South Dakota,1986,12,351578,68.5,336154,65.5,15424,4.4
Tennessee,1986,12,2307689,63.2,2131700,58.4,175989,7.6
Texas,1986,12,8223804,68.6,7465616,62.3,758188,9.2
Utah,1986,12,758124,70.1,707754,65.4,50370,6.6
Vermont,1986,12,291855,71.2,279309,68.1,12546,4.3
Virginia,1986,12,2965781,68.3,2822754,65.0,143027,4.8
Washington,1986,12,2219475,66.0,2040756,60.7,178719,8.1
West Virginia,1986,12,744833,51.3,658424,45.3,86409,11.6
Wisconsin,1986,12,2463668,68.4,2305955,64.0,157713,6.4
Wyoming,1986,12,248187,69.9,225536,63.5,22651,9.1
Alabama,1987,1,1861861,61.6,1690980,56.0,170881,9.2
Alaska,1987,1,251717,72.3,224368,64.5,27349,10.9
Arizona,1987,1,1594908,64.5,1478208,59.8,116700,7.3
Arkansas,1987,1,1080414,61.0,988598,55.8,91816,8.5
California,1987,1,13560957,66.8,12689035,62.5,871922,6.4
Los Angeles County,1987,1,4167682,66.0,3896180,61.7,271502,6.5
Colorado,1987,1,1710894,70.4,1568030,64.6,142864,8.4
Connecticut,1987,1,1744756,69.8,1683097,67.4,61659,3.5
Delaware,1987,1,329830,67.9,319225,65.7,10605,3.2
District of Columbia,1987,1,326199,68.4,302848,63.5,23351,7.2
Florida,1987,1,5737103,61.6,5410799,58.1,326304,5.7
Georgia,1987,1,3028961,67.2,2856439,63.4,172522,5.7
Hawaii,1987,1,501132,66.5,480983,63.8,20149,4.0
Idaho,1987,1,472425,66.5,433154,61.0,39271,8.3
Illinois,1987,1,5704599,65.5,5259915,60.4,444684,7.8
Indiana,1987,1,2747720,66.4,2566452,62.0,181268,6.6
Iowa,1987,1,1454941,68.1,1367296,64.0,87645,6.0
Kansas,1987,1,1261457,69.1,1196573,65.6,64884,5.1
Kentucky,1987,1,1702452,61.5,1547920,55.9,154532,9.1
Louisiana,1987,1,1963911,61.2,1715624,53.4,248287,12.6
Maine,1987,1,573470,64.4,545161,61.2,28309,4.9
Maryland,1987,1,2391172,69.9,2282500,66.7,108672,4.5
Massachusetts,1987,1,3075217,67.2,2958401,64.6,116816,3.8
Michigan,1987,1,4465828,64.7,4090017,59.3,375811,8.4
Minnesota,1987,1,2270111,71.3,2150333,67.6,119778,5.3
Mississippi,1987,1,1151570,61.5,1022265,54.6,129305,11.2
Missouri,1987,1,2539953,66.0,2375472,61.7,164481,6.5
Montana,1987,1,404256,67.5,372541,62.2,31715,7.8
Nebraska,1987,1,814665,69.0,778069,65.9,36596,4.5
Nevada,1987,1,545769,72.8,511445,68.2,34324,6.3
New Hampshire,1987,1,568919,71.7,556397,70.2,12522,2.2
New Jersey,1987,1,3920525,65.5,3754351,62.8,166174,4.2
New Mexico,1987,1,674533,63.2,611367,57.3,63166,9.4
New York,1987,1,8436752,61.4,7987333,58.1,449419,5.3
New York city,1987,1,3231028,55.5,3028993,52.0,202035,6.3
North Carolina,1987,1,3233810,67.8,3068715,64.3,165095,5.1
North Dakota,1987,1,330862,68.2,313626,64.7,17236,5.2
Ohio,1987,1,5253817,64.6,4835881,59.5,417936,8.0
Oklahoma,1987,1,1568422,65.0,1443991,59.8,124431,7.9
Oregon,1987,1,1376463,66.5,1287273,62.2,89190,6.5
Pennsylvania,1987,1,5601833,60.4,5257372,56.7,344461,6.1
Rhode Island,1987,1,510235,67.2,489498,64.5,20737,4.1
South Carolina,1987,1,1616870,65.3,1517653,61.3,99217,6.1
South Dakota,1987,1,351570,68.4,336194,65.4,15376,4.4
Tennessee,1987,1,2311050,63.2,2137496,58.5,173554,7.5
Texas,1987,1,8232849,68.7,7482045,62.4,750804,9.1
Utah,1987,1,758297,70.0,707567,65.3,50730,6.7
Vermont,1987,1,292245,71.3,279856,68.3,12389,4.2
Virginia,1987,1,2972774,68.3,2831285,65.1,141489,4.8
Washington,1987,1,2225660,66.1,2048163,60.8,177497,8.0
West Virginia,1987,1,744229,51.2,658578,45.3,85651,11.5
Wisconsin,1987,1,2469596,68.5,2313562,64.2,156034,6.3
Wyoming,1987,1,247599,69.9,224979,63.6,22620,9.1
Alabama,1987,2,1862425,61.6,1695213,56.1,167212,9.0
Alaska,1987,2,251062,72.4,224049,64.6,27013,10.8
Arizona,1987,2,1597440,64.4,1483020,59.8,114420,7.2
Arkansas,1987,2,1081362,61.0,990342,55.9,91020,8.4
California,1987,2,13590735,66.8,12732450,62.6,858285,6.3
Los Angeles County,1987,2,4175374,66.0,3907087,61.8,268287,6.4
Colorado,1987,2,1709720,70.4,1567759,64.5,141961,8.3
Connecticut,1987,2,1745618,69.9,1684916,67.4,60702,3.5
Delaware,1987,2,330689,68.0,320258,65.9,10431,3.2
District of Columbia,1987,2,326803,68.7,304027,63.9,22776,7.0
Florida,1987,2,5759958,61.7,5435926,58.3,324032,5.6
Georgia,1987,2,3031724,67.1,2862096,63.4,169628,5.6
Hawaii,1987,2,503459,66.6,483458,63.9,20001,4.0
Idaho,1987,2,472282,66.5,433450,61.0,38832,8.2
Illinois,1987,2,5713883,65.5,5268244,60.4,445639,7.8
Indiana,1987,2,2747454,66.3,2567384,62.0,180070,6.6
Iowa,1987,2,1457252,68.2,1370779,64.1,86473,5.9
Kansas,1987,2,1261601,69.1,1197370,65.6,64231,5.1
Kentucky,1987,2,1702600,61.5,1550126,56.0,152474,9.0
Louisiana,1987,2,1960071,61.1,1715560,53.5,244511,12.5
Maine,1987,2,575437,64.5,547858,61.4,27579,4.8
Maryland,1987,2,2393311,69.8,2286530,66.7,106781,4.5
Massachusetts,1987,2,3077991,67.2,2963412,64.7,114579,3.7
Michigan,1987,2,4477002,64.8,4101173,59.4,375829,8.4
Minnesota,1987,2,2274688,71.4,2154615,67.6,120073,5.3
Mississippi,1987,2,1150890,61.4,1024191,54.7,126699,11.0
Missouri,1987,2,2544061,66.1,2378262,61.8,165799,6.5
Montana,1987,2,403901,67.5,372613,62.3,31288,7.7
Nebraska,1987,2,813781,68.9,777744,65.9,36037,4.4
Nevada,1987,2,547689,72.7,513123,68.1,34566,6.3
New Hampshire,1987,2,571263,71.9,558859,70.3,12404,2.2
New Jersey,1987,2,3926431,65.6,3762453,62.9,163978,4.2
New Mexico,1987,2,674449,63.2,611818,57.3,62631,9.3
New York,1987,2,8443338,61.4,8005336,58.2,438002,5.2
New York city,1987,2,3231865,55.5,3035442,52.1,196423,6.1
North Carolina,1987,2,3243349,67.9,3080968,64.5,162381,5.0
North Dakota,1987,2,330771,68.2,313737,64.7,17034,5.1
Ohio,1987,2,5257262,64.6,4845181,59.5,412081,7.8
Oklahoma,1987,2,1565013,64.9,1443237,59.9,121776,7.8
Oregon,1987,2,1378405,66.5,1291389,62.3,87016,6.3
Pennsylvania,1987,2,5604968,60.4,5267204,56.8,337764,6.0
Rhode Island,1987,2,510997,67.3,490404,64.6,20593,4.0
South Carolina,1987,2,1620643,65.3,1521339,61.3,99304,6.1
South Dakota,1987,2,351574,68.4,336232,65.4,15342,4.4
Tennessee,1987,2,2315094,63.3,2144145,58.6,170949,7.4
Texas,1987,2,8238817,68.7,7498891,62.5,739926,9.0
Utah,1987,2,758236,70.0,707431,65.3,50805,6.7
Vermont,1987,2,292575,71.2,280415,68.2,12160,4.2
Virginia,1987,2,2978558,68.3,2839386,65.1,139172,4.7
Washington,1987,2,2231424,66.2,2056082,61.0,175342,7.9
West Virginia,1987,2,743460,51.2,658603,45.4,84857,11.4
Wisconsin,1987,2,2474813,68.6,2321022,64.3,153791,6.2
Wyoming,1987,2,246754,69.9,224478,63.6,22276,9.0
Alabama,1987,3,1863312,61.6,1700251,56.2,163061,8.8
Alaska,1987,3,250418,72.2,223778,64.5,26640,10.6
Arizona,1987,3,1600407,64.3,1488808,59.8,111599,7.0
Arkansas,1987,3,1083254,61.1,993055,56.0,90199,8.3
California,1987,3,13622652,66.8,12780431,62.7,842221,6.2
Los Angeles County,1987,3,4185893,66.1,3921630,61.9,264263,6.3
Colorado,1987,3,1707372,70.2,1567455,64.5,139917,8.2
Connecticut,1987,3,1746388,69.8,1686926,67.5,59462,3.4
Delaware,1987,3,331289,68.0,320978,65.9,10311,3.1
District of Columbia,1987,3,327643,68.8,305506,64.2,22137,6.8
Florida,1987,3,5783385,61.8,5461674,58.4,321711,5.6
Georgia,1987,3,3034405,67.1,2867682,63.4,166723,5.5
Hawaii,1987,3,505835,66.8,485942,64.2,19893,3.9
Idaho,1987,3,472209,66.5,433902,61.1,38307,8.1
Illinois,1987,3,5727189,65.6,5280767,60.5,446422,7.8
Indiana,1987,3,2747853,66.3,2569253,62.0,178600,6.5
Iowa,1987,3,1458743,68.3,1373324,64.3,85419,5.9
Kansas,1987,3,1261890,69.1,1198479,65.6,63411,5.0
Kentucky,1987,3,1702987,61.5,1553108,56.1,149879,8.8
Louisiana,1987,3,1957182,61.0,1716609,53.5,240573,12.3
Maine,1987,3,577561,64.7,550716,61.7,26845,4.6
Maryland,1987,3,2394803,69.8,2289745,66.7,105058,4.4
Massachusetts,1987,3,3082660,67.3,2970674,64.9,111986,3.6
Michigan,1987,3,4487861,64.9,4110164,59.5,377697,8.4
Minnesota,1987,3,2278848,71.5,2158820,67.7,120028,5.3
Mississippi,1987,3,1150431,61.4,1026730,54.8,123701,10.8
Missouri,1987,3,2548564,66.1,2381639,61.8,166925,6.5
Montana,1987,3,403327,67.4,372519,62.3,30808,7.6
Nebraska,1987,3,813172,68.9,777588,65.8,35584,4.4
Nevada,1987,3,549580,72.8,514871,68.2,34709,6.3
New Hampshire,1987,3,573740,72.0,561452,70.4,12288,2.1
New Jersey,1987,3,3934333,65.7,3771533,63.0,162800,4.1
New Mexico,1987,3,674374,63.1,612468,57.3,61906,9.2
New York,1987,3,8452127,61.5,8024923,58.4,427204,5.1
New York city,1987,3,3232981,55.5,3041952,52.2,191029,5.9
North Carolina,1987,3,3251993,68.0,3092949,64.7,159044,4.9
North Dakota,1987,3,330704,68.3,313925,64.9,16779,5.1
Ohio,1987,3,5259257,64.6,4854104,59.6,405153,7.7
Oklahoma,1987,3,1562109,64.9,1442807,59.9,119302,7.6
Oregon,1987,3,1380573,66.5,1295346,62.4,85227,6.2
Pennsylvania,1987,3,5613276,60.5,5280834,56.9,332442,5.9
Rhode Island,1987,3,511911,67.4,491471,64.7,20440,4.0
South Carolina,1987,3,1623935,65.4,1525964,61.5,97971,6.0
South Dakota,1987,3,351642,68.4,336325,65.4,15317,4.4
Tennessee,1987,3,2319272,63.3,2151028,58.7,168244,7.3
Texas,1987,3,8244929,68.7,7516203,62.6,728726,8.8
Utah,1987,3,757976,69.9,707389,65.3,50587,6.7
Vermont,1987,3,292917,71.3,281016,68.4,11901,4.1
Virginia,1987,3,2983813,68.3,2847521,65.2,136292,4.6
Washington,1987,3,2236821,66.2,2064526,61.1,172295,7.7
West Virginia,1987,3,742633,51.1,658559,45.4,84074,11.3
Wisconsin,1987,3,2479426,68.7,2328319,64.5,151107,6.1
Wyoming,1987,3,245633,69.8,223970,63.6,21663,8.8
Alabama,1987,4,1864450,61.5,1705678,56.3,158772,8.5
Alaska,1987,4,249740,72.2,223518,64.6,26222,10.5
Arizona,1987,4,1603708,64.3,1495318,59.9,108390,6.8
Arkansas,1987,4,1085865,61.2,996366,56.1,89499,8.2
California,1987,4,13656227,66.8,12831117,62.8,825110,6.0
Los Angeles County,1987,4,4198491,66.2,3939186,62.1,259305,6.2
Colorado,1987,4,1704273,70.0,1567506,64.4,136767,8.0
Connecticut,1987,4,1747341,69.8,1689385,67.5,57956,3.3
Delaware,1987,4,331602,68.0,321402,65.9,10200,3.1
District of Columbia,1987,4,328506,69.2,306995,64.6,21511,6.5
Florida,1987,4,5806771,61.9,5487381,58.5,319390,5.5
Georgia,1987,4,3037576,67.0,2873009,63.4,164567,5.4
Hawaii,1987,4,507965,66.9,488196,64.3,19769,3.9
Idaho,1987,4,472117,66.5,434464,61.2,37653,8.0
Illinois,1987,4,5743104,65.8,5297834,60.7,445270,7.8
Indiana,1987,4,2748547,66.2,2571749,62.0,176798,6.4
Iowa,1987,4,1459354,68.3,1374943,64.3,84411,5.8
Kansas,1987,4,1262588,69.0,1200074,65.6,62514,5.0
Kentucky,1987,4,1702918,61.4,1556132,56.1,146786,8.6
Louisiana,1987,4,1955201,61.0,1718544,53.7,236657,12.1
Maine,1987,4,580005,64.9,553817,61.9,26188,4.5
Maryland,1987,4,2396157,69.7,2292512,66.7,103645,4.3
Massachusetts,1987,4,3088816,67.4,2979767,65.0,109049,3.5
Michigan,1987,4,4498776,65.0,4118083,59.5,380693,8.5
Minnesota,1987,4,2281912,71.5,2162206,67.8,119706,5.2
Mississippi,1987,4,1150229,61.3,1029572,54.9,120657,10.5
Missouri,1987,4,2552910,66.2,2385713,61.8,167197,6.5
Montana,1987,4,402572,67.3,372222,62.2,30350,7.5
Nebraska,1987,4,813009,68.8,777693,65.9,35316,4.3
Nevada,1987,4,551472,72.8,516714,68.2,34758,6.3
New Hampshire,1987,4,576245,72.1,564063,70.6,12182,2.1
New Jersey,1987,4,3943156,65.8,3780955,63.1,162201,4.1
New Mexico,1987,4,674472,63.0,613303,57.3,61169,9.1
New York,1987,4,8461776,61.5,8044668,58.5,417108,4.9
New York city,1987,4,3234879,55.5,3048985,52.3,185894,5.7
North Carolina,1987,4,3259248,68.0,3103728,64.8,155520,4.8
North Dakota,1987,4,330676,68.3,314164,64.9,16512,5.0
Ohio,1987,4,5259836,64.6,4862942,59.7,396894,7.5
Oklahoma,1987,4,1559174,64.8,1442799,60.0,116375,7.5
Oregon,1987,4,1382880,66.5,1299107,62.5,83773,6.1
Pennsylvania,1987,4,5624773,60.6,5296344,57.0,328429,5.8
Rhode Island,1987,4,512964,67.4,492731,64.7,20233,3.9
South Carolina,1987,4,1626098,65.4,1530966,61.6,95132,5.9
South Dakota,1987,4,351789,68.4,336497,65.5,15292,4.3
Tennessee,1987,4,2322879,63.3,2157426,58.8,165453,7.1
Texas,1987,4,8252958,68.7,7533930,62.8,719028,8.7
Utah,1987,4,757483,69.8,707458,65.2,50025,6.6
Vermont,1987,4,293357,71.2,281725,68.4,11632,4.0
Virginia,1987,4,2988968,68.3,2856013,65.3,132955,4.4
Washington,1987,4,2242207,66.3,2073435,61.3,168772,7.5
West Virginia,1987,4,741713,51.1,658482,45.4,83231,11.2
Wisconsin,1987,4,2483562,68.8,2335430,64.7,148132,6.0
Wyoming,1987,4,244406,69.6,223491,63.7,20915,8.6
Alabama,1987,5,1865599,61.5,1710928,56.4,154671,8.3
Alaska,1987,5,249173,72.2,223395,64.8,25778,10.3
Arizona,1987,5,1606934,64.2,1501817,60.0,105117,6.5
Arkansas,1987,5,1088735,61.3,999784,56.3,88951,8.2
California,1987,5,13689639,66.9,12881285,62.9,808354,5.9
Los Angeles County,1987,5,4211494,66.3,3957778,62.3,253716,6.0
Colorado,1987,5,1700911,69.8,1568235,64.4,132676,7.8
Connecticut,1987,5,1748395,69.8,1692112,67.6,56283,3.2
Delaware,1987,5,331719,67.8,321659,65.8,10060,3.0
District of Columbia,1987,5,329094,69.3,308155,64.9,20939,6.4
Florida,1987,5,5829773,62.0,5512775,58.7,316998,5.4
Georgia,1987,5,3041820,67.0,2878138,63.4,163682,5.4
Hawaii,1987,5,509721,67.1,490143,64.5,19578,3.8
Idaho,1987,5,472031,66.4,435104,61.2,36927,7.8
Illinois,1987,5,5759979,65.9,5318782,60.9,441197,7.7
Indiana,1987,5,2749152,66.2,2574524,62.0,174628,6.4
Iowa,1987,5,1459503,68.3,1375993,64.4,83510,5.7
Kansas,1987,5,1263595,69.0,1201999,65.7,61596,4.9
Kentucky,1987,5,1701955,61.4,1558618,56.2,143337,8.4
Louisiana,1987,5,1953465,61.0,1720652,53.8,232813,11.9
Maine,1987,5,582799,65.0,557099,62.2,25700,4.4
Maryland,1987,5,2397941,69.7,2295399,66.7,102542,4.3
Massachusetts,1987,5,3095561,67.5,2989650,65.2,105911,3.4
Michigan,1987,5,4508662,65.1,4125852,59.6,382810,8.5
Minnesota,1987,5,2283526,71.5,2164492,67.8,119034,5.2
Mississippi,1987,5,1150208,61.3,1032334,55.0,117874,10.2
Missouri,1987,5,2556388,66.2,2390219,61.9,166169,6.5
Montana,1987,5,401698,67.2,371719,62.2,29979,7.5
Nebraska,1987,5,813163,68.9,777989,65.9,35174,4.3
Nevada,1987,5,553349,72.8,518611,68.2,34738,6.3
New Hampshire,1987,5,578641,72.2,566456,70.7,12185,2.1
New Jersey,1987,5,3951376,65.9,3789710,63.2,161666,4.1
New Mexico,1987,5,674805,62.9,614289,57.3,60516,9.0
New York,1987,5,8470031,61.6,8062016,58.6,408015,4.8
New York city,1987,5,3236938,55.5,3055906,52.4,181032,5.6
North Carolina,1987,5,3265303,68.1,3113309,64.9,151994,4.7
North Dakota,1987,5,330699,68.3,314423,65.0,16276,4.9
Ohio,1987,5,5259374,64.5,4872323,59.8,387051,7.4
Oklahoma,1987,5,1556111,64.7,1442924,60.0,113187,7.3
Oregon,1987,5,1385585,66.6,1302572,62.6,83013,6.0
Pennsylvania,1987,5,5638211,60.7,5312732,57.2,325479,5.8
Rhode Island,1987,5,514038,67.5,494106,64.8,19932,3.9
South Carolina,1987,5,1627188,65.3,1535932,61.7,91256,5.6
South Dakota,1987,5,351987,68.3,336752,65.4,15235,4.3
Tennessee,1987,5,2325841,63.3,2163677,58.9,162164,7.0
Texas,1987,5,8262047,68.8,7550980,62.9,711067,8.6
Utah,1987,5,756714,69.7,707592,65.2,49122,6.5
Vermont,1987,5,293941,71.3,282564,68.6,11377,3.9
Virginia,1987,5,2993915,68.3,2864694,65.3,129221,4.3
Washington,1987,5,2248153,66.3,2082750,61.5,165403,7.4
West Virginia,1987,5,740768,51.1,658476,45.4,82292,11.1
Wisconsin,1987,5,2487287,68.8,2342238,64.8,145049,5.8
Wyoming,1987,5,243256,69.5,223118,63.7,20138,8.3
Alabama,1987,6,1866710,61.5,1715585,56.5,151125,8.1
Alaska,1987,6,248844,72.1,223476,64.8,25368,10.2
Arizona,1987,6,1609758,64.1,1507498,60.0,102260,6.4
Arkansas,1987,6,1091567,61.4,1003003,56.4,88564,8.1
California,1987,6,13722122,66.9,12928159,63.0,793963,5.8
Los Angeles County,1987,6,4223794,66.4,3975586,62.5,248208,5.9
Colorado,1987,6,1697968,69.7,1569745,64.4,128223,7.6
Connecticut,1987,6,1749265,69.8,1694598,67.6,54667,3.1
Delaware,1987,6,331877,67.7,321974,65.7,9903,3.0
District of Columbia,1987,6,329341,69.5,308893,65.2,20448,6.2
Florida,1987,6,5851925,62.1,5537085,58.8,314840,5.4
Georgia,1987,6,3047464,66.9,2883162,63.3,164302,5.4
Hawaii,1987,6,511291,67.1,491955,64.6,19336,3.8
Idaho,1987,6,472026,66.4,435830,61.3,36196,7.7
Illinois,1987,6,5775959,66.1,5341045,61.1,434914,7.5
Indiana,1987,6,2749082,66.1,2576908,62.0,172174,6.3
Iowa,1987,6,1459620,68.3,1376773,64.4,82847,5.7
Kansas,1987,6,1264664,69.1,1203854,65.7,60810,4.8
Kentucky,1987,6,1700427,61.3,1560463,56.3,139964,8.2
Louisiana,1987,6,1951695,61.0,1722312,53.9,229383,11.8
Maine,1987,6,585746,65.3,560327,62.5,25419,4.3
Maryland,1987,6,2400589,69.6,2298741,66.7,101848,4.2
Massachusetts,1987,6,3102214,67.6,2999265,65.4,102949,3.3
Michigan,1987,6,4515954,65.1,4133076,59.6,382878,8.5
Minnesota,1987,6,2284398,71.5,2166206,67.8,118192,5.2
Mississippi,1987,6,1150396,61.3,1034814,55.1,115582,10.0
Missouri,1987,6,2558861,66.2,2394611,61.9,164250,6.4
Montana,1987,6,400867,67.1,371097,62.2,29770,7.4
Nebraska,1987,6,813360,68.9,778330,65.9,35030,4.3
Nevada,1987,6,555215,72.8,520509,68.2,34706,6.3
New Hampshire,1987,6,580877,72.3,568475,70.8,12402,2.1
New Jersey,1987,6,3957880,65.9,3797010,63.3,160870,4.1
New Mexico,1987,6,675360,62.9,615294,57.3,60066,8.9
New York,1987,6,8477703,61.6,8076402,58.7,401301,4.7
New York city,1987,6,3239246,55.5,3061965,52.5,177281,5.5
North Carolina,1987,6,3271074,68.1,3122392,65.0,148682,4.5
North Dakota,1987,6,330784,68.5,314657,65.1,16127,4.9
Ohio,1987,6,5259016,64.5,4882491,59.8,376525,7.2
Oklahoma,1987,6,1552753,64.7,1442599,60.1,110154,7.1
Oregon,1987,6,1389239,66.7,1306149,62.7,83090,6.0
Pennsylvania,1987,6,5652880,60.8,5329338,57.3,323542,5.7
Rhode Island,1987,6,514953,67.6,495435,65.0,19518,3.8
South Carolina,1987,6,1627952,65.3,1540645,61.8,87307,5.4
South Dakota,1987,6,352212,68.4,337068,65.5,15144,4.3
Tennessee,1987,6,2328379,63.3,2170167,59.0,158212,6.8
Texas,1987,6,8271596,68.8,7566800,63.0,704796,8.5
Utah,1987,6,755742,69.6,707739,65.2,48003,6.4
Vermont,1987,6,294644,71.3,283495,68.6,11149,3.8
Virginia,1987,6,2998438,68.3,2873161,65.4,125277,4.2
Washington,1987,6,2254986,66.4,2092302,61.6,162684,7.2
West Virginia,1987,6,740087,51.0,658706,45.4,81381,11.0
Wisconsin,1987,6,2490651,68.9,2348365,64.9,142286,5.7
Wyoming,1987,6,242323,69.4,222888,63.9,19435,8.0
Alabama,1987,7,1867798,61.5,1719387,56.6,148411,7.9
Alaska,1987,7,248711,72.3,223693,65.0,25018,10.1
Arizona,1987,7,1612661,64.0,1512418,60.1,100243,6.2
Arkansas,1987,7,1094319,61.5,1006045,56.6,88274,8.1
California,1987,7,13754143,66.9,12971311,63.1,782832,5.7
Los Angeles County,1987,7,4235204,66.5,3992079,62.7,243125,5.7
Colorado,1987,7,1696212,69.5,1572250,64.5,123962,7.3
Connecticut,1987,7,1749668,69.8,1696385,67.7,53283,3.0
Delaware,1987,7,332288,67.7,322526,65.7,9762,2.9
District of Columbia,1987,7,329298,69.5,309267,65.2,20031,6.1
Florida,1987,7,5873442,62.2,5559973,58.9,313469,5.3
Georgia,1987,7,3054686,67.0,2888396,63.3,166290,5.4
Hawaii,1987,7,512840,67.2,493791,64.7,19049,3.7
Idaho,1987,7,472131,66.4,436554,61.4,35577,7.5
Illinois,1987,7,5787959,66.2,5360292,61.3,427667,7.4
Indiana,1987,7,2748146,66.0,2578771,62.0,169375,6.2
Iowa,1987,7,1460207,68.3,1377925,64.5,82282,5.6
Kansas,1987,7,1265408,69.1,1205266,65.8,60142,4.8
Kentucky,1987,7,1699114,61.2,1562062,56.3,137052,8.1
Louisiana,1987,7,1949699,61.0,1723105,53.9,226594,11.6
Maine,1987,7,588526,65.5,563235,62.7,25291,4.3
Maryland,1987,7,2404270,69.6,2302779,66.7,101491,4.2
Massachusetts,1987,7,3108231,67.7,3007705,65.6,100526,3.2
Michigan,1987,7,4519954,65.1,4139167,59.6,380787,8.4
Minnesota,1987,7,2285904,71.5,2168535,67.8,117369,5.1
Mississippi,1987,7,1150831,61.3,1037026,55.2,113805,9.9
Missouri,1987,7,2560374,66.2,2398390,62.0,161984,6.3
Montana,1987,7,400231,67.0,370516,62.1,29715,7.4
Nebraska,1987,7,813307,68.9,778563,65.9,34744,4.3
Nevada,1987,7,557177,72.8,522453,68.3,34724,6.2
New Hampshire,1987,7,582916,72.4,570117,70.8,12799,2.2
New Jersey,1987,7,3962473,66.0,3802733,63.3,159740,4.0
New Mexico,1987,7,676018,62.9,616195,57.4,59823,8.8
New York,1987,7,8486728,61.6,8088999,58.7,397729,4.7
New York city,1987,7,3241967,55.6,3066683,52.6,175284,5.4
North Carolina,1987,7,3277008,68.1,3131547,65.1,145461,4.4
North Dakota,1987,7,330904,68.5,314822,65.2,16082,4.9
Ohio,1987,7,5260145,64.4,4893885,59.9,366260,7.0
Oklahoma,1987,7,1549089,64.6,1441555,60.1,107534,6.9
Oregon,1987,7,1394150,66.9,1310251,62.9,83899,6.0
Pennsylvania,1987,7,5667973,60.9,5345799,57.5,322174,5.7
Rhode Island,1987,7,515607,67.6,496611,65.1,18996,3.7
South Carolina,1987,7,1629485,65.2,1545105,61.9,84380,5.2
South Dakota,1987,7,352466,68.4,337418,65.5,15048,4.3
Tennessee,1987,7,2331256,63.3,2177466,59.1,153790,6.6
Texas,1987,7,8281141,68.9,7581950,63.1,699191,8.4
Utah,1987,7,754845,69.4,707984,65.1,46861,6.2
Vermont,1987,7,295394,71.5,284460,68.9,10934,3.7
Virginia,1987,7,3003196,68.3,2881685,65.5,121511,4.0
Washington,1987,7,2262938,66.6,2101981,61.8,160957,7.1
West Virginia,1987,7,739947,51.0,659297,45.5,80650,10.9
Wisconsin,1987,7,2493914,68.9,2353678,65.1,140236,5.6
Wyoming,1987,7,241675,69.4,222798,64.0,18877,7.8
Alabama,1987,8,1869136,61.5,1722541,56.6,146595,7.8
Alaska,1987,8,248729,72.3,224024,65.1,24705,9.9
Arizona,1987,8,1616244,64.1,1516906,60.1,99338,6.1
Arkansas,1987,8,1096948,61.6,1008830,56.7,88118,8.0
California,1987,8,13787737,67.0,13012350,63.2,775387,5.6
Los Angeles County,1987,8,4246756,66.6,4007735,62.9,239021,5.6
Colorado,1987,8,1696062,69.5,1575417,64.6,120645,7.1
Connecticut,1987,8,1749575,69.8,1697317,67.7,52258,3.0
Delaware,1987,8,333074,67.7,323360,65.7,9714,2.9
District of Columbia,1987,8,329133,69.6,309454,65.4,19679,6.0
Florida,1987,8,5894910,62.3,5581836,59.0,313074,5.3
Georgia,1987,8,3063549,67.1,2894260,63.4,169289,5.5
Hawaii,1987,8,514462,67.3,495759,64.9,18703,3.6
Idaho,1987,8,472265,66.4,437150,61.5,35115,7.4
Illinois,1987,8,5794369,66.2,5373503,61.4,420866,7.3
Indiana,1987,8,2746963,66.0,2580892,62.0,166071,6.0
Iowa,1987,8,1461625,68.4,1380108,64.6,81517,5.6
Kansas,1987,8,1265768,69.1,1206238,65.8,59530,4.7
Kentucky,1987,8,1698891,61.2,1563985,56.3,134906,7.9
Louisiana,1987,8,1947697,61.0,1723056,54.0,224641,11.5
Maine,1987,8,590886,65.7,565649,62.8,25237,4.3
Maryland,1987,8,2409339,69.7,2307758,66.8,101581,4.2
Massachusetts,1987,8,3113354,67.8,3014432,65.7,98922,3.2
Michigan,1987,8,4521202,65.1,4143215,59.7,377987,8.4
Minnesota,1987,8,2288642,71.5,2172183,67.8,116459,5.1
Mississippi,1987,8,1151509,61.3,1039177,55.3,112332,9.8
Missouri,1987,8,2561084,66.1,2401562,62.0,159522,6.2
Montana,1987,8,399903,67.0,370146,62.0,29757,7.4
Nebraska,1987,8,812947,68.8,778678,65.9,34269,4.2
Nevada,1987,8,559252,72.8,524478,68.3,34774,6.2
New Hampshire,1987,8,584663,72.4,571422,70.8,13241,2.3
New Jersey,1987,8,3965966,66.0,3807389,63.4,158577,4.0
New Mexico,1987,8,676655,62.9,616983,57.4,59672,8.8
New York,1987,8,8497626,61.7,8100997,58.8,396629,4.7
New York city,1987,8,3244429,55.6,3069745,52.6,174684,5.4
North Carolina,1987,8,3282950,68.2,3140011,65.2,142939,4.4
North Dakota,1987,8,331009,68.5,314894,65.2,16115,4.9
Ohio,1987,8,5263148,64.4,4906322,60.0,356826,6.8
Oklahoma,1987,8,1545656,64.5,1439941,60.0,105715,6.8
Oregon,1987,8,1399704,67.1,1314487,63.0,85217,6.1
Pennsylvania,1987,8,5683262,61.1,5361832,57.6,321430,5.7
Rhode Island,1987,8,515974,67.6,497527,65.2,18447,3.6
South Carolina,1987,8,1632415,65.3,1549302,61.9,83113,5.1
South Dakota,1987,8,352790,68.5,337805,65.6,14985,4.2
Tennessee,1987,8,2334925,63.3,2185439,59.3,149486,6.4
Texas,1987,8,8289920,68.9,7596549,63.2,693371,8.4
Utah,1987,8,754241,69.3,708381,65.1,45860,6.1
Vermont,1987,8,296122,71.5,285402,68.9,10720,3.6
Virginia,1987,8,3008940,68.3,2890445,65.6,118495,3.9
Washington,1987,8,2271623,66.7,2111358,62.0,160265,7.1
West Virginia,1987,8,740363,51.1,660239,45.6,80124,10.8
Wisconsin,1987,8,2497005,69.0,2358200,65.1,138805,5.6
Wyoming,1987,8,241292,69.3,222817,64.0,18475,7.7
Alabama,1987,9,1870854,61.5,1725552,56.7,145302,7.8
Alaska,1987,9,248894,72.1,224498,65.1,24396,9.8
Arizona,1987,9,1620584,64.1,1521300,60.2,99284,6.1
Arkansas,1987,9,1099409,61.8,1011360,56.8,88049,8.0
California,1987,9,13824385,67.0,13053851,63.3,770534,5.6
Los Angeles County,1987,9,4259351,66.8,4023234,63.1,236117,5.5
Colorado,1987,9,1697915,69.6,1579136,64.7,118779,7.0
Connecticut,1987,9,1749143,69.7,1697601,67.7,51542,2.9
Delaware,1987,9,334270,67.8,324473,65.8,9797,2.9
District of Columbia,1987,9,328984,69.6,309643,65.5,19341,5.9
Florida,1987,9,5916541,62.4,5603570,59.1,312971,5.3
Georgia,1987,9,3073580,67.2,2901124,63.4,172456,5.6
Hawaii,1987,9,516161,67.5,497862,65.1,18299,3.5
Idaho,1987,9,472346,66.3,437674,61.5,34672,7.3
Illinois,1987,9,5796463,66.2,5381069,61.5,415394,7.2
Indiana,1987,9,2746582,65.9,2584563,62.0,162019,5.9
Iowa,1987,9,1463701,68.4,1383380,64.7,80321,5.5
Kansas,1987,9,1266056,69.0,1207182,65.8,58874,4.7
Kentucky,1987,9,1700257,61.2,1566731,56.4,133526,7.9
Louisiana,1987,9,1946021,61.0,1722770,54.0,223251,11.5
Maine,1987,9,592647,65.8,567563,63.0,25084,4.2
Maryland,1987,9,2415890,69.8,2313718,66.8,102172,4.2
Massachusetts,1987,9,3117764,67.9,3019657,65.7,98107,3.1
Michigan,1987,9,4521123,65.1,4145336,59.7,375787,8.3
Minnesota,1987,9,2292054,71.5,2177113,67.9,114941,5.0
Mississippi,1987,9,1152229,61.3,1041477,55.4,110752,9.6
Missouri,1987,9,2561417,66.1,2404829,62.1,156588,6.1
Montana,1987,9,399976,67.0,370217,62.0,29759,7.4
Nebraska,1987,9,812448,68.7,778904,65.8,33544,4.1
Nevada,1987,9,561388,72.8,526654,68.3,34734,6.2
New Hampshire,1987,9,586064,72.5,572488,70.9,13576,2.3
New Jersey,1987,9,3969090,66.0,3811754,63.4,157336,4.0
New Mexico,1987,9,677347,63.0,617901,57.4,59446,8.8
New York,1987,9,8509116,61.8,8113516,58.9,395600,4.6
New York city,1987,9,3245753,55.6,3071718,52.6,174035,5.4
North Carolina,1987,9,3289033,68.2,3147544,65.3,141489,4.3
North Dakota,1987,9,331088,68.5,314941,65.2,16147,4.9
Ohio,1987,9,5267709,64.4,4919371,60.2,348338,6.6
Oklahoma,1987,9,1543094,64.4,1438341,60.0,104753,6.8
Oregon,1987,9,1404937,67.2,1318407,63.1,86530,6.2
Pennsylvania,1987,9,5698628,61.2,5377648,57.8,320980,5.6
Rhode Island,1987,9,516187,67.6,498197,65.2,17990,3.5
South Carolina,1987,9,1636609,65.4,1553420,62.0,83189,5.1
South Dakota,1987,9,353233,68.5,338266,65.6,14967,4.2
Tennessee,1987,9,2338965,63.4,2193225,59.4,145740,6.2
Texas,1987,9,8297572,69.0,7610887,63.3,686685,8.3
Utah,1987,9,754058,69.2,709018,65.1,45040,6.0
Vermont,1987,9,296785,71.5,286288,69.0,10497,3.5
Virginia,1987,9,3016182,68.3,2899628,65.7,116554,3.9
Washington,1987,9,2280146,66.8,2120167,62.1,159979,7.0
West Virginia,1987,9,741052,51.2,661453,45.7,79599,10.7
Wisconsin,1987,9,2499922,69.0,2362633,65.2,137289,5.5
Wyoming,1987,9,241075,69.3,222947,64.1,18128,7.5
Alabama,1987,10,1872460,61.5,1728348,56.8,144112,7.7
Alaska,1987,10,249191,72.2,225115,65.3,24076,9.7
Arizona,1987,10,1625126,64.2,1525353,60.2,99773,6.1
Arkansas,1987,10,1101660,61.9,1013659,56.9,88001,8.0
California,1987,10,13862797,67.1,13095769,63.4,767028,5.5
Los Angeles County,1987,10,4272920,66.9,4038724,63.3,234196,5.5
Colorado,1987,10,1701447,69.7,1583195,64.9,118252,7.0
Connecticut,1987,10,1748279,69.7,1697253,67.6,51026,2.9
Delaware,1987,10,335772,68.1,325775,66.1,9997,3.0
District of Columbia,1987,10,328940,69.7,309934,65.7,19006,5.8
Florida,1987,10,5937690,62.5,5624797,59.2,312893,5.3
Georgia,1987,10,3083670,67.3,2908551,63.5,175119,5.7
Hawaii,1987,10,517677,67.6,499798,65.2,17879,3.5
Idaho,1987,10,472340,66.3,438171,61.5,34169,7.2
Illinois,1987,10,5796182,66.2,5383986,61.5,412196,7.1
Indiana,1987,10,2747419,65.9,2589717,62.1,157702,5.7
Iowa,1987,10,1465663,68.5,1387022,64.8,78641,5.4
Kansas,1987,10,1266629,69.0,1208379,65.8,58250,4.6
Kentucky,1987,10,1702856,61.3,1570018,56.5,132838,7.8
Louisiana,1987,10,1944770,61.0,1722666,54.0,222104,11.4
Maine,1987,10,593605,65.7,568898,63.0,24707,4.2
Maryland,1987,10,2423132,69.9,2320022,66.9,103110,4.3
Massachusetts,1987,10,3121899,67.9,3023962,65.8,97937,3.1
Michigan,1987,10,4520858,65.1,4145979,59.7,374879,8.3
Minnesota,1987,10,2295389,71.5,2182783,68.0,112606,4.9
Mississippi,1987,10,1152637,61.3,1043770,55.5,108867,9.4
Missouri,1987,10,2561699,66.1,2408585,62.1,153114,6.0
Montana,1987,10,400415,67.1,370795,62.1,29620,7.4
Nebraska,1987,10,811981,68.6,779358,65.9,32623,4.0
Nevada,1987,10,563471,72.8,528952,68.3,34519,6.1
New Hampshire,1987,10,587010,72.5,573315,70.8,13695,2.3
New Jersey,1987,10,3971431,66.0,3815382,63.4,156049,3.9
New Mexico,1987,10,678131,63.0,619046,57.5,59085,8.7
New York,1987,10,8519019,61.8,8126244,59.0,392775,4.6
New York city,1987,10,3245113,55.6,3072752,52.7,172361,5.3
North Carolina,1987,10,3295096,68.3,3154501,65.4,140595,4.3
North Dakota,1987,10,331135,68.6,315008,65.2,16127,4.9
Ohio,1987,10,5272992,64.4,4931217,60.3,341775,6.5
Oklahoma,1987,10,1541260,64.4,1437055,60.0,104205,6.8
Oregon,1987,10,1409233,67.3,1321918,63.1,87315,6.2
Pennsylvania,1987,10,5713246,61.4,5392744,57.9,320502,5.6
Rhode Island,1987,10,516233,67.6,498607,65.3,17626,3.4
South Carolina,1987,10,1641459,65.5,1557638,62.1,83821,5.1
South Dakota,1987,10,353805,68.6,338778,65.7,15027,4.2
Tennessee,1987,10,2342518,63.4,2199702,59.5,142816,6.1
Texas,1987,10,8304516,69.0,7624375,63.4,680141,8.2
Utah,1987,10,754156,69.3,709841,65.2,44315,5.9
Vermont,1987,10,297269,71.6,287001,69.2,10268,3.5
Virginia,1987,10,3024933,68.4,2909376,65.8,115557,3.8
Washington,1987,10,2287560,66.9,2128133,62.2,159427,7.0
West Virginia,1987,10,741694,51.2,662676,45.8,79018,10.7
Wisconsin,1987,10,2502608,69.0,2367558,65.3,135050,5.4
Wyoming,1987,10,240873,69.4,223134,64.3,17739,7.4
Alabama,1987,11,1873514,61.5,1730817,56.8,142697,7.6
Alaska,1987,11,249525,72.3,225806,65.5,23719,9.5
Arizona,1987,11,1629374,64.2,1528901,60.3,100473,6.2
Arkansas,1987,11,1103624,62.0,1015821,57.0,87803,8.0
California,1987,11,13901345,67.2,13138322,63.5,763023,5.5
Los Angeles County,1987,11,4286917,67.1,4054571,63.4,232346,5.4
Colorado,1987,11,1705602,69.9,1587248,65.0,118354,6.9
Connecticut,1987,11,1746930,69.6,1696387,67.6,50543,2.9
Delaware,1987,11,337388,68.3,327160,66.2,10228,3.0
District of Columbia,1987,11,329063,69.9,310373,65.9,18690,5.7
Florida,1987,11,5958265,62.6,5645574,59.3,312691,5.2
Georgia,1987,11,3093550,67.4,2916483,63.6,177067,5.7
Hawaii,1987,11,518715,67.5,501247,65.3,17468,3.4
Idaho,1987,11,472250,66.2,438718,61.5,33532,7.1
Illinois,1987,11,5795151,66.1,5384050,61.5,411101,7.1
Indiana,1987,11,2749297,65.9,2595740,62.2,153557,5.6
Iowa,1987,11,1467559,68.5,1390969,65.0,76590,5.2
Kansas,1987,11,1267652,69.0,1209947,65.9,57705,4.6
Kentucky,1987,11,1705862,61.4,1573336,56.6,132526,7.8
Louisiana,1987,11,1943837,61.0,1723158,54.1,220679,11.4
Maine,1987,11,593757,65.7,569721,63.0,24036,4.0
Maryland,1987,11,2430099,70.0,2326048,67.0,104051,4.3
Massachusetts,1987,11,3126506,68.0,3028401,65.9,98105,3.1
Michigan,1987,11,4521729,65.1,4146497,59.7,375232,8.3
Minnesota,1987,11,2298209,71.5,2188604,68.1,109605,4.8
Mississippi,1987,11,1152463,61.3,1045938,55.6,106525,9.2
Missouri,1987,11,2562206,66.0,2413050,62.2,149156,5.8
Montana,1987,11,401119,67.2,371817,62.3,29302,7.3
Nebraska,1987,11,811817,68.6,780121,65.9,31696,3.9
Nevada,1987,11,565462,72.8,531382,68.4,34080,6.0
New Hampshire,1987,11,587579,72.5,573951,70.8,13628,2.3
New Jersey,1987,11,3972654,66.0,3818098,63.5,154556,3.9
New Mexico,1987,11,679053,63.1,620517,57.6,58536,8.6
New York,1987,11,8525763,61.9,8139188,59.1,386575,4.5
New York city,1987,11,3242211,55.6,3073025,52.7,169186,5.2
North Carolina,1987,11,3300543,68.3,3161276,65.4,139267,4.2
North Dakota,1987,11,331154,68.6,315144,65.2,16010,4.8
Ohio,1987,11,5279138,64.5,4941177,60.3,337961,6.4
Oklahoma,1987,11,1539831,64.3,1436261,60.0,103570,6.7
Oregon,1987,11,1412433,67.4,1325362,63.2,87071,6.2
Pennsylvania,1987,11,5725802,61.5,5406694,58.0,319108,5.6
Rhode Island,1987,11,515990,67.4,498802,65.2,17188,3.3
South Carolina,1987,11,1646229,65.6,1562174,62.2,84055,5.1
South Dakota,1987,11,354454,68.7,339314,65.8,15140,4.3
Tennessee,1987,11,2345003,63.4,2204497,59.6,140506,6.0
Texas,1987,11,8311325,69.1,7637612,63.5,673713,8.1
Utah,1987,11,754382,69.2,710847,65.2,43535,5.8
Vermont,1987,11,297494,71.5,287484,69.1,10010,3.4
Virginia,1987,11,3034719,68.5,2919704,65.9,115015,3.8
Washington,1987,11,2293361,66.9,2135276,62.3,158085,6.9
West Virginia,1987,11,742128,51.3,663748,45.9,78380,10.6
Wisconsin,1987,11,2505477,69.0,2373602,65.4,131875,5.3
Wyoming,1987,11,240625,69.3,223336,64.4,17289,7.2
Alabama,1987,12,1873624,61.5,1732573,56.9,141051,7.5
Alaska,1987,12,249745,72.4,226380,65.6,23365,9.4
Arizona,1987,12,1632802,64.2,1531408,60.2,101394,6.2
Arkansas,1987,12,1104956,62.0,1017470,57.1,87486,7.9
California,1987,12,13937069,67.2,13178776,63.6,758293,5.4
Los Angeles County,1987,12,4299807,67.2,4069871,63.6,229936,5.3
Colorado,1987,12,1709038,70.0,1590617,65.1,118421,6.9
Connecticut,1987,12,1745153,69.5,1695133,67.5,50020,2.9
Delaware,1987,12,338875,68.5,328493,66.4,10382,3.1
District of Columbia,1987,12,329330,69.9,310919,66.0,18411,5.6
Florida,1987,12,5977310,62.7,5664702,59.4,312608,5.2
Georgia,1987,12,3103158,67.5,2924367,63.7,178791,5.8
Hawaii,1987,12,519058,67.5,501962,65.3,17096,3.3
Idaho,1987,12,472113,66.2,439327,61.6,32786,6.9
Illinois,1987,12,5794156,66.1,5382790,61.4,411366,7.1
Indiana,1987,12,2751460,65.9,2601513,62.3,149947,5.4
Iowa,1987,12,1469609,68.6,1395084,65.1,74525,5.1
Kansas,1987,12,1268904,69.0,1211519,65.9,57385,4.5
Kentucky,1987,12,1708369,61.4,1575988,56.7,132381,7.7
Louisiana,1987,12,1942816,61.0,1723849,54.2,218967,11.3
Maine,1987,12,593294,65.5,570178,62.9,23116,3.9
Maryland,1987,12,2435720,70.0,2330909,67.0,104811,4.3
Massachusetts,1987,12,3131161,68.1,3032733,65.9,98428,3.1
Michigan,1987,12,4523889,65.1,4147992,59.7,375897,8.3
Minnesota,1987,12,2300103,71.5,2193641,68.2,106462,4.6
Mississippi,1987,12,1151503,61.2,1047648,55.7,103855,9.0
Missouri,1987,12,2563073,66.0,2417713,62.3,145360,5.7
Montana,1987,12,401816,67.3,372955,62.5,28861,7.2
Nebraska,1987,12,811996,68.5,781056,65.9,30940,3.8
Nevada,1987,12,567270,72.7,533835,68.4,33435,5.9
New Hampshire,1987,12,587940,72.3,574469,70.7,13471,2.3
New Jersey,1987,12,3972225,66.0,3819349,63.5,152876,3.8
New Mexico,1987,12,680023,63.1,622154,57.7,57869,8.5
New York,1987,12,8527225,61.9,8150169,59.1,377056,4.4
New York city,1987,12,3237084,55.5,3072345,52.7,164739,5.1
North Carolina,1987,12,3304438,68.3,3167389,65.5,137049,4.1
North Dakota,1987,12,331096,68.5,315281,65.3,15815,4.8
Ohio,1987,12,5285401,64.5,4948607,60.4,336794,6.4
Oklahoma,1987,12,1538088,64.3,1435520,60.0,102568,6.7
Oregon,1987,12,1414594,67.3,1328553,63.2,86041,6.1
Pennsylvania,1987,12,5734022,61.5,5417517,58.1,316505,5.5
Rhode Island,1987,12,515457,67.4,498884,65.2,16573,3.2
South Carolina,1987,12,1650013,65.7,1566426,62.3,83587,5.1
South Dakota,1987,12,355062,68.7,339786,65.7,15276,4.3
Tennessee,1987,12,2345661,63.4,2207045,59.6,138616,5.9
Texas,1987,12,8316703,69.1,7649467,63.5,667236,8.0
Utah,1987,12,754469,69.2,711885,65.3,42584,5.6
Vermont,1987,12,297448,71.3,287743,69.0,9705,3.3
Virginia,1987,12,3044392,68.6,2929687,66.0,114705,3.8
Washington,1987,12,2297322,66.9,2141437,62.4,155885,6.8
West Virginia,1987,12,742419,51.3,664588,46.0,77831,10.5
Wisconsin,1987,12,2508772,69.1,2380809,65.6,127963,5.1
Wyoming,1987,12,240294,69.2,223465,64.4,16829,7.0
Alabama,1988,1,1872638,61.4,1733412,56.9,139226,7.4
Alaska,1988,1,249709,72.2,226692,65.5,23017,9.2
Arizona,1988,1,1635414,64.2,1532912,60.2,102502,6.3
Arkansas,1988,1,1105455,62.0,1018381,57.1,87074,7.9
California,1988,1,13967800,67.2,13214733,63.6,753067,5.4
Los Angeles County,1988,1,4309316,67.3,4082484,63.8,226832,5.3
Colorado,1988,1,1710846,70.1,1593001,65.2,117845,6.9
Connecticut,1988,1,1743456,69.4,1693997,67.4,49459,2.8
Delaware,1988,1,340179,68.6,329783,66.5,10396,3.1
District of Columbia,1988,1,329674,70.1,311531,66.3,18143,5.5
Florida,1988,1,5993923,62.7,5681440,59.5,312483,5.2
Georgia,1988,1,3112005,67.7,2931704,63.7,180301,5.8
Hawaii,1988,1,518680,67.4,501945,65.2,16735,3.2
Idaho,1988,1,472097,66.2,440060,61.7,32037,6.8
Illinois,1988,1,5793013,66.1,5381626,61.4,411387,7.1
Indiana,1988,1,2753453,65.9,2606593,62.4,146860,5.3
Iowa,1988,1,1472126,68.7,1399385,65.3,72741,4.9
Kansas,1988,1,1270010,69.0,1212712,65.9,57298,4.5
Kentucky,1988,1,1709737,61.4,1577705,56.7,132032,7.7
Louisiana,1988,1,1941012,61.0,1724160,54.2,216852,11.2
Maine,1988,1,592596,65.3,570509,62.9,22087,3.7
Maryland,1988,1,2439566,70.0,2334434,67.0,105132,4.3
Massachusetts,1988,1,3135420,68.1,3036651,66.0,98769,3.2
Michigan,1988,1,4526112,65.1,4151395,59.7,374717,8.3
Minnesota,1988,1,2300902,71.4,2197402,68.2,103500,4.5
Mississippi,1988,1,1149584,61.1,1048539,55.7,101045,8.8
Missouri,1988,1,2564640,66.0,2422017,62.3,142623,5.6
Montana,1988,1,402389,67.4,374016,62.6,28373,7.1
Nebraska,1988,1,812353,68.5,782057,65.9,30296,3.7
Nevada,1988,1,568920,72.7,536242,68.5,32678,5.7
New Hampshire,1988,1,588278,72.3,575035,70.6,13243,2.3
New Jersey,1988,1,3969953,65.9,3818869,63.4,151084,3.8
New Mexico,1988,1,680904,63.1,623779,57.8,57125,8.4
New York,1988,1,8522477,61.8,8157405,59.2,365072,4.3
New York city,1988,1,3230612,55.4,3071245,52.6,159367,4.9
North Carolina,1988,1,3306044,68.2,3172349,65.5,133695,4.0
North Dakota,1988,1,330947,68.5,315355,65.3,15592,4.7
Ohio,1988,1,5290468,64.5,4953695,60.4,336773,6.4
Oklahoma,1988,1,1535540,64.2,1434593,60.0,100947,6.6
Oregon,1988,1,1416034,67.3,1331232,63.3,84802,6.0
Pennsylvania,1988,1,5736452,61.5,5423849,58.2,312603,5.4
Rhode Island,1988,1,514801,67.3,498995,65.2,15806,3.1
South Carolina,1988,1,1652286,65.7,1569765,62.4,82521,5.0
South Dakota,1988,1,355541,68.8,340161,65.8,15380,4.3
Tennessee,1988,1,2343762,63.3,2206809,59.6,136953,5.8
Texas,1988,1,8319802,69.1,7659565,63.6,660237,7.9
Utah,1988,1,754310,69.1,712886,65.3,41424,5.5
Vermont,1988,1,297253,71.1,287901,68.9,9352,3.1
Virginia,1988,1,3053240,68.7,2938657,66.1,114583,3.8
Washington,1988,1,2299925,66.8,2146754,62.4,153171,6.7
West Virginia,1988,1,742616,51.4,665211,46.0,77405,10.4
Wisconsin,1988,1,2512496,69.1,2388963,65.7,123533,4.9
Wyoming,1988,1,239862,69.1,223498,64.4,16364,6.8
Alabama,1988,2,1870796,61.3,1733404,56.8,137392,7.3
Alaska,1988,2,249529,72.1,226844,65.6,22685,9.1
Arizona,1988,2,1637822,64.2,1534142,60.1,103680,6.3
Arkansas,1988,2,1105452,62.0,1018869,57.1,86583,7.8
California,1988,2,13995002,67.2,13246962,63.7,748040,5.3
Los Angeles County,1988,2,4314536,67.3,4091062,63.8,223474,5.2
Colorado,1988,2,1711516,70.1,1595091,65.3,116425,6.8
Connecticut,1988,2,1742398,69.3,1693466,67.4,48932,2.8
Delaware,1988,2,341399,68.7,331145,66.6,10254,3.0
District of Columbia,1988,2,330047,70.4,312201,66.6,17846,5.4
Florida,1988,2,6008310,62.7,5696320,59.5,311990,5.2
Georgia,1988,2,3119904,67.7,2938763,63.8,181141,5.8
Hawaii,1988,2,517862,67.2,501469,65.0,16393,3.2
Idaho,1988,2,472431,66.2,441096,61.8,31335,6.6
Illinois,1988,2,5791918,66.0,5382020,61.3,409898,7.1
Indiana,1988,2,2756051,65.9,2611645,62.5,144406,5.2
Iowa,1988,2,1475373,68.8,1403970,65.5,71403,4.8
Kansas,1988,2,1270803,69.0,1213503,65.9,57300,4.5
Kentucky,1988,2,1709812,61.4,1578473,56.7,131339,7.7
Louisiana,1988,2,1938307,61.0,1723983,54.2,214324,11.1
Maine,1988,2,592256,65.2,571035,62.8,21221,3.6
Maryland,1988,2,2442240,70.0,2337429,67.0,104811,4.3
Massachusetts,1988,2,3139245,68.2,3040160,66.0,99085,3.2
Michigan,1988,2,4527757,65.1,4158075,59.8,369682,8.2
Minnesota,1988,2,2301354,71.4,2200319,68.2,101035,4.4
Mississippi,1988,2,1146927,60.9,1048468,55.7,98459,8.6
Missouri,1988,2,2567454,66.0,2425977,62.4,141477,5.5
Montana,1988,2,402877,67.6,374950,62.9,27927,6.9
Nebraska,1988,2,812916,68.5,783147,66.0,29769,3.7
Nevada,1988,2,570614,72.6,538682,68.5,31932,5.6
New Hampshire,1988,2,588761,72.2,575737,70.6,13024,2.2
New Jersey,1988,2,3967089,65.9,3817724,63.4,149365,3.8
New Mexico,1988,2,681698,63.1,625396,57.9,56302,8.3
New York,1988,2,8513985,61.7,8161262,59.2,352723,4.1
New York city,1988,2,3224578,55.3,3070656,52.6,153922,4.8
North Carolina,1988,2,3306487,68.2,3176975,65.5,129512,3.9
North Dakota,1988,2,330744,68.6,315368,65.4,15376,4.6
Ohio,1988,2,5294712,64.5,4958839,60.4,335873,6.3
Oklahoma,1988,2,1532294,64.1,1433458,60.0,98836,6.5
Oregon,1988,2,1417277,67.3,1333472,63.3,83805,5.9
Pennsylvania,1988,2,5734594,61.5,5426918,58.2,307676,5.4
Rhode Island,1988,2,514275,67.1,499260,65.2,15015,2.9
South Carolina,1988,2,1653560,65.6,1572424,62.4,81136,4.9
South Dakota,1988,2,355869,68.8,340497,65.9,15372,4.3
Tennessee,1988,2,2339988,63.1,2204414,59.5,135574,5.8
Texas,1988,2,8321766,69.1,7669767,63.7,651999,7.8
Utah,1988,2,754135,69.0,713997,65.3,40138,5.3
Vermont,1988,2,297138,70.9,288143,68.8,8995,3.0
Virginia,1988,2,3061256,68.8,2946408,66.2,114848,3.8
Washington,1988,2,2302558,66.8,2152012,62.4,150546,6.5
West Virginia,1988,2,742719,51.4,665745,46.1,76974,10.4
Wisconsin,1988,2,2517149,69.2,2397999,65.9,119150,4.7
Wyoming,1988,2,239429,69.2,223520,64.6,15909,6.6
Alabama,1988,3,1868482,61.2,1732653,56.8,135829,7.3
Alaska,1988,3,249409,72.1,226975,65.6,22434,9.0
Arizona,1988,3,1640390,64.2,1535384,60.0,105006,6.4
Arkansas,1988,3,1105362,62.0,1019221,57.2,86141,7.8
California,1988,3,14020683,67.3,13275848,63.7,744835,5.3
Los Angeles County,1988,3,4316019,67.3,4095279,63.9,220740,5.1
Colorado,1988,3,1711387,70.0,1596837,65.3,114550,6.7
Connecticut,1988,3,1741933,69.3,1693317,67.3,48616,2.8
Delaware,1988,3,342677,68.8,332662,66.8,10015,2.9
District of Columbia,1988,3,330349,70.4,312844,66.7,17505,5.3
Florida,1988,3,6020751,62.8,5709584,59.5,311167,5.2
Georgia,1988,3,3126957,67.8,2945881,63.8,181076,5.8
Hawaii,1988,3,517010,67.0,500899,64.9,16111,3.1
Idaho,1988,3,473202,66.3,442486,62.0,30716,6.5
Illinois,1988,3,5792117,66.0,5385090,61.4,407027,7.0
Indiana,1988,3,2759980,66.0,2617082,62.6,142898,5.2
Iowa,1988,3,1478885,68.9,1408250,65.6,70635,4.8
Kansas,1988,3,1271324,69.0,1213970,65.9,57354,4.5
Kentucky,1988,3,1708911,61.4,1578351,56.7,130560,7.6
Louisiana,1988,3,1934930,60.9,1723155,54.3,211775,10.9
Maine,1988,3,592552,65.1,571744,62.8,20808,3.5
Maryland,1988,3,2444576,69.9,2340466,67.0,104110,4.3
Massachusetts,1988,3,3142130,68.2,3042588,66.1,99542,3.2
Michigan,1988,3,4528450,65.1,4167405,59.9,361045,8.0
Minnesota,1988,3,2302289,71.3,2202830,68.2,99459,4.3
Mississippi,1988,3,1143858,60.7,1047474,55.6,96384,8.4
Missouri,1988,3,2571635,66.1,2429597,62.5,142038,5.5
Montana,1988,3,403168,67.6,375552,63.0,27616,6.8
Nebraska,1988,3,813645,68.5,784295,66.1,29350,3.6
Nevada,1988,3,572424,72.6,541109,68.6,31315,5.5
New Hampshire,1988,3,589367,72.0,576412,70.5,12955,2.2
New Jersey,1988,3,3964579,65.8,3816524,63.3,148055,3.7
New Mexico,1988,3,682285,63.1,626848,58.0,55437,8.1
New York,1988,3,8505714,61.7,8162351,59.2,343363,4.0
New York city,1988,3,3220102,55.2,3070020,52.6,150082,4.7
North Carolina,1988,3,3307613,68.1,3182240,65.5,125373,3.8
North Dakota,1988,3,330540,68.6,315323,65.4,15217,4.6
Ohio,1988,3,5298625,64.5,4965690,60.5,332935,6.3
Oklahoma,1988,3,1528432,64.0,1431553,59.9,96879,6.3
Oregon,1988,3,1418655,67.2,1335389,63.3,83266,5.9
Pennsylvania,1988,3,5731704,61.4,5428994,58.2,302710,5.3
Rhode Island,1988,3,514114,67.1,499731,65.2,14383,2.8
South Carolina,1988,3,1654548,65.6,1574675,62.4,79873,4.8
South Dakota,1988,3,356047,68.7,340826,65.8,15221,4.3
Tennessee,1988,3,2335887,63.0,2201189,59.3,134698,5.8
Texas,1988,3,8322994,69.1,7680433,63.7,642561,7.7
Utah,1988,3,754133,68.9,715198,65.4,38935,5.2
Vermont,1988,3,297215,70.8,288518,68.7,8697,2.9
Virginia,1988,3,3068031,68.8,2952408,66.2,115623,3.8
Washington,1988,3,2306115,66.8,2157603,62.5,148512,6.4
West Virginia,1988,3,742802,51.5,666348,46.2,76454,10.3
Wisconsin,1988,3,2522986,69.3,2407475,66.1,115511,4.6
Wyoming,1988,3,239085,69.1,223561,64.6,15524,6.5
Alabama,1988,4,1866560,61.1,1731673,56.7,134887,7.2
Alaska,1988,4,249424,72.1,227146,65.6,22278,8.9
Arizona,1988,4,1643843,64.2,1537393,60.0,106450,6.5
Arkansas,1988,4,1105577,62.0,1019698,57.2,85879,7.8
California,1988,4,14047660,67.3,13303414,63.7,744246,5.3
Los Angeles County,1988,4,4315582,67.2,4096423,63.8,219159,5.1
Colorado,1988,4,1710811,70.0,1598066,65.4,112745,6.6
Connecticut,1988,4,1742067,69.2,1693413,67.3,48654,2.8
Delaware,1988,4,344157,69.1,334330,67.1,9827,2.9
District of Columbia,1988,4,330556,70.6,313414,67.0,17142,5.2
Florida,1988,4,6032519,62.8,5721978,59.5,310541,5.1
Georgia,1988,4,3133726,67.8,2953521,63.9,180205,5.8
Hawaii,1988,4,516584,66.8,500676,64.8,15908,3.1
Idaho,1988,4,474515,66.4,444285,62.1,30230,6.4
Illinois,1988,4,5794922,66.0,5391704,61.4,403218,7.0
Indiana,1988,4,2765407,66.1,2622938,62.7,142469,5.2
Iowa,1988,4,1482369,69.0,1412046,65.8,70323,4.7
Kansas,1988,4,1271768,69.0,1214340,65.9,57428,4.5
Kentucky,1988,4,1708180,61.3,1578228,56.6,129952,7.6
Louisiana,1988,4,1931580,60.9,1721936,54.3,209644,10.9
Maine,1988,4,593327,65.1,572461,62.8,20866,3.5
Maryland,1988,4,2447346,69.9,2343807,67.0,103539,4.2
Massachusetts,1988,4,3144383,68.2,3044045,66.1,100338,3.2
Michigan,1988,4,4528907,65.0,4177700,60.0,351207,7.8
Minnesota,1988,4,2304276,71.3,2205462,68.2,98814,4.3
Mississippi,1988,4,1141008,60.6,1045896,55.5,95112,8.3
Missouri,1988,4,2577187,66.2,2433027,62.5,144160,5.6
Montana,1988,4,403332,67.7,375865,63.1,27467,6.8
Nebraska,1988,4,814537,68.6,785509,66.1,29028,3.6
Nevada,1988,4,574434,72.5,543512,68.6,30922,5.4
New Hampshire,1988,4,590206,72.1,577078,70.5,13128,2.2
New Jersey,1988,4,3963511,65.7,3816146,63.3,147365,3.7
New Mexico,1988,4,682650,63.1,628114,58.1,54536,8.0
New York,1988,4,8502963,61.6,8163183,59.2,339780,4.0
New York city,1988,4,3218271,55.2,3068733,52.6,149538,4.6
North Carolina,1988,4,3311155,68.1,3189208,65.6,121947,3.7
North Dakota,1988,4,330418,68.6,315267,65.4,15151,4.6
Ohio,1988,4,5303399,64.5,4974742,60.5,328657,6.2
Oklahoma,1988,4,1524579,63.9,1428890,59.9,95689,6.3
Oregon,1988,4,1420537,67.2,1337340,63.3,83197,5.9
Pennsylvania,1988,4,5731779,61.4,5433152,58.2,298627,5.2
Rhode Island,1988,4,514379,67.1,500332,65.2,14047,2.7
South Carolina,1988,4,1655620,65.5,1576684,62.4,78936,4.8
South Dakota,1988,4,356151,68.8,341192,65.9,14959,4.2
Tennessee,1988,4,2332728,62.8,2198355,59.2,134373,5.8
Texas,1988,4,8324953,69.1,7692115,63.8,632838,7.6
Utah,1988,4,754569,69.0,716514,65.5,38055,5.0
Vermont,1988,4,297525,70.8,289020,68.8,8505,2.9
Virginia,1988,4,3073790,68.8,2956813,66.2,116977,3.8
Washington,1988,4,2311402,66.8,2163902,62.5,147500,6.4
West Virginia,1988,4,742926,51.5,667089,46.2,75837,10.2
Wisconsin,1988,4,2529936,69.4,2416976,66.3,112960,4.5
Wyoming,1988,4,238869,69.0,223609,64.6,15260,6.4
Alabama,1988,5,1866008,61.1,1731433,56.7,134575,7.2
Alaska,1988,5,249598,71.9,227430,65.5,22168,8.9
Arizona,1988,5,1649010,64.3,1541180,60.1,107830,6.5
Arkansas,1988,5,1106158,62.0,1020357,57.2,85801,7.8
California,1988,5,14077761,67.3,13332188,63.7,745573,5.3
Los Angeles County,1988,5,4314788,67.2,4096195,63.8,218593,5.1
Colorado,1988,5,1710155,69.9,1598892,65.4,111263,6.5
Connecticut,1988,5,1743025,69.3,1694026,67.3,48999,2.8
Delaware,1988,5,345849,69.3,336039,67.3,9810,2.8
District of Columbia,1988,5,330589,70.8,313798,67.2,16791,5.1
Florida,1988,5,6044759,62.8,5734359,59.5,310400,5.1
Georgia,1988,5,3140371,67.9,2961667,64.0,178704,5.7
Hawaii,1988,5,516762,66.7,500983,64.6,15779,3.1
Idaho,1988,5,476283,66.6,446396,62.4,29887,6.3
Illinois,1988,5,5800391,66.0,5401781,61.5,398610,6.9
Indiana,1988,5,2772427,66.2,2629489,62.8,142938,5.2
Iowa,1988,5,1485554,69.2,1415416,65.9,70138,4.7
Kansas,1988,5,1272414,69.0,1214998,65.9,57416,4.5
Kentucky,1988,5,1708701,61.3,1579136,56.6,129565,7.6
Louisiana,1988,5,1928779,60.8,1720853,54.3,207926,10.8
Maine,1988,5,594551,65.1,573236,62.8,21315,3.6
Maryland,1988,5,2450964,69.9,2347574,67.0,103390,4.2
Massachusetts,1988,5,3146797,68.2,3045360,66.0,101437,3.2
Michigan,1988,5,4530290,65.0,4187648,60.1,342642,7.6
Minnesota,1988,5,2307409,71.3,2208460,68.2,98949,4.3
Mississippi,1988,5,1139179,60.4,1044383,55.4,94796,8.3
Missouri,1988,5,2583590,66.3,2436653,62.6,146937,5.7
Montana,1988,5,403470,67.7,376061,63.1,27409,6.8
Nebraska,1988,5,815575,68.6,786819,66.2,28756,3.5
Nevada,1988,5,576670,72.5,545953,68.7,30717,5.3
New Hampshire,1988,5,591376,72.0,577868,70.4,13508,2.3
New Jersey,1988,5,3964196,65.7,3816962,63.3,147234,3.7
New Mexico,1988,5,682903,63.1,629275,58.2,53628,7.9
New York,1988,5,8509303,61.7,8166770,59.2,342533,4.0
New York city,1988,5,3220217,55.2,3067659,52.6,152558,4.7
North Carolina,1988,5,3317352,68.1,3197485,65.7,119867,3.6
North Dakota,1988,5,330421,68.6,315255,65.4,15166,4.6
Ohio,1988,5,5309650,64.5,4985496,60.6,324154,6.1
Oklahoma,1988,5,1521487,63.8,1426221,59.8,95266,6.3
Oregon,1988,5,1422911,67.2,1339667,63.3,83244,5.9
Pennsylvania,1988,5,5736864,61.4,5440867,58.3,295997,5.2
Rhode Island,1988,5,515042,67.2,500960,65.3,14082,2.7
South Carolina,1988,5,1656851,65.5,1578594,62.4,78257,4.7
South Dakota,1988,5,356276,68.8,341616,65.9,14660,4.1
Tennessee,1988,5,2330751,62.7,2196189,59.1,134562,5.8
Texas,1988,5,8329523,69.1,7705531,63.9,623992,7.5
Utah,1988,5,755611,69.0,718049,65.6,37562,5.0
Vermont,1988,5,298058,70.8,289609,68.8,8449,2.8
Virginia,1988,5,3079182,68.8,2960289,66.2,118893,3.9
Washington,1988,5,2318521,66.9,2171177,62.6,147344,6.4
West Virginia,1988,5,742870,51.5,667761,46.3,75109,10.1
Wisconsin,1988,5,2537758,69.6,2426272,66.5,111486,4.4
Wyoming,1988,5,238780,69.0,223644,64.6,15136,6.3
Alabama,1988,6,1867290,61.1,1732527,56.7,134763,7.2
Alaska,1988,6,249929,72.0,227862,65.7,22067,8.8
Arizona,1988,6,1655749,64.4,1546838,60.2,108911,6.6
Arkansas,1988,6,1106887,62.0,1021123,57.2,85764,7.7
California,1988,6,14111124,67.3,13363692,63.8,747432,5.3
Los Angeles County,1988,6,4314894,67.1,4096132,63.7,218762,5.1
Colorado,1988,6,1709268,69.9,1599123,65.4,110145,6.4
Connecticut,1988,6,1744735,69.3,1695224,67.3,49511,2.8
Delaware,1988,6,347569,69.5,337589,67.5,9980,2.9
District of Columbia,1988,6,330312,70.7,313847,67.2,16465,5.0
Florida,1988,6,6058755,62.8,5747937,59.6,310818,5.1
Georgia,1988,6,3146734,67.9,2969886,64.1,176848,5.6
Hawaii,1988,6,517320,66.7,501608,64.6,15712,3.0
Idaho,1988,6,478238,66.8,448597,62.7,29641,6.2
Illinois,1988,6,5809638,66.1,5415772,61.6,393866,6.8
Indiana,1988,6,2781326,66.4,2637374,62.9,143952,5.2
Iowa,1988,6,1488348,69.3,1418539,66.0,69809,4.7
Kansas,1988,6,1273530,69.0,1216220,65.9,57310,4.5
Kentucky,1988,6,1710758,61.3,1581544,56.7,129214,7.6
Louisiana,1988,6,1926396,60.8,1720212,54.3,206184,10.7
Maine,1988,6,596312,65.2,574325,62.8,21987,3.7
Maryland,1988,6,2455393,69.9,2351752,67.0,103641,4.2
Massachusetts,1988,6,3149646,68.3,3046929,66.1,102717,3.3
Michigan,1988,6,4534164,65.1,4197381,60.2,336783,7.4
Minnesota,1988,6,2311114,71.3,2211656,68.2,99458,4.3
Mississippi,1988,6,1138896,60.4,1043558,55.4,95338,8.4
Missouri,1988,6,2589898,66.4,2440758,62.6,149140,5.8
Montana,1988,6,403689,67.7,376384,63.2,27305,6.8
Nebraska,1988,6,816676,68.7,788207,66.3,28469,3.5
Nevada,1988,6,579009,72.6,548433,68.7,30576,5.3
New Hampshire,1988,6,592800,72.1,578815,70.4,13985,2.4
New Jersey,1988,6,3965714,65.7,3818294,63.3,147420,3.7
New Mexico,1988,6,683054,63.1,630464,58.2,52590,7.7
New York,1988,6,8523291,61.7,8173862,59.2,349429,4.1
New York city,1988,6,3225153,55.3,3067498,52.6,157655,4.9
North Carolina,1988,6,3325066,68.2,3205717,65.8,119349,3.6
North Dakota,1988,6,330525,68.6,315318,65.4,15207,4.6
Ohio,1988,6,5316940,64.6,4996880,60.7,320060,6.0
Oklahoma,1988,6,1519697,63.7,1424291,59.7,95406,6.3
Oregon,1988,6,1425659,67.2,1342584,63.3,83075,5.8
Pennsylvania,1988,6,5746515,61.5,5451597,58.4,294918,5.1
Rhode Island,1988,6,516032,67.2,501578,65.3,14454,2.8
South Carolina,1988,6,1658377,65.5,1580788,62.4,77589,4.7
South Dakota,1988,6,356516,68.7,342101,65.9,14415,4.0
Tennessee,1988,6,2329995,62.6,2194898,59.0,135097,5.8
Texas,1988,6,8337076,69.1,7720552,64.0,616524,7.4
Utah,1988,6,757164,69.1,719803,65.7,37361,4.9
Vermont,1988,6,298726,70.8,290187,68.8,8539,2.9
Virginia,1988,6,3084561,68.9,2963402,66.1,121159,3.9
Washington,1988,6,2327017,67.0,2179491,62.7,147526,6.3
West Virginia,1988,6,742443,51.5,668183,46.4,74260,10.0
Wisconsin,1988,6,2545950,69.8,2435362,66.7,110588,4.3
Wyoming,1988,6,238791,69.2,223659,64.8,15132,6.3
Alabama,1988,7,1870241,61.1,1734921,56.7,135320,7.2
Alaska,1988,7,250513,72.2,228541,65.9,21972,8.8
Arizona,1988,7,1663625,64.6,1554091,60.3,109534,6.6
Arkansas,1988,7,1107623,62.1,1021981,57.3,85642,7.7
California,1988,7,14146708,67.4,13397748,63.8,748960,5.3
Los Angeles County,1988,7,4317427,67.1,4097858,63.7,219569,5.1
Colorado,1988,7,1708087,69.8,1598855,65.4,109232,6.4
Connecticut,1988,7,1746771,69.3,1696669,67.4,50102,2.9
Delaware,1988,7,349074,69.7,338787,67.6,10287,2.9
District of Columbia,1988,7,329779,70.8,313610,67.3,16169,4.9
Florida,1988,7,6075287,62.8,5763308,59.6,311979,5.1
Georgia,1988,7,3152774,67.9,2977668,64.2,175106,5.6
Hawaii,1988,7,517958,66.7,502236,64.6,15722,3.0
Idaho,1988,7,480234,67.1,450838,63.0,29396,6.1
Illinois,1988,7,5824376,66.2,5434411,61.8,389965,6.7
Indiana,1988,7,2791990,66.6,2646735,63.1,145255,5.2
Iowa,1988,7,1490793,69.3,1421543,66.1,69250,4.6
Kansas,1988,7,1275171,69.0,1217915,65.9,57256,4.5
Kentucky,1988,7,1713923,61.4,1585151,56.8,128772,7.5
Louisiana,1988,7,1924362,60.8,1720213,54.3,204149,10.6
Maine,1988,7,598492,65.3,575824,62.9,22668,3.8
Maryland,1988,7,2460354,70.0,2356208,67.0,104146,4.2
Massachusetts,1988,7,3153019,68.3,3048898,66.1,104121,3.3
Michigan,1988,7,4541559,65.1,4207374,60.4,334185,7.4
Minnesota,1988,7,2314726,71.3,2214877,68.3,99849,4.3
Mississippi,1988,7,1140206,60.5,1043703,55.3,96503,8.5
Missouri,1988,7,2595614,66.6,2445227,62.7,150387,5.8
Montana,1988,7,404099,67.8,377054,63.3,27045,6.7
Nebraska,1988,7,817699,68.7,789543,66.3,28156,3.4
Nevada,1988,7,581285,72.6,550934,68.8,30351,5.2
New Hampshire,1988,7,594259,72.1,579815,70.4,14444,2.4
New Jersey,1988,7,3967666,65.7,3819722,63.3,147944,3.7
New Mexico,1988,7,683206,63.0,631817,58.3,51389,7.5
New York,1988,7,8541837,61.9,8183813,59.3,358024,4.2
New York city,1988,7,3231907,55.4,3068612,52.6,163295,5.1
North Carolina,1988,7,3333313,68.3,3213148,65.9,120165,3.6
North Dakota,1988,7,330676,68.6,315451,65.4,15225,4.6
Ohio,1988,7,5324442,64.6,5007357,60.8,317085,6.0
Oklahoma,1988,7,1519561,63.8,1423572,59.7,95989,6.3
Oregon,1988,7,1428946,67.3,1346460,63.4,82486,5.8
Pennsylvania,1988,7,5758664,61.6,5463871,58.5,294793,5.1
Rhode Island,1988,7,517124,67.3,502104,65.4,15020,2.9
South Carolina,1988,7,1660196,65.5,1583554,62.5,76642,4.6
South Dakota,1988,7,356890,68.8,342612,66.0,14278,4.0
Tennessee,1988,7,2330044,62.6,2194304,58.9,135740,5.8
Texas,1988,7,8346901,69.2,7736271,64.1,610630,7.3
Utah,1988,7,759008,69.2,721764,65.8,37244,4.9
Vermont,1988,7,299390,70.8,290641,68.7,8749,2.9
Virginia,1988,7,3089543,68.9,2966231,66.1,123312,4.0
Washington,1988,7,2336137,67.1,2188802,62.9,147335,6.3
West Virginia,1988,7,741593,51.5,668259,46.4,73334,9.9
Wisconsin,1988,7,2553964,69.9,2444152,66.9,109812,4.3
Wyoming,1988,7,238864,69.2,223655,64.8,15209,6.4
Alabama,1988,8,1874400,61.3,1738124,56.8,136276,7.3
Alaska,1988,8,251295,72.4,229426,66.1,21869,8.7
Arizona,1988,8,1671986,64.8,1562297,60.6,109689,6.6
Arkansas,1988,8,1108522,62.1,1023154,57.3,85368,7.7
California,1988,8,14183783,67.4,13433877,63.9,749906,5.3
Los Angeles County,1988,8,4323244,67.1,4102443,63.6,220801,5.1
Colorado,1988,8,1706192,69.7,1598071,65.3,108121,6.3
Connecticut,1988,8,1748586,69.4,1697856,67.4,50730,2.9
Delaware,1988,8,350253,69.8,339616,67.7,10637,3.0
District of Columbia,1988,8,329001,70.8,313063,67.3,15938,4.8
Florida,1988,8,6094344,62.9,5779950,59.7,314394,5.2
Georgia,1988,8,3158682,68.0,2984733,64.3,173949,5.5
Hawaii,1988,8,518578,66.7,502738,64.6,15840,3.1
Idaho,1988,8,482146,67.2,453026,63.2,29120,6.0
Illinois,1988,8,5844158,66.4,5456760,62.0,387398,6.6
Indiana,1988,8,2803595,66.8,2657083,63.3,146512,5.2
Iowa,1988,8,1493307,69.5,1424665,66.3,68642,4.6
Kansas,1988,8,1277083,69.1,1219767,66.0,57316,4.5
Kentucky,1988,8,1717316,61.5,1589273,56.9,128043,7.5
Louisiana,1988,8,1922628,60.7,1720794,54.4,201834,10.5
Maine,1988,8,600768,65.5,577609,63.0,23159,3.9
Maryland,1988,8,2465226,70.0,2360808,67.1,104418,4.2
Massachusetts,1988,8,3157099,68.4,3051463,66.1,105636,3.3
Michigan,1988,8,4552128,65.3,4217933,60.5,334195,7.3
Minnesota,1988,8,2318216,71.4,2218000,68.3,100216,4.3
Mississippi,1988,8,1142738,60.6,1044730,55.4,98008,8.6
Missouri,1988,8,2600682,66.7,2449729,62.8,150953,5.8
Montana,1988,8,404649,67.9,378007,63.4,26642,6.6
Nebraska,1988,8,818522,68.8,790716,66.4,27806,3.4
Nevada,1988,8,583438,72.6,553420,68.8,30018,5.1
New Hampshire,1988,8,595596,72.2,580782,70.4,14814,2.5
New Jersey,1988,8,3970325,65.8,3821490,63.3,148835,3.7
New Mexico,1988,8,683479,63.0,633268,58.4,50211,7.3
New York,1988,8,8562348,62.0,8195330,59.3,367018,4.3
New York city,1988,8,3240128,55.5,3071165,52.6,168963,5.2
North Carolina,1988,8,3341460,68.4,3219857,65.9,121603,3.6
North Dakota,1988,8,330852,68.6,315618,65.5,15234,4.6
Ohio,1988,8,5332602,64.7,5016905,60.9,315697,5.9
Oklahoma,1988,8,1520753,63.8,1424211,59.8,96542,6.3
Oregon,1988,8,1433303,67.4,1351812,63.6,81491,5.7
Pennsylvania,1988,8,5771235,61.7,5476555,58.6,294680,5.1
Rhode Island,1988,8,518111,67.5,502482,65.4,15629,3.0
South Carolina,1988,8,1662419,65.5,1586944,62.5,75475,4.5
South Dakota,1988,8,357366,68.9,343104,66.1,14262,4.0
Tennessee,1988,8,2330569,62.5,2194178,58.9,136391,5.9
Texas,1988,8,8358965,69.2,7752107,64.2,606858,7.3
Utah,1988,8,760976,69.3,723908,65.9,37068,4.9
Vermont,1988,8,299957,70.7,290936,68.6,9021,3.0
Virginia,1988,8,3093823,68.9,2969031,66.1,124792,4.0
Washington,1988,8,2345314,67.3,2198882,63.1,146432,6.2
West Virginia,1988,8,740533,51.5,668064,46.4,72469,9.8
Wisconsin,1988,8,2561626,70.1,2452581,67.1,109045,4.3
Wyoming,1988,8,238937,69.3,223631,64.8,15306,6.4
Alabama,1988,9,1879024,61.4,1741612,56.9,137412,7.3
Alaska,1988,9,252087,72.4,230369,66.2,21718,8.6
Arizona,1988,9,1680165,65.0,1570895,60.8,109270,6.5
Arkansas,1988,9,1109761,62.1,1024828,57.4,84933,7.7
California,1988,9,14221295,67.5,13471753,63.9,749542,5.3
Los Angeles County,1988,9,4331857,67.1,4109948,63.7,221909,5.1
Colorado,1988,9,1703488,69.6,1596865,65.2,106623,6.3
Connecticut,1988,9,1750061,69.5,1698713,67.5,51348,2.9
Delaware,1988,9,351140,69.8,340222,67.6,10918,3.1
District of Columbia,1988,9,328032,70.7,312237,67.3,15795,4.8
Florida,1988,9,6114922,63.0,5796572,59.7,318350,5.2
Georgia,1988,9,3164521,68.1,2991044,64.3,173477,5.5
Hawaii,1988,9,519173,66.6,503171,64.6,16002,3.1
Idaho,1988,9,483922,67.4,455066,63.4,28856,6.0
Illinois,1988,9,5867034,66.7,5481590,62.3,385444,6.6
Indiana,1988,9,2815059,67.1,2667875,63.6,147184,5.2
Iowa,1988,9,1496322,69.6,1428219,66.4,68103,4.6
Kansas,1988,9,1278876,69.2,1221446,66.1,57430,4.5
Kentucky,1988,9,1720362,61.6,1593550,57.1,126812,7.4
Louisiana,1988,9,1920916,60.7,1721625,54.4,199291,10.4
Maine,1988,9,602794,65.7,579500,63.1,23294,3.9
Maryland,1988,9,2469388,70.1,2365533,67.1,103855,4.2
Massachusetts,1988,9,3161930,68.5,3054748,66.2,107182,3.4
Michigan,1988,9,4564186,65.5,4229523,60.7,334663,7.3
Minnesota,1988,9,2321724,71.5,2221100,68.4,100624,4.3
Mississippi,1988,9,1145857,60.7,1046489,55.5,99368,8.7
Missouri,1988,9,2605041,66.8,2453903,62.9,151138,5.8
Montana,1988,9,405180,68.0,379024,63.6,26156,6.5
Nebraska,1988,9,818940,68.8,791585,66.5,27355,3.3
Nevada,1988,9,585521,72.5,555881,68.8,29640,5.1
New Hampshire,1988,9,596753,72.2,581713,70.4,15040,2.5
New Jersey,1988,9,3974238,65.9,3824193,63.4,150045,3.8
New Mexico,1988,9,683888,63.0,634720,58.4,49168,7.2
New York,1988,9,8582323,62.2,8206697,59.4,375626,4.4
New York city,1988,9,3249887,55.7,3075134,52.7,174753,5.4
North Carolina,1988,9,3348333,68.5,3225728,66.0,122605,3.7
North Dakota,1988,9,330988,68.8,315745,65.6,15243,4.6
Ohio,1988,9,5342334,64.8,5027289,61.0,315045,5.9
Oklahoma,1988,9,1522631,63.9,1425995,59.8,96636,6.3
Oregon,1988,9,1438831,67.6,1358466,63.8,80365,5.6
Pennsylvania,1988,9,5782752,61.8,5489204,58.7,293548,5.1
Rhode Island,1988,9,518804,67.6,502738,65.5,16066,3.1
South Carolina,1988,9,1665098,65.6,1590692,62.6,74406,4.5
South Dakota,1988,9,357871,69.0,343545,66.2,14326,4.0
Tennessee,1988,9,2331856,62.5,2195197,58.9,136659,5.9
Texas,1988,9,8372425,69.2,7767712,64.2,604713,7.2
Utah,1988,9,762998,69.4,726254,66.1,36744,4.8
Vermont,1988,9,300435,70.9,291155,68.7,9280,3.1
Virginia,1988,9,3097389,68.9,2972115,66.1,125274,4.0
Washington,1988,9,2354391,67.4,2209311,63.2,145080,6.2
West Virginia,1988,9,739594,51.4,667796,46.4,71798,9.7
Wisconsin,1988,9,2568988,70.3,2460629,67.3,108359,4.2
Wyoming,1988,9,238972,69.3,223594,64.8,15378,6.4
Alabama,1988,10,1883380,61.5,1745275,57.0,138105,7.3
Alaska,1988,10,252662,72.6,231235,66.4,21427,8.5
Arizona,1988,10,1687274,65.2,1579328,61.0,107946,6.4
Arkansas,1988,10,1111288,62.2,1027017,57.5,84271,7.6
California,1988,10,14257687,67.5,13511723,64.0,745964,5.2
Los Angeles County,1988,10,4341941,67.2,4119797,63.7,222144,5.1
Colorado,1988,10,1700219,69.4,1595574,65.1,104645,6.2
Connecticut,1988,10,1751502,69.6,1699638,67.5,51864,3.0
Delaware,1988,10,351831,69.9,340801,67.8,11030,3.1
District of Columbia,1988,10,326862,70.6,311188,67.2,15674,4.8
Florida,1988,10,6134982,63.1,5812344,59.8,322638,5.3
Georgia,1988,10,3169997,68.1,2996866,64.4,173131,5.5
Hawaii,1988,10,519809,66.6,503766,64.6,16043,3.1
Idaho,1988,10,485522,67.6,456978,63.6,28544,5.9
Illinois,1988,10,5891251,66.9,5508962,62.6,382289,6.5
Indiana,1988,10,2825208,67.3,2678992,63.8,146216,5.2
Iowa,1988,10,1499779,69.7,1432299,66.6,67480,4.5
Kansas,1988,10,1280245,69.2,1222841,66.1,57404,4.5
Kentucky,1988,10,1722851,61.7,1598075,57.2,124776,7.2
Louisiana,1988,10,1918722,60.6,1722578,54.4,196144,10.2
Maine,1988,10,604314,65.8,581380,63.3,22934,3.8
Maryland,1988,10,2472769,70.1,2370628,67.2,102141,4.1
Massachusetts,1988,10,3166924,68.6,3058448,66.3,108476,3.4
Michigan,1988,10,4575011,65.6,4241855,60.8,333156,7.3
Minnesota,1988,10,2324678,71.5,2224177,68.4,100501,4.3
Mississippi,1988,10,1148775,60.8,1048802,55.6,99973,8.7
Missouri,1988,10,2608862,66.8,2457795,63.0,151067,5.8
Montana,1988,10,405492,68.0,379876,63.7,25616,6.3
Nebraska,1988,10,818876,68.8,792144,66.5,26732,3.3
Nevada,1988,10,587521,72.4,558297,68.8,29224,5.0
New Hampshire,1988,10,597763,72.3,582705,70.5,15058,2.5
New Jersey,1988,10,3979477,65.9,3828573,63.4,150904,3.8
New Mexico,1988,10,684393,63.0,636164,58.5,48229,7.0
New York,1988,10,8598269,62.3,8216318,59.5,381951,4.4
New York city,1988,10,3260127,55.9,3080176,52.8,179951,5.5
North Carolina,1988,10,3353145,68.5,3230532,66.0,122613,3.7
North Dakota,1988,10,330992,68.8,315801,65.7,15191,4.6
Ohio,1988,10,5353991,64.9,5041177,61.1,312814,5.8
Oklahoma,1988,10,1524409,63.9,1428305,59.9,96104,6.3
Oregon,1988,10,1445019,67.7,1365649,64.0,79370,5.5
Pennsylvania,1988,10,5792679,61.9,5502214,58.8,290465,5.0
Rhode Island,1988,10,519209,67.6,503005,65.5,16204,3.1
South Carolina,1988,10,1667953,65.6,1594465,62.7,73488,4.4
South Dakota,1988,10,358296,69.0,343940,66.3,14356,4.0
Tennessee,1988,10,2333709,62.5,2197831,58.9,135878,5.8
Texas,1988,10,8385011,69.3,7783217,64.3,601794,7.2
Utah,1988,10,765060,69.6,728795,66.3,36265,4.7
Vermont,1988,10,300932,70.8,291477,68.6,9455,3.1
Virginia,1988,10,3100000,68.9,2975416,66.1,124584,4.0
Washington,1988,10,2362972,67.5,2219607,63.4,143365,6.1
West Virginia,1988,10,738815,51.4,667718,46.4,71097,9.6
Wisconsin,1988,10,2575719,70.4,2468212,67.5,107507,4.2
Wyoming,1988,10,238952,69.3,223575,64.8,15377,6.4
Alabama,1988,11,1886984,61.6,1748902,57.1,138082,7.3
Alaska,1988,11,252998,72.7,232041,66.7,20957,8.3
Arizona,1988,11,1692780,65.3,1587076,61.3,105704,6.2
Arkansas,1988,11,1113069,62.3,1029600,57.6,83469,7.5
California,1988,11,14292441,67.5,13552984,64.1,739457,5.2
Los Angeles County,1988,11,4352272,67.2,4130486,63.8,221786,5.1
Colorado,1988,11,1696923,69.2,1594600,65.1,102323,6.0
Connecticut,1988,11,1753191,69.6,1700858,67.5,52333,3.0
Delaware,1988,11,352490,69.9,341535,67.8,10955,3.1
District of Columbia,1988,11,325445,70.4,309925,67.1,15520,4.8
Florida,1988,11,6153178,63.1,5826739,59.8,326439,5.3
Georgia,1988,11,3174815,68.1,3002200,64.4,172615,5.4
Hawaii,1988,11,520538,66.7,504696,64.6,15842,3.0
Idaho,1988,11,486917,67.7,458764,63.8,28153,5.8
Illinois,1988,11,5915629,67.2,5538628,62.9,377001,6.4
Indiana,1988,11,2833444,67.4,2690261,64.0,143183,5.1
Iowa,1988,11,1503035,69.9,1436378,66.8,66657,4.4
Kansas,1988,11,1281072,69.3,1224005,66.2,57067,4.5
Kentucky,1988,11,1724797,61.8,1602758,57.4,122039,7.1
Louisiana,1988,11,1916068,60.6,1723774,54.5,192294,10.0
Maine,1988,11,605227,65.8,583084,63.4,22143,3.7
Maryland,1988,11,2475719,70.1,2376087,67.3,99632,4.0
Massachusetts,1988,11,3171461,68.7,3061892,66.3,109569,3.5
Michigan,1988,11,4582763,65.7,4254278,61.0,328485,7.2
Minnesota,1988,11,2326765,71.5,2227013,68.5,99752,4.3
Mississippi,1988,11,1151050,60.9,1051322,55.7,99728,8.7
Missouri,1988,11,2612271,66.9,2461518,63.1,150753,5.8
Montana,1988,11,405515,68.0,380424,63.8,25091,6.2
Nebraska,1988,11,818501,68.7,792492,66.5,26009,3.2
Nevada,1988,11,589420,72.3,560608,68.8,28812,4.9
New Hampshire,1988,11,598662,72.2,583743,70.4,14919,2.5
New Jersey,1988,11,3985432,66.0,3834295,63.5,151137,3.8
New Mexico,1988,11,684894,62.9,637567,58.6,47327,6.9
New York,1988,11,8609413,62.4,8223746,59.6,385667,4.5
New York city,1988,11,3270518,56.0,3086250,52.9,184268,5.6
North Carolina,1988,11,3356516,68.5,3234884,66.0,121632,3.6
North Dakota,1988,11,330827,68.9,315765,65.8,15062,4.6
Ohio,1988,11,5366645,65.1,5058986,61.3,307659,5.7
Oklahoma,1988,11,1525457,64.0,1430481,60.0,94976,6.2
Oregon,1988,11,1451382,67.9,1372573,64.3,78809,5.4
Pennsylvania,1988,11,5801803,62.0,5515997,59.0,285806,4.9
Rhode Island,1988,11,519474,67.6,503327,65.5,16147,3.1
South Carolina,1988,11,1670740,65.6,1598013,62.8,72727,4.4
South Dakota,1988,11,358598,69.1,344301,66.3,14297,4.0
Tennessee,1988,11,2336138,62.6,2202281,59.0,133857,5.7
Texas,1988,11,8395939,69.3,7798516,64.3,597423,7.1
Utah,1988,11,767219,69.7,731446,66.4,35773,4.7
Vermont,1988,11,301555,71.0,291992,68.7,9563,3.2
Virginia,1988,11,3102195,68.8,2979155,66.1,123040,4.0
Washington,1988,11,2371171,67.6,2229482,63.6,141689,6.0
West Virginia,1988,11,738229,51.4,667996,46.5,70233,9.5
Wisconsin,1988,11,2581604,70.6,2475041,67.7,106563,4.1
Wyoming,1988,11,238869,69.2,223600,64.8,15269,6.4
Alabama,1988,12,1889429,61.6,1752163,57.2,137266,7.3
Alaska,1988,12,253180,72.8,232884,66.9,20296,8.0
Arizona,1988,12,1696837,65.4,1594249,61.5,102588,6.0
Arkansas,1988,12,1114945,62.4,1032322,57.7,82623,7.4
California,1988,12,14324937,67.6,13593580,64.1,731357,5.1
Los Angeles County,1988,12,4361927,67.3,4140489,63.8,221438,5.1
Colorado,1988,12,1694153,69.1,1594226,65.0,99927,5.9
Connecticut,1988,12,1755055,69.7,1702200,67.6,52855,3.0
Delaware,1988,12,353229,69.9,342475,67.8,10754,3.0
District of Columbia,1988,12,323796,70.2,308472,66.9,15324,4.7
Florida,1988,12,6168308,63.2,5838786,59.8,329522,5.3
Georgia,1988,12,3178610,68.1,3006807,64.4,171803,5.4
Hawaii,1988,12,521386,66.7,506025,64.7,15361,2.9
Idaho,1988,12,488080,67.8,460354,63.9,27726,5.7
Illinois,1988,12,5938284,67.4,5568427,63.2,369857,6.2
Indiana,1988,12,2839361,67.6,2700804,64.3,138557,4.9
Iowa,1988,12,1505250,69.9,1439606,66.9,65644,4.4
Kansas,1988,12,1281304,69.3,1225000,66.2,56304,4.4
Kentucky,1988,12,1726045,61.8,1607039,57.5,119006,6.9
Louisiana,1988,12,1913043,60.5,1725301,54.6,187742,9.8
Maine,1988,12,605614,65.8,584409,63.5,21205,3.5
Maryland,1988,12,2478550,70.1,2381555,67.4,96995,3.9
Massachusetts,1988,12,3175218,68.8,3064570,66.4,110648,3.5
Michigan,1988,12,4586562,65.7,4265488,61.1,321074,7.0
Minnesota,1988,12,2328119,71.5,2229353,68.5,98766,4.2
Mississippi,1988,12,1152532,61.0,1053725,55.8,98807,8.6
Missouri,1988,12,2614851,67.0,2465032,63.1,149819,5.7
Montana,1988,12,405328,68.0,380673,63.9,24655,6.1
Nebraska,1988,12,817917,68.6,792668,66.5,25249,3.1
Nevada,1988,12,591235,72.3,562792,68.8,28443,4.8
New Hampshire,1988,12,599395,72.2,584620,70.4,14775,2.5
New Jersey,1988,12,3990632,66.1,3839916,63.6,150716,3.8
New Mexico,1988,12,685370,62.9,638932,58.7,46438,6.8
New York,1988,12,8617608,62.4,8229591,59.6,388017,4.5
New York city,1988,12,3281371,56.2,3092991,53.0,188380,5.7
North Carolina,1988,12,3359549,68.5,3239395,66.1,120154,3.6
North Dakota,1988,12,330542,68.9,315674,65.8,14868,4.5
Ohio,1988,12,5377992,65.2,5077815,61.6,300177,5.6
Oklahoma,1988,12,1525435,64.0,1432009,60.1,93426,6.1
Oregon,1988,12,1457273,68.1,1378581,64.4,78692,5.4
Pennsylvania,1988,12,5810596,62.1,5529839,59.1,280757,4.8
Rhode Island,1988,12,519638,67.6,503562,65.5,16076,3.1
South Carolina,1988,12,1673120,65.7,1601127,62.8,71993,4.3
South Dakota,1988,12,358772,69.1,344622,66.4,14150,3.9
Tennessee,1988,12,2338864,62.6,2208144,59.1,130720,5.6
Texas,1988,12,8404314,69.3,7812770,64.4,591544,7.0
Utah,1988,12,769583,69.8,734158,66.6,35425,4.6
Vermont,1988,12,302301,71.0,292652,68.7,9649,3.2
Virginia,1988,12,3104715,68.8,2983622,66.1,121093,3.9
Washington,1988,12,2379258,67.7,2238750,63.7,140508,5.9
West Virginia,1988,12,737722,51.4,668465,46.6,69257,9.4
Wisconsin,1988,12,2586411,70.7,2480464,67.8,105947,4.1
Wyoming,1988,12,238744,69.2,223681,64.8,15063,6.3
Alabama,1989,1,1891022,61.7,1755003,57.2,136019,7.2
Alaska,1989,1,253357,72.6,233861,67.0,19496,7.7
Arizona,1989,1,1699795,65.4,1600875,61.6,98920,5.8
Arkansas,1989,1,1116875,62.5,1035014,57.9,81861,7.3
California,1989,1,14356113,67.6,13632369,64.2,723744,5.0
Los Angeles County,1989,1,4370849,67.3,4149193,63.9,221656,5.1
Colorado,1989,1,1692383,69.0,1594520,65.0,97863,5.8
Connecticut,1989,1,1756918,69.8,1703366,67.7,53552,3.0
Delaware,1989,1,354064,70.0,343512,67.9,10552,3.0
District of Columbia,1989,1,322087,70.0,306959,66.7,15128,4.7
Florida,1989,1,6180938,63.2,5848615,59.8,332323,5.4
Georgia,1989,1,3182025,68.1,3010920,64.5,171105,5.4
Hawaii,1989,1,522450,66.7,507785,64.9,14665,2.8
Idaho,1989,1,488993,67.8,461673,64.0,27320,5.6
Illinois,1989,1,5958858,67.6,5596611,63.5,362247,6.1
Indiana,1989,1,2843716,67.6,2710363,64.5,133353,4.7
Iowa,1989,1,1506117,70.0,1441574,67.0,64543,4.3
Kansas,1989,1,1281114,69.2,1225840,66.3,55274,4.3
Kentucky,1989,1,1726989,61.8,1610788,57.7,116201,6.7
Louisiana,1989,1,1910152,60.4,1727541,54.7,182611,9.6
Maine,1989,1,605774,65.7,585333,63.5,20441,3.4
Maryland,1989,1,2481695,70.2,2386786,67.5,94909,3.8
Massachusetts,1989,1,3178108,68.8,3066113,66.4,111995,3.5
Michigan,1989,1,4587543,65.7,4274317,61.3,313226,6.8
Minnesota,1989,1,2329392,71.5,2231408,68.5,97984,4.2
Mississippi,1989,1,1153629,61.0,1056095,55.9,97534,8.5
Missouri,1989,1,2616503,67.0,2468280,63.2,148223,5.7
Montana,1989,1,405081,68.0,380727,63.9,24354,6.0
Nebraska,1989,1,817197,68.6,792625,66.5,24572,3.0
Nevada,1989,1,593002,72.2,564854,68.8,28148,4.7
New Hampshire,1989,1,600071,72.2,585226,70.4,14845,2.5
New Jersey,1989,1,3993967,66.2,3844267,63.7,149700,3.7
New Mexico,1989,1,685955,62.9,640290,58.7,45665,6.7
New York,1989,1,8625311,62.5,8234904,59.6,390407,4.5
New York city,1989,1,3292547,56.4,3099543,53.1,193004,5.9
North Carolina,1989,1,3363608,68.5,3244715,66.1,118893,3.5
North Dakota,1989,1,330234,68.8,315609,65.8,14625,4.4
Ohio,1989,1,5387514,65.3,5095039,61.8,292475,5.4
Oklahoma,1989,1,1524651,63.9,1432884,60.1,91767,6.0
Oregon,1989,1,1462273,68.3,1383486,64.6,78787,5.4
Pennsylvania,1989,1,5819921,62.2,5543393,59.2,276528,4.8
Rhode Island,1989,1,519669,67.6,503566,65.5,16103,3.1
South Carolina,1989,1,1675087,65.7,1603663,62.9,71424,4.3
South Dakota,1989,1,358874,69.1,344918,66.5,13956,3.9
Tennessee,1989,1,2341852,62.6,2215009,59.3,126843,5.4
Texas,1989,1,8409874,69.3,7825605,64.4,584269,6.9
Utah,1989,1,772214,70.0,736891,66.8,35323,4.6
Vermont,1989,1,303105,71.2,293355,68.9,9750,3.2
Virginia,1989,1,3108323,68.8,2988944,66.2,119379,3.8
Washington,1989,1,2387905,67.9,2247839,63.9,140066,5.9
West Virginia,1989,1,741948,51.7,673612,46.9,68336,9.2
Wisconsin,1989,1,2590307,70.8,2484320,67.9,105987,4.1
Wyoming,1989,1,238642,69.2,223803,64.9,14839,6.2
Alabama,1989,2,1892378,61.7,1757381,57.3,134997,7.1
Alaska,1989,2,253659,72.7,234931,67.3,18728,7.4
Arizona,1989,2,1702033,65.4,1606490,61.7,95543,5.6
Arkansas,1989,2,1118612,62.5,1037209,58.0,81403,7.3
California,1989,2,14386737,67.6,13666952,64.2,719785,5.0
Los Angeles County,1989,2,4379579,67.3,4156287,63.9,223292,5.1
Colorado,1989,2,1691828,68.9,1595309,65.0,96519,5.7
Connecticut,1989,2,1758627,69.9,1704046,67.7,54581,3.1
Delaware,1989,2,354880,70.1,344357,68.1,10523,3.0
District of Columbia,1989,2,320383,70.0,305391,66.7,14992,4.7
Florida,1989,2,6192387,63.2,5856699,59.7,335688,5.4
Georgia,1989,2,3185672,68.1,3014529,64.5,171143,5.4
Hawaii,1989,2,523698,66.7,509780,64.9,13918,2.7
Idaho,1989,2,489604,67.8,462582,64.1,27022,5.5
Illinois,1989,2,5976591,67.8,5620673,63.7,355918,6.0
Indiana,1989,2,2847585,67.7,2718598,64.6,128987,4.5
Iowa,1989,2,1505551,70.0,1441972,67.0,63579,4.2
Kansas,1989,2,1280632,69.2,1226337,66.3,54295,4.2
Kentucky,1989,2,1728290,61.9,1614090,57.8,114200,6.6
Louisiana,1989,2,1907557,60.4,1730204,54.8,177353,9.3
Maine,1989,2,606009,65.7,585801,63.5,20208,3.3
Maryland,1989,2,2485435,70.2,2391452,67.5,93983,3.8
Massachusetts,1989,2,3180071,68.9,3066064,66.4,114007,3.6
Michigan,1989,2,4587099,65.7,4279202,61.3,307897,6.7
Minnesota,1989,2,2330890,71.5,2233040,68.5,97850,4.2
Mississippi,1989,2,1154893,61.1,1058609,56.0,96284,8.3
Missouri,1989,2,2617447,67.0,2470956,63.3,146491,5.6
Montana,1989,2,404995,68.0,380772,63.9,24223,6.0
Nebraska,1989,2,816379,68.5,792254,66.5,24125,3.0
Nevada,1989,2,594693,72.1,566706,68.7,27987,4.7
New Hampshire,1989,2,600816,72.2,585542,70.4,15274,2.5
New Jersey,1989,2,3994278,66.2,3845486,63.7,148792,3.7
New Mexico,1989,2,686705,62.9,641508,58.8,45197,6.6
New York,1989,2,8633416,62.5,8239330,59.7,394086,4.6
New York city,1989,2,3303605,56.6,3105311,53.2,198294,6.0
North Carolina,1989,2,3368766,68.5,3250399,66.1,118367,3.5
North Dakota,1989,2,329966,68.9,315572,65.9,14394,4.4
Ohio,1989,2,5394658,65.4,5107383,61.9,287275,5.3
Oklahoma,1989,2,1523694,63.9,1433324,60.1,90370,5.9
Oregon,1989,2,1466204,68.3,1387149,64.6,79055,5.4
Pennsylvania,1989,2,5829195,62.3,5554746,59.4,274449,4.7
Rhode Island,1989,2,519479,67.6,503200,65.4,16279,3.1
South Carolina,1989,2,1676829,65.7,1605319,62.9,71510,4.3
South Dakota,1989,2,358989,69.2,345178,66.5,13811,3.8
Tennessee,1989,2,2344833,62.7,2221779,59.4,123054,5.2
Texas,1989,2,8413285,69.2,7835551,64.5,577734,6.9
Utah,1989,2,774962,70.1,739474,66.9,35488,4.6
Vermont,1989,2,303840,71.2,293941,68.8,9899,3.3
Virginia,1989,2,3113388,68.8,2994836,66.2,118552,3.8
Washington,1989,2,2397426,68.0,2256863,64.0,140563,5.9
West Virginia,1989,2,746116,52.0,678342,47.3,67774,9.1
Wisconsin,1989,2,2593313,70.8,2486313,67.9,107000,4.1
Wyoming,1989,2,238572,69.4,223887,65.1,14685,6.2
Alabama,1989,3,1893970,61.7,1759554,57.4,134416,7.1
Alaska,1989,3,254223,72.8,236133,67.7,18090,7.1
Arizona,1989,3,1704235,65.4,1611303,61.9,92932,5.5
Arkansas,1989,3,1119912,62.6,1038803,58.1,81109,7.2
California,1989,3,14417513,67.6,13697894,64.3,719619,5.0
Los Angeles County,1989,3,4388126,67.4,4161841,63.9,226285,5.2
Colorado,1989,3,1692882,68.9,1597117,65.0,95765,5.7
Connecticut,1989,3,1760292,70.0,1704345,67.7,55947,3.2
Delaware,1989,3,355656,70.1,344914,68.0,10742,3.0
District of Columbia,1989,3,318729,69.7,303804,66.5,14925,4.7
Florida,1989,3,6204360,63.2,5865039,59.7,339321,5.5
Georgia,1989,3,3189788,68.1,3017976,64.5,171812,5.4
Hawaii,1989,3,525073,66.8,511856,65.1,13217,2.5
Idaho,1989,3,489883,67.8,463044,64.0,26839,5.5
Illinois,1989,3,5989473,67.9,5638351,63.9,351122,5.9
Indiana,1989,3,2851806,67.8,2725571,64.8,126235,4.4
Iowa,1989,3,1504388,69.9,1441386,66.9,63002,4.2
Kansas,1989,3,1279952,69.1,1226503,66.2,53449,4.2
Kentucky,1989,3,1730323,61.9,1617377,57.9,112946,6.5
Louisiana,1989,3,1904882,60.3,1733146,54.9,171736,9.0
Maine,1989,3,606634,65.7,585982,63.4,20652,3.4
Maryland,1989,3,2489823,70.3,2395756,67.6,94067,3.8
Massachusetts,1989,3,3181981,68.9,3065188,66.4,116793,3.7
Michigan,1989,3,4586574,65.7,4280656,61.3,305918,6.7
Minnesota,1989,3,2332812,71.5,2234441,68.5,98371,4.2
Mississippi,1989,3,1156594,61.2,1061539,56.1,95055,8.2
Missouri,1989,3,2618120,67.0,2473317,63.3,144803,5.5
Montana,1989,3,405328,68.0,381124,63.9,24204,6.0
Nebraska,1989,3,815630,68.4,791727,66.4,23903,2.9
Nevada,1989,3,596348,72.0,568455,68.7,27893,4.7
New Hampshire,1989,3,601787,72.2,585733,70.3,16054,2.7
New Jersey,1989,3,3991691,66.2,3843086,63.7,148605,3.7
New Mexico,1989,3,687679,63.0,642652,58.9,45027,6.5
New York,1989,3,8642072,62.6,8243436,59.7,398636,4.6
New York city,1989,3,3314123,56.7,3110580,53.3,203543,6.1
North Carolina,1989,3,3374690,68.6,3256135,66.2,118555,3.5
North Dakota,1989,3,329771,68.8,315582,65.9,14189,4.3
Ohio,1989,3,5399353,65.4,5114179,62.0,285174,5.3
Oklahoma,1989,3,1523368,63.9,1434114,60.1,89254,5.9
Oregon,1989,3,1469227,68.4,1389860,64.7,79367,5.4
Pennsylvania,1989,3,5836722,62.4,5562158,59.4,274564,4.7
Rhode Island,1989,3,519022,67.5,502428,65.3,16594,3.2
South Carolina,1989,3,1678907,65.7,1606574,62.9,72333,4.3
South Dakota,1989,3,359214,69.2,345455,66.6,13759,3.8
Tennessee,1989,3,2347725,62.7,2227705,59.5,120020,5.1
Texas,1989,3,8417010,69.2,7843835,64.5,573175,6.8
Utah,1989,3,777746,70.3,741986,67.1,35760,4.6
Vermont,1989,3,304441,71.1,294326,68.8,10115,3.3
Virginia,1989,3,3119900,68.9,3001310,66.3,118590,3.8
Washington,1989,3,2408187,68.2,2266387,64.2,141800,5.9
West Virginia,1989,3,750076,52.3,682525,47.6,67551,9.0
Wisconsin,1989,3,2595502,70.8,2486755,67.9,108747,4.2
Wyoming,1989,3,238542,69.3,223921,65.1,14621,6.1
Alabama,1989,4,1895717,61.8,1761463,57.4,134254,7.1
Alaska,1989,4,255196,73.1,237522,68.1,17674,6.9
Arizona,1989,4,1706577,65.4,1615174,61.9,91403,5.4
Arkansas,1989,4,1120815,62.6,1040060,58.1,80755,7.2
California,1989,4,14448840,67.7,13726087,64.3,722753,5.0
Los Angeles County,1989,4,4396585,67.4,4166261,63.8,230324,5.2
Colorado,1989,4,1695652,69.0,1600308,65.1,95344,5.6
Connecticut,1989,4,1761838,70.0,1704209,67.7,57629,3.3
Delaware,1989,4,356430,70.2,345300,68.0,11130,3.1
District of Columbia,1989,4,317276,69.6,302373,66.3,14903,4.7
Florida,1989,4,6217727,63.2,5874959,59.7,342768,5.5
Georgia,1989,4,3194262,68.2,3021497,64.5,172765,5.4
Hawaii,1989,4,526501,66.9,513817,65.3,12684,2.4
Idaho,1989,4,489833,67.8,463101,64.1,26732,5.5
Illinois,1989,4,5997211,68.0,5648894,64.0,348317,5.8
Indiana,1989,4,2856232,67.8,2730739,64.8,125493,4.4
Iowa,1989,4,1503246,69.8,1440221,66.9,63025,4.2
Kansas,1989,4,1279161,69.1,1226380,66.2,52781,4.1
Kentucky,1989,4,1732902,62.0,1620543,58.0,112359,6.5
Louisiana,1989,4,1901726,60.2,1736212,55.0,165514,8.7
Maine,1989,4,607909,65.7,586200,63.4,21709,3.6
Maryland,1989,4,2494564,70.3,2399920,67.6,94644,3.8
Massachusetts,1989,4,3183970,69.0,3063602,66.4,120368,3.8
Michigan,1989,4,4587304,65.7,4279912,61.3,307392,6.7
Minnesota,1989,4,2335221,71.6,2235852,68.5,99369,4.3
Mississippi,1989,4,1158654,61.2,1064804,56.3,93850,8.1
Missouri,1989,4,2619137,67.0,2475628,63.3,143509,5.5
Montana,1989,4,406078,68.1,381839,64.1,24239,6.0
Nebraska,1989,4,815072,68.3,791251,66.3,23821,2.9
Nevada,1989,4,597962,71.9,570166,68.5,27796,4.6
New Hampshire,1989,4,602971,72.3,585853,70.2,17118,2.8
New Jersey,1989,4,3987737,66.1,3837918,63.6,149819,3.8
New Mexico,1989,4,688878,63.0,643749,58.9,45129,6.6
New York,1989,4,8649910,62.7,8246296,59.7,403614,4.7
New York city,1989,4,3323292,56.9,3114991,53.3,208301,6.3
North Carolina,1989,4,3381035,68.7,3261480,66.2,119555,3.5
North Dakota,1989,4,329648,69.0,315610,66.0,14038,4.3
Ohio,1989,4,5402078,65.4,5116608,62.0,285470,5.3
Oklahoma,1989,4,1524016,63.9,1435514,60.2,88502,5.8
Oregon,1989,4,1471422,68.4,1391974,64.7,79448,5.4
Pennsylvania,1989,4,5841330,62.4,5564859,59.4,276471,4.7
Rhode Island,1989,4,518381,67.4,501364,65.2,17017,3.3
South Carolina,1989,4,1681800,65.7,1608044,62.8,73756,4.4
South Dakota,1989,4,359583,69.3,345776,66.6,13807,3.8
Tennessee,1989,4,2351329,62.8,2233210,59.6,118119,5.0
Texas,1989,4,8422596,69.1,7851985,64.5,570611,6.8
Utah,1989,4,780445,70.5,744462,67.3,35983,4.6
Vermont,1989,4,304852,71.2,294447,68.8,10405,3.4
Virginia,1989,4,3127076,69.0,3007940,66.4,119136,3.8
Washington,1989,4,2420132,68.4,2276813,64.3,143319,5.9
West Virginia,1989,4,753856,52.6,686380,47.9,67476,9.0
Wisconsin,1989,4,2596902,70.8,2486091,67.8,110811,4.3
Wyoming,1989,4,238539,69.3,223901,65.1,14638,6.1
Alabama,1989,5,1897363,61.8,1762934,57.4,134429,7.1
Alaska,1989,5,256450,73.3,238903,68.3,17547,6.8
Arizona,1989,5,1708660,65.4,1617923,61.9,90737,5.3
Arkansas,1989,5,1121600,62.7,1041341,58.2,80259,7.2
California,1989,5,14481655,67.7,13752764,64.3,728891,5.0
Los Angeles County,1989,5,4406031,67.4,4171026,63.8,235005,5.3
Colorado,1989,5,1699846,69.1,1604618,65.3,95228,5.6
Connecticut,1989,5,1763219,70.1,1703563,67.7,59656,3.4
Delaware,1989,5,357204,70.2,345598,67.9,11606,3.2
District of Columbia,1989,5,316243,69.5,301331,66.2,14912,4.7
Florida,1989,5,6232259,63.2,5886150,59.7,346109,5.6
Georgia,1989,5,3199052,68.2,3025249,64.5,173803,5.4
Hawaii,1989,5,527910,67.0,515504,65.4,12406,2.4
Idaho,1989,5,489641,67.6,462958,63.9,26683,5.4
Illinois,1989,5,6001708,68.0,5653094,64.0,348614,5.8
Indiana,1989,5,2859952,67.9,2733020,64.9,126932,4.4
Iowa,1989,5,1502281,69.8,1438640,66.8,63641,4.2
Kansas,1989,5,1278549,69.0,1226046,66.2,52503,4.1
Kentucky,1989,5,1735582,62.1,1623357,58.1,112225,6.5
Louisiana,1989,5,1897694,60.1,1738950,55.1,158744,8.4
Maine,1989,5,609733,65.8,586581,63.3,23152,3.8
Maryland,1989,5,2499396,70.4,2404031,67.7,95365,3.8
Massachusetts,1989,5,3185281,69.0,3060514,66.3,124767,3.9
Michigan,1989,5,4590951,65.7,4278022,61.3,312929,6.8
Minnesota,1989,5,2337883,71.6,2237270,68.5,100613,4.3
Mississippi,1989,5,1160754,61.3,1068098,56.4,92656,8.0
Missouri,1989,5,2620936,67.0,2477957,63.4,142979,5.5
Montana,1989,5,407070,68.3,382761,64.2,24309,6.0
Nebraska,1989,5,814777,68.3,790966,66.3,23811,2.9
Nevada,1989,5,599593,71.8,571843,68.5,27750,4.6
New Hampshire,1989,5,604310,72.3,585938,70.1,18372,3.0
New Jersey,1989,5,3984590,66.0,3831652,63.5,152938,3.8
New Mexico,1989,5,690375,63.1,644817,58.9,45558,6.6
New York,1989,5,8656355,62.7,8247234,59.7,409121,4.7
New York city,1989,5,3330384,57.0,3117822,53.4,212562,6.4
North Carolina,1989,5,3387247,68.7,3265982,66.2,121265,3.6
North Dakota,1989,5,329568,68.9,315588,66.0,13980,4.2
Ohio,1989,5,5404198,65.4,5116175,62.0,288023,5.3
Oklahoma,1989,5,1525169,63.9,1437084,60.2,88085,5.8
Oregon,1989,5,1472655,68.3,1393465,64.7,79190,5.4
Pennsylvania,1989,5,5842841,62.4,5563329,59.4,279512,4.8
Rhode Island,1989,5,517768,67.2,500173,65.0,17595,3.4
South Carolina,1989,5,1685403,65.8,1609745,62.8,75658,4.5
South Dakota,1989,5,360079,69.4,346134,66.7,13945,3.9
Tennessee,1989,5,2356358,62.9,2238804,59.7,117554,5.0
Texas,1989,5,8430701,69.1,7861047,64.5,569654,6.8
Utah,1989,5,783026,70.7,746876,67.4,36150,4.6
Vermont,1989,5,305057,71.1,294306,68.6,10751,3.5
Virginia,1989,5,3134119,69.1,3014108,66.4,120011,3.8
Washington,1989,5,2432650,68.6,2287756,64.5,144894,6.0
West Virginia,1989,5,757746,52.9,690299,48.2,67447,8.9
Wisconsin,1989,5,2597550,70.8,2484765,67.8,112785,4.3
Wyoming,1989,5,238570,69.4,223858,65.1,14712,6.2
Alabama,1989,6,1898894,61.8,1764236,57.4,134658,7.1
Alaska,1989,6,257816,73.7,240164,68.6,17652,6.8
Arizona,1989,6,1710315,65.4,1620037,61.9,90278,5.3
Arkansas,1989,6,1122517,62.7,1042874,58.2,79643,7.1
California,1989,6,14516703,67.7,13780211,64.3,736492,5.1
Los Angeles County,1989,6,4417299,67.5,4177819,63.8,239480,5.4
Colorado,1989,6,1705328,69.3,1609980,65.4,95348,5.6
Connecticut,1989,6,1764733,70.2,1702738,67.7,61995,3.5
Delaware,1989,6,357963,70.3,345888,68.0,12075,3.4
District of Columbia,1989,6,315681,69.5,300728,66.2,14953,4.7
Florida,1989,6,6247292,63.2,5897818,59.7,349474,5.6
Georgia,1989,6,3204288,68.2,3029467,64.5,174821,5.5
Hawaii,1989,6,529313,67.1,516976,65.5,12337,2.3
Idaho,1989,6,489572,67.5,462853,63.8,26719,5.5
Illinois,1989,6,6004324,68.0,5652213,64.0,352111,5.9
Indiana,1989,6,2862016,67.9,2731832,64.8,130184,4.5
Iowa,1989,6,1501717,69.7,1437050,66.7,64667,4.3
Kansas,1989,6,1278249,69.0,1225646,66.1,52603,4.1
Kentucky,1989,6,1738263,62.2,1626195,58.2,112068,6.4
Louisiana,1989,6,1892844,60.0,1741096,55.2,151748,8.0
Maine,1989,6,611720,66.0,587048,63.3,24672,4.0
Maryland,1989,6,2504323,70.4,2408397,67.7,95926,3.8
Massachusetts,1989,6,3185761,69.0,3055851,66.2,129910,4.1
Michigan,1989,6,4597980,65.8,4275970,61.2,322010,7.0
Minnesota,1989,6,2340342,71.6,2238646,68.5,101696,4.3
Mississippi,1989,6,1162671,61.4,1071139,56.6,91532,7.9
Missouri,1989,6,2623738,67.1,2480413,63.4,143325,5.5
Montana,1989,6,408033,68.5,383628,64.4,24405,6.0
Nebraska,1989,6,814725,68.2,790941,66.2,23784,2.9
Nevada,1989,6,601382,71.7,573559,68.4,27823,4.6
New Hampshire,1989,6,605818,72.4,586116,70.0,19702,3.3
New Jersey,1989,6,3984258,66.1,3826318,63.4,157940,4.0
New Mexico,1989,6,692270,63.2,645916,59.0,46354,6.7
New York,1989,6,8663022,62.8,8247120,59.7,415902,4.8
New York city,1989,6,3335520,57.1,3119098,53.4,216422,6.5
North Carolina,1989,6,3392828,68.8,3269736,66.3,123092,3.6
North Dakota,1989,6,329500,69.1,315489,66.1,14011,4.3
Ohio,1989,6,5407380,65.5,5114446,61.9,292934,5.4
Oklahoma,1989,6,1526345,64.0,1438531,60.3,87814,5.8
Oregon,1989,6,1472737,68.2,1393868,64.6,78869,5.4
Pennsylvania,1989,6,5842026,62.4,5559332,59.4,282694,4.8
Rhode Island,1989,6,517360,67.2,498978,64.8,18382,3.6
South Carolina,1989,6,1689498,65.9,1611596,62.9,77902,4.6
South Dakota,1989,6,360631,69.5,346534,66.8,14097,3.9
Tennessee,1989,6,2362412,63.0,2244212,59.8,118200,5.0
Texas,1989,6,8441607,69.1,7871656,64.5,569951,6.8
Utah,1989,6,785609,70.8,749314,67.6,36295,4.6
Vermont,1989,6,305106,71.1,293996,68.5,11110,3.6
Virginia,1989,6,3140900,69.1,3019752,66.5,121148,3.9
Washington,1989,6,2445164,68.8,2298565,64.7,146599,6.0
West Virginia,1989,6,761910,53.2,694574,48.5,67336,8.8
Wisconsin,1989,6,2597587,70.8,2483272,67.7,114315,4.4
Wyoming,1989,6,238631,69.4,223837,65.1,14794,6.2
Alabama,1989,7,1900380,61.8,1765871,57.5,134509,7.1
Alaska,1989,7,258990,74.0,241115,68.9,17875,6.9
Arizona,1989,7,1710951,65.3,1621630,61.9,89321,5.2
Arkansas,1989,7,1123648,62.7,1044615,58.3,79033,7.0
California,1989,7,14552475,67.8,13808739,64.3,743736,5.1
Los Angeles County,1989,7,4428901,67.6,4185930,63.9,242971,5.5
Colorado,1989,7,1711472,69.5,1615715,65.7,95757,5.6
Connecticut,1989,7,1766654,70.2,1702141,67.7,64513,3.7
Delaware,1989,7,358698,70.3,346288,67.9,12410,3.5
District of Columbia,1989,7,315327,69.6,300298,66.3,15029,4.8
Florida,1989,7,6261944,63.3,5909044,59.7,352900,5.6
Georgia,1989,7,3209493,68.3,3033962,64.5,175531,5.5
Hawaii,1989,7,530730,67.2,518340,65.6,12390,2.3
Idaho,1989,7,489653,67.4,462829,63.8,26824,5.5
Illinois,1989,7,6005909,68.0,5647699,63.9,358210,6.0
Indiana,1989,7,2861316,67.9,2727012,64.7,134304,4.7
Iowa,1989,7,1501549,69.7,1435785,66.7,65764,4.4
Kansas,1989,7,1278277,68.9,1225377,66.1,52900,4.1
Kentucky,1989,7,1741075,62.2,1629567,58.3,111508,6.4
Louisiana,1989,7,1887264,59.8,1742497,55.2,144767,7.7
Maine,1989,7,613571,66.1,587581,63.3,25990,4.2
Maryland,1989,7,2509106,70.5,2413137,67.8,95969,3.8
Massachusetts,1989,7,3185620,69.0,3050104,66.0,135516,4.3
Michigan,1989,7,4607312,66.0,4274666,61.2,332646,7.2
Minnesota,1989,7,2341988,71.6,2239457,68.5,102531,4.4
Mississippi,1989,7,1164403,61.5,1073910,56.7,90493,7.8
Missouri,1989,7,2627234,67.2,2483037,63.5,144197,5.5
Montana,1989,7,408715,68.6,384220,64.5,24495,6.0
Nebraska,1989,7,814892,68.2,791196,66.3,23696,2.9
Nevada,1989,7,603308,71.7,575274,68.3,28034,4.6
New Hampshire,1989,7,607456,72.5,586447,70.0,21009,3.5
New Jersey,1989,7,3986860,66.1,3823045,63.4,163815,4.1
New Mexico,1989,7,694389,63.4,647048,59.0,47341,6.8
New York,1989,7,8671116,62.8,8246965,59.7,424151,4.9
New York city,1989,7,3339410,57.1,3119509,53.4,219901,6.6
North Carolina,1989,7,3396764,68.8,3272378,66.2,124386,3.7
North Dakota,1989,7,329410,69.1,315321,66.1,14089,4.3
Ohio,1989,7,5412077,65.5,5112592,61.9,299485,5.5
Oklahoma,1989,7,1527039,64.0,1439553,60.3,87486,5.7
Oregon,1989,7,1471420,68.1,1392713,64.4,78707,5.3
Pennsylvania,1989,7,5839951,62.3,5554070,59.3,285881,4.9
Rhode Island,1989,7,517303,67.2,497837,64.7,19466,3.8
South Carolina,1989,7,1693948,66.0,1613679,62.9,80269,4.7
South Dakota,1989,7,361166,69.6,346966,66.9,14200,3.9
Tennessee,1989,7,2368353,63.1,2248828,59.9,119525,5.0
Texas,1989,7,8453832,69.2,7882961,64.5,570871,6.8
Utah,1989,7,788140,71.0,751705,67.7,36435,4.6
Vermont,1989,7,305061,70.9,293629,68.3,11432,3.7
Virginia,1989,7,3147268,69.2,3024800,66.5,122468,3.9
Washington,1989,7,2457083,69.1,2308721,64.9,148362,6.0
West Virginia,1989,7,764098,53.4,697082,48.7,67016,8.8
Wisconsin,1989,7,2596740,70.8,2481922,67.6,114818,4.4
Wyoming,1989,7,238692,69.4,223844,65.1,14848,6.2
Alabama,1989,8,1901655,61.8,1768107,57.5,133548,7.0
Alaska,1989,8,259877,74.3,241725,69.1,18152,7.0
Arizona,1989,8,1710855,65.2,1623324,61.9,87531,5.1
Arkansas,1989,8,1124928,62.8,1046532,58.4,78396,7.0
California,1989,8,14588015,67.8,13838434,64.3,749581,5.1
Los Angeles County,1989,8,4440625,67.6,4195287,63.9,245338,5.5
Colorado,1989,8,1717822,69.8,1621585,65.9,96237,5.6
Connecticut,1989,8,1769482,70.4,1702455,67.7,67027,3.8
Delaware,1989,8,359348,70.5,346780,68.0,12568,3.5
District of Columbia,1989,8,315133,69.7,300007,66.4,15126,4.8
Florida,1989,8,6276539,63.3,5920511,59.7,356028,5.7
Georgia,1989,8,3214465,68.3,3038927,64.5,175538,5.5
Hawaii,1989,8,532061,67.3,519549,65.7,12512,2.4
Idaho,1989,8,490077,67.4,463140,63.7,26937,5.5
Illinois,1989,8,6006883,68.0,5641126,63.8,365757,6.1
Indiana,1989,8,2857658,67.7,2719427,64.5,138231,4.8
Iowa,1989,8,1501373,69.7,1434899,66.6,66474,4.4
Kansas,1989,8,1278594,69.0,1225408,66.1,53186,4.2
Kentucky,1989,8,1744147,62.3,1633675,58.4,110472,6.3
Louisiana,1989,8,1881067,59.6,1743257,55.3,137810,7.3
Maine,1989,8,615300,66.2,588368,63.3,26932,4.4
Maryland,1989,8,2514057,70.6,2418281,67.9,95776,3.8
Massachusetts,1989,8,3185458,69.0,3044244,65.9,141214,4.4
Michigan,1989,8,4617923,66.1,4275156,61.2,342767,7.4
Minnesota,1989,8,2342902,71.6,2239818,68.5,103084,4.4
Mississippi,1989,8,1166173,61.6,1076586,56.8,89587,7.7
Missouri,1989,8,2630922,67.3,2485813,63.5,145109,5.5
Montana,1989,8,409072,68.6,384574,64.5,24498,6.0
Nebraska,1989,8,815198,68.3,791685,66.3,23513,2.9
Nevada,1989,8,605359,71.6,577058,68.2,28301,4.7
New Hampshire,1989,8,609205,72.6,586990,70.0,22215,3.6
New Jersey,1989,8,3991285,66.2,3822102,63.4,169183,4.2
New Mexico,1989,8,696571,63.5,648404,59.1,48167,6.9
New York,1989,8,8682239,62.9,8249635,59.8,432604,5.0
New York city,1989,8,3342502,57.2,3119899,53.4,222603,6.7
North Carolina,1989,8,3398932,68.7,3274313,66.2,124619,3.7
North Dakota,1989,8,329252,69.0,315119,66.1,14133,4.3
Ohio,1989,8,5416784,65.5,5109690,61.8,307094,5.7
Oklahoma,1989,8,1527171,64.0,1439813,60.3,87358,5.7
Oregon,1989,8,1469005,67.9,1390563,64.3,78442,5.3
Pennsylvania,1989,8,5837170,62.3,5548051,59.2,289119,5.0
Rhode Island,1989,8,517711,67.2,496840,64.5,20871,4.0
South Carolina,1989,8,1698595,66.1,1616320,62.9,82275,4.8
South Dakota,1989,8,361656,69.7,347435,66.9,14221,3.9
Tennessee,1989,8,2373278,63.2,2252571,60.0,120707,5.1
Texas,1989,8,8465016,69.2,7895263,64.5,569753,6.7
Utah,1989,8,790682,71.1,754106,67.8,36576,4.6
Vermont,1989,8,305000,70.8,293329,68.1,11671,3.8
Virginia,1989,8,3153218,69.3,3029329,66.5,123889,3.9
Washington,1989,8,2467738,69.2,2318297,65.0,149441,6.1
West Virginia,1989,8,771018,53.9,704592,49.3,66426,8.6
Wisconsin,1989,8,2595168,70.7,2480841,67.6,114327,4.4
Wyoming,1989,8,238716,69.4,223910,65.1,14806,6.2
Alabama,1989,9,1902626,61.9,1770729,57.6,131897,6.9
Alaska,1989,9,260673,74.3,242227,69.0,18446,7.1
Arizona,1989,9,1711858,65.2,1626433,61.9,85425,5.0
Arkansas,1989,9,1126203,62.8,1048509,58.5,77694,6.9
California,1989,9,14623371,67.8,13869342,64.3,754029,5.2
Los Angeles County,1989,9,4453427,67.7,4206510,64.0,246917,5.5
Colorado,1989,9,1723702,70.0,1627455,66.1,96247,5.6
Connecticut,1989,9,1773444,70.5,1704019,67.8,69425,3.9
Delaware,1989,9,359811,70.4,347205,67.9,12606,3.5
District of Columbia,1989,9,315159,69.9,299905,66.5,15254,4.8
Florida,1989,9,6292856,63.3,5934072,59.7,358784,5.7
Georgia,1989,9,3219865,68.3,3045079,64.6,174786,5.4
Hawaii,1989,9,533259,67.2,520559,65.6,12700,2.4
Idaho,1989,9,490919,67.4,463935,63.7,26984,5.5
Illinois,1989,9,6005885,67.9,5632711,63.7,373174,6.2
Indiana,1989,9,2852195,67.6,2710940,64.2,141255,5.0
Iowa,1989,9,1500904,69.6,1434381,66.6,66523,4.4
Kansas,1989,9,1279009,68.9,1225778,66.1,53231,4.2
Kentucky,1989,9,1747043,62.4,1637970,58.5,109073,6.2
Louisiana,1989,9,1874724,59.5,1743681,55.3,131043,7.0
Maine,1989,9,616988,66.3,589495,63.4,27493,4.5
Maryland,1989,9,2519867,70.7,2424047,68.0,95820,3.8
Massachusetts,1989,9,3186361,69.0,3039550,65.8,146811,4.6
Michigan,1989,9,4628364,66.2,4276901,61.2,351463,7.6
Minnesota,1989,9,2344214,71.6,2240630,68.4,103584,4.4
Mississippi,1989,9,1168157,61.6,1079117,56.9,89040,7.6
Missouri,1989,9,2634426,67.3,2488556,63.6,145870,5.5
Montana,1989,9,409118,68.5,384734,64.4,24384,6.0
Nebraska,1989,9,815554,68.2,792346,66.3,23208,2.8
Nevada,1989,9,607523,71.6,579028,68.2,28495,4.7
New Hampshire,1989,9,611009,72.7,587708,70.0,23301,3.8
New Jersey,1989,9,3996682,66.3,3823369,63.4,173313,4.3
New Mexico,1989,9,698665,63.6,650042,59.2,48623,7.0
New York,1989,9,8699034,63.0,8258751,59.8,440283,5.1
New York city,1989,9,3345505,57.2,3121154,53.4,224351,6.7
North Carolina,1989,9,3400880,68.7,3277012,66.2,123868,3.6
North Dakota,1989,9,329042,69.0,314944,66.0,14098,4.3
Ohio,1989,9,5419176,65.6,5104283,61.8,314893,5.8
Oklahoma,1989,9,1526903,64.0,1439255,60.3,87648,5.7
Oregon,1989,9,1466670,67.7,1388654,64.1,78016,5.3
Pennsylvania,1989,9,5833777,62.2,5541384,59.1,292393,5.0
Rhode Island,1989,9,518613,67.4,496011,64.4,22602,4.4
South Carolina,1989,9,1703155,66.2,1619676,62.9,83479,4.9
South Dakota,1989,9,362070,69.8,347931,67.0,14139,3.9
Tennessee,1989,9,2376437,63.2,2255175,60.0,121262,5.1
Texas,1989,9,8475013,69.2,7909572,64.6,565441,6.7
Utah,1989,9,793322,71.3,756635,68.0,36687,4.6
Vermont,1989,9,304991,70.8,293184,68.0,11807,3.9
Virginia,1989,9,3159097,69.3,3033928,66.6,125169,4.0
Washington,1989,9,2476741,69.4,2327766,65.2,148975,6.0
West Virginia,1989,9,770840,53.9,705227,49.4,65613,8.5
Wisconsin,1989,9,2593356,70.6,2480080,67.5,113276,4.4
Wyoming,1989,9,238657,69.4,224041,65.1,14616,6.1
Alabama,1989,10,1903733,61.8,1773474,57.6,130259,6.8
Alaska,1989,10,261619,74.5,242917,69.2,18702,7.1
Arizona,1989,10,1715972,65.2,1632075,62.0,83897,4.9
Arkansas,1989,10,1127487,62.9,1050468,58.6,77019,6.8
California,1989,10,14660438,67.9,13902840,64.4,757598,5.2
Los Angeles County,1989,10,4468108,67.8,4219936,64.1,248172,5.6
Colorado,1989,10,1728862,70.1,1633331,66.3,95531,5.5
Connecticut,1989,10,1778549,70.7,1706883,67.9,71666,4.0
Delaware,1989,10,360097,70.3,347501,67.9,12596,3.5
District of Columbia,1989,10,315509,70.1,300033,66.7,15476,4.9
Florida,1989,10,6313591,63.4,5951987,59.8,361604,5.7
Georgia,1989,10,3226803,68.4,3053358,64.7,173445,5.4
Hawaii,1989,10,534473,67.3,521513,65.7,12960,2.4
Idaho,1989,10,492042,67.5,465120,63.8,26922,5.5
Illinois,1989,10,6001167,67.8,5622589,63.6,378578,6.3
Indiana,1989,10,2846888,67.4,2703868,64.0,143020,5.0
Iowa,1989,10,1500410,69.6,1434412,66.5,65998,4.4
Kansas,1989,10,1279594,68.9,1226638,66.1,52956,4.1
Kentucky,1989,10,1749662,62.5,1642295,58.7,107367,6.1
Louisiana,1989,10,1869153,59.3,1744225,55.3,124928,6.7
Maine,1989,10,618760,66.5,590961,63.5,27799,4.5
Maryland,1989,10,2526962,70.8,2431036,68.1,95926,3.8
Massachusetts,1989,10,3189820,69.1,3037532,65.8,152288,4.8
Michigan,1989,10,4636961,66.3,4279218,61.2,357743,7.7
Minnesota,1989,10,2347591,71.7,2243082,68.5,104509,4.5
Mississippi,1989,10,1170412,61.7,1081501,57.0,88911,7.6
Missouri,1989,10,2637840,67.4,2491399,63.7,146441,5.6
Montana,1989,10,409046,68.5,384871,64.5,24175,5.9
Nebraska,1989,10,815991,68.3,793251,66.4,22740,2.8
Nevada,1989,10,609887,71.5,581315,68.1,28572,4.7
New Hampshire,1989,10,612904,72.8,588561,69.9,24343,4.0
New Jersey,1989,10,4003491,66.4,3827321,63.5,176170,4.4
New Mexico,1989,10,700607,63.7,651945,59.3,48662,6.9
New York,1989,10,8723445,63.2,8276613,59.9,446832,5.1
New York city,1989,10,3349334,57.3,3123723,53.4,225611,6.7
North Carolina,1989,10,3405268,68.7,3282773,66.2,122495,3.6
North Dakota,1989,10,328886,69.1,314895,66.2,13991,4.3
Ohio,1989,10,5418399,65.5,5096946,61.6,321453,5.9
Oklahoma,1989,10,1524568,63.8,1438685,60.2,85883,5.6
Oregon,1989,10,1465606,67.5,1388055,63.9,77551,5.3
Pennsylvania,1989,10,5831227,62.2,5535682,59.1,295545,5.1
Rhode Island,1989,10,519697,67.5,495304,64.3,24393,4.7
South Carolina,1989,10,1707733,66.3,1623997,63.0,83736,4.9
South Dakota,1989,10,362464,69.8,348500,67.1,13964,3.9
Tennessee,1989,10,2378099,63.2,2257080,60.0,121019,5.1
Texas,1989,10,8486028,69.2,7927096,64.6,558932,6.6
Utah,1989,10,796190,71.5,759456,68.2,36734,4.6
Vermont,1989,10,305138,70.6,293246,67.9,11892,3.9
Virginia,1989,10,3165957,69.4,3039980,66.6,125977,4.0
Washington,1989,10,2484793,69.5,2337860,65.4,146933,5.9
West Virginia,1989,10,770428,53.9,705731,49.4,64697,8.4
Wisconsin,1989,10,2591952,70.5,2479924,67.5,112028,4.3
Wyoming,1989,10,238530,69.3,224248,65.2,14282,6.0
Alabama,1989,11,1905242,61.9,1776188,57.7,129054,6.8
Alaska,1989,11,262826,74.9,243918,69.5,18908,7.2
Arizona,1989,11,1723855,65.4,1640218,62.2,83637,4.9
Arkansas,1989,11,1128613,62.9,1052155,58.7,76458,6.8
California,1989,11,14698650,67.9,13937435,64.4,761215,5.2
Los Angeles County,1989,11,4484186,68.0,4234697,64.2,249489,5.6
Colorado,1989,11,1733611,70.3,1639323,66.5,94288,5.4
Connecticut,1989,11,1784598,71.0,1710802,68.0,73796,4.1
Delaware,1989,11,360210,70.2,347620,67.8,12590,3.5
District of Columbia,1989,11,316133,70.4,300293,66.9,15840,5.0
Florida,1989,11,6339241,63.5,5974359,59.9,364882,5.8
Georgia,1989,11,3235452,68.5,3063764,64.9,171688,5.3
Hawaii,1989,11,535902,67.4,522604,65.7,13298,2.5
Idaho,1989,11,493231,67.6,466458,63.9,26773,5.4
Illinois,1989,11,5992024,67.7,5611251,63.4,380773,6.4
Indiana,1989,11,2842480,67.3,2698713,63.9,143767,5.1
Iowa,1989,11,1499985,69.6,1434826,66.6,65159,4.3
Kansas,1989,11,1280421,69.0,1227924,66.2,52497,4.1
Kentucky,1989,11,1751956,62.6,1646454,58.8,105502,6.0
Louisiana,1989,11,1864719,59.2,1744886,55.4,119833,6.4
Maine,1989,11,620672,66.6,592699,63.6,27973,4.5
Maryland,1989,11,2534991,70.9,2439240,68.3,95751,3.8
Massachusetts,1989,11,3196202,69.2,3038410,65.8,157792,4.9
Michigan,1989,11,4641427,66.4,4280811,61.2,360616,7.8
Minnesota,1989,11,2353418,71.8,2247556,68.6,105862,4.5
Mississippi,1989,11,1172875,61.8,1083855,57.1,89020,7.6
Missouri,1989,11,2641183,67.5,2494316,63.7,146867,5.6
Montana,1989,11,409017,68.5,385126,64.5,23891,5.8
Nebraska,1989,11,816500,68.3,794368,66.5,22132,2.7
Nevada,1989,11,612464,71.5,583921,68.2,28543,4.7
New Hampshire,1989,11,614873,72.9,589487,69.9,25386,4.1
New Jersey,1989,11,4011615,66.5,3833427,63.6,178188,4.4
New Mexico,1989,11,702376,63.9,654017,59.5,48359,6.9
New York,1989,11,8752808,63.4,8301180,60.1,451628,5.2
New York city,1989,11,3353288,57.3,3126819,53.5,226469,6.8
North Carolina,1989,11,3413032,68.8,3292209,66.4,120823,3.5
North Dakota,1989,11,328838,69.1,315030,66.2,13808,4.2
Ohio,1989,11,5414391,65.5,5089176,61.5,325215,6.0
Oklahoma,1989,11,1523020,63.8,1438658,60.2,84362,5.5
Oregon,1989,11,1466084,67.4,1389195,63.9,76889,5.2
Pennsylvania,1989,11,5829657,62.2,5531446,59.0,298211,5.1
Rhode Island,1989,11,520589,67.6,494661,64.2,25928,5.0
South Carolina,1989,11,1712178,66.4,1628948,63.2,83230,4.9
South Dakota,1989,11,362868,69.9,349151,67.3,13717,3.8
Tennessee,1989,11,2378960,63.2,2258899,60.0,120061,5.0
Texas,1989,11,8498491,69.2,7947231,64.7,551260,6.5
Utah,1989,11,799257,71.7,762581,68.4,36676,4.6
Vermont,1989,11,305471,70.5,293504,67.8,11967,3.9
Virginia,1989,11,3173889,69.5,3047749,66.7,126140,4.0
Washington,1989,11,2492278,69.5,2348633,65.5,143645,5.8
West Virginia,1989,11,769622,53.9,705842,49.4,63780,8.3
Wisconsin,1989,11,2591183,70.5,2480340,67.5,110843,4.3
Wyoming,1989,11,238378,69.3,224512,65.3,13866,5.8
Alabama,1989,12,1907341,61.9,1778818,57.8,128523,6.7
Alaska,1989,12,264244,75.3,245147,69.8,19097,7.2
Arizona,1989,12,1734832,65.8,1649714,62.5,85118,4.9
Arkansas,1989,12,1129488,63.0,1053413,58.7,76075,6.7
California,1989,12,14737257,68.0,13970785,64.4,766472,5.2
Los Angeles County,1989,12,4500856,68.1,4249659,64.3,251197,5.6
Colorado,1989,12,1738508,70.5,1645628,66.7,92880,5.3
Connecticut,1989,12,1791371,71.3,1715402,68.2,75969,4.2
Delaware,1989,12,360192,70.2,347569,67.8,12623,3.5
District of Columbia,1989,12,316983,70.8,300648,67.1,16335,5.2
Florida,1989,12,6369137,63.7,6000382,60.0,368755,5.8
Georgia,1989,12,3245559,68.6,3075652,65.0,169907,5.2
Hawaii,1989,12,537755,67.6,524037,65.8,13718,2.6
Idaho,1989,12,494171,67.7,467578,64.1,26593,5.4
Illinois,1989,12,5979489,67.6,5599825,63.3,379664,6.3
Indiana,1989,12,2838748,67.1,2694784,63.7,143964,5.1
Iowa,1989,12,1499813,69.6,1435501,66.6,64312,4.3
Kansas,1989,12,1281647,69.1,1229616,66.3,52031,4.1
Kentucky,1989,12,1753897,62.6,1650206,58.9,103691,5.9
Louisiana,1989,12,1861462,59.1,1745656,55.4,115806,6.2
Maine,1989,12,622737,66.7,594655,63.7,28082,4.5
Maryland,1989,12,2543411,71.1,2448181,68.4,95230,3.7
Massachusetts,1989,12,3205451,69.4,3041795,65.9,163656,5.1
Michigan,1989,12,4641207,66.4,4280846,61.2,360361,7.8
Minnesota,1989,12,2361045,72.0,2253765,68.7,107280,4.5
Mississippi,1989,12,1175408,62.0,1086317,57.3,89091,7.6
Missouri,1989,12,2644674,67.5,2497494,63.8,147180,5.6
Montana,1989,12,409137,68.5,385544,64.6,23593,5.8
Nebraska,1989,12,817254,68.4,795751,66.6,21503,2.6
Nevada,1989,12,615166,71.6,586696,68.3,28470,4.6
New Hampshire,1989,12,616922,73.1,590456,70.0,26466,4.3
New Jersey,1989,12,4020841,66.7,3840757,63.7,180084,4.5
New Mexico,1989,12,704004,63.9,656119,59.6,47885,6.8
New York,1989,12,8782742,63.6,8328628,60.3,454114,5.2
New York city,1989,12,3356153,57.4,3129576,53.5,226577,6.8
North Carolina,1989,12,3424291,69.0,3304836,66.5,119455,3.5
North Dakota,1989,12,328950,69.3,315388,66.4,13562,4.1
Ohio,1989,12,5408992,65.4,5083408,61.5,325584,6.0
Oklahoma,1989,12,1522342,63.7,1439268,60.3,83074,5.5
Oregon,1989,12,1468318,67.4,1392294,64.0,76024,5.2
Pennsylvania,1989,12,5829118,62.2,5528896,59.0,300222,5.2
Rhode Island,1989,12,521271,67.7,494116,64.2,27155,5.2
South Carolina,1989,12,1716598,66.5,1634173,63.3,82425,4.8
South Dakota,1989,12,363333,70.0,349903,67.4,13430,3.7
Tennessee,1989,12,2380666,63.2,2261439,60.0,119227,5.0
Texas,1989,12,8513571,69.3,7969062,64.9,544509,6.4
Utah,1989,12,802383,71.9,765847,68.6,36536,4.6
Vermont,1989,12,306007,70.7,293907,67.9,12100,4.0
Virginia,1989,12,3182454,69.6,3056600,66.8,125854,4.0
Washington,1989,12,2499456,69.6,2359568,65.7,139888,5.6
West Virginia,1989,12,768527,53.9,705623,49.4,62904,8.2
Wisconsin,1989,12,2591039,70.4,2481325,67.5,109714,4.2
Wyoming,1989,12,238217,69.5,224780,65.5,13437,5.6
Alabama,1990,1,1909599,62.8,1781120,58.6,128479,6.7
Alaska,1990,1,265735,71.2,246470,66.0,19265,7.2
Arizona,1990,1,1747599,63.3,1659536,60.1,88063,5.0
Arkansas,1990,1,1129973,64.0,1054176,59.7,75797,6.7
California,1990,1,15008860,66.5,14235508,63.1,773352,5.2
Los Angeles County,1990,1,4516860,66.4,4264015,62.7,252845,5.6
Colorado,1990,1,1743987,70.2,1652439,66.5,91548,5.2
Connecticut,1990,1,1798461,70.1,1720309,67.1,78152,4.3
Delaware,1990,1,360102,70.9,347450,68.4,12652,3.5
District of Columbia,1990,1,330348,69.0,313453,65.4,16895,5.1
Florida,1990,1,6400373,62.6,6027651,58.9,372722,5.8
Georgia,1990,1,3256019,67.4,3087660,63.9,168359,5.2
Hawaii,1990,1,540051,67.8,525886,66.0,14165,2.6
Idaho,1990,1,494707,68.4,468290,64.7,26417,5.3
Illinois,1990,1,5964079,69.1,5588813,64.8,375266,6.3
Indiana,1990,1,2834492,68.7,2690690,65.2,143802,5.1
Iowa,1990,1,1460842,70.3,1397203,67.2,63639,4.4
Kansas,1990,1,1266936,69.7,1215349,66.9,51587,4.1
Kentucky,1990,1,1755235,63.3,1653028,59.6,102207,5.8
Louisiana,1990,1,1859188,61.2,1746514,57.5,112674,6.1
Maine,1990,1,624966,67.0,596812,64.0,28154,4.5
Maryland,1990,1,2551416,69.3,2456861,66.7,94555,3.7
Massachusetts,1990,1,3216593,68.5,3046804,64.8,169789,5.3
Michigan,1990,1,4637317,66.4,4280060,61.3,357257,7.7
Minnesota,1990,1,2369206,72.8,2260850,69.5,108356,4.6
Mississippi,1990,1,1177427,63.1,1088697,58.3,88730,7.5
Missouri,1990,1,2605685,67.9,2458816,64.1,146869,5.6
Montana,1990,1,409472,68.8,386126,64.9,23346,5.7
Nebraska,1990,1,818420,70.9,797556,69.1,20864,2.5
Nevada,1990,1,642262,69.4,613848,66.4,28414,4.4
New Hampshire,1990,1,618924,73.6,591342,70.3,27582,4.5
New Jersey,1990,1,4030749,67.1,3848401,64.1,182348,4.5
New Mexico,1990,1,705521,63.3,658230,59.1,47291,6.7
New York,1990,1,8809538,62.8,8355512,59.6,454026,5.2
New York city,1990,1,3358159,57.6,3132487,53.8,225672,6.7
North Carolina,1990,1,3438205,68.1,3319248,65.8,118957,3.5
North Dakota,1990,1,318932,69.5,305641,66.6,13291,4.2
Ohio,1990,1,5404006,66.2,5081649,62.2,322357,6.0
Oklahoma,1990,1,1522315,64.9,1440437,61.4,81878,5.4
Oregon,1990,1,1472154,67.4,1396976,64.0,75178,5.1
Pennsylvania,1990,1,5828663,63.6,5527432,60.3,301231,5.2
Rhode Island,1990,1,521839,67.9,493745,64.2,28094,5.4
South Carolina,1990,1,1721052,66.7,1639454,63.5,81598,4.7
South Dakota,1990,1,351198,70.3,338049,67.7,13149,3.7
Tennessee,1990,1,2384366,63.9,2265306,60.7,119060,5.0
Texas,1990,1,8531763,67.9,7991632,63.6,540131,6.3
Utah,1990,1,805442,70.8,769122,67.6,36320,4.5
Vermont,1990,1,306678,72.0,294347,69.1,12331,4.0
Virginia,1990,1,3191089,69.0,3065731,66.2,125358,3.9
Washington,1990,1,2506313,68.4,2369921,64.7,136392,5.4
West Virginia,1990,1,767442,55.3,705327,50.8,62115,8.1
Wisconsin,1990,1,2591242,70.7,2482768,67.7,108474,4.2
Wyoming,1990,1,238046,72.4,225026,68.4,13020,5.5
Alabama,1990,2,1911140,62.7,1782802,58.5,128338,6.7
Alaska,1990,2,267112,71.7,247774,66.5,19338,7.2
Arizona,1990,2,1760380,63.7,1668977,60.4,91403,5.2
Arkansas,1990,2,1129960,63.9,1054480,59.6,75480,6.7
California,1990,2,15109627,66.9,14329179,63.5,780448,5.2
Los Angeles County,1990,2,4529619,66.7,4276301,62.9,253318,5.6
Colorado,1990,2,1749653,70.4,1659242,66.8,90411,5.2
Connecticut,1990,2,1805181,70.3,1725028,67.2,80153,4.4
Delaware,1990,2,359934,70.8,347316,68.3,12618,3.5
District of Columbia,1990,2,334739,69.6,317312,66.0,17427,5.2
Florida,1990,2,6428640,62.9,6052659,59.2,375981,5.8
Georgia,1990,2,3265666,67.5,3098473,64.1,167193,5.1
Hawaii,1990,2,542568,67.9,528047,66.1,14521,2.7
Idaho,1990,2,494843,68.4,468486,64.7,26357,5.3
Illinois,1990,2,5947575,68.8,5578886,64.6,368689,6.2
Indiana,1990,2,2828238,68.4,2685288,64.9,142950,5.1
Iowa,1990,2,1449267,69.7,1386100,66.6,63167,4.4
Kansas,1990,2,1264236,69.5,1213080,66.7,51156,4.0
Kentucky,1990,2,1755623,63.2,1654528,59.5,101095,5.8
Louisiana,1990,2,1857449,61.0,1747388,57.4,110061,5.9
Maine,1990,2,627311,67.2,599069,64.1,28242,4.5
Maryland,1990,2,2558105,69.4,2464039,66.9,94066,3.7
Massachusetts,1990,2,3227108,68.6,3051394,64.9,175714,5.4
Michigan,1990,2,4631078,66.3,4279385,61.2,351693,7.6
Minnesota,1990,2,2376529,73.0,2267698,69.6,108831,4.6
Mississippi,1990,2,1178311,62.9,1090522,58.2,87789,7.5
Missouri,1990,2,2595723,67.6,2450290,63.8,145433,5.6
Montana,1990,2,409913,68.9,386738,65.0,23175,5.7
Nebraska,1990,2,819866,70.9,799708,69.2,20158,2.5
Nevada,1990,2,652283,70.4,623895,67.3,28388,4.4
New Hampshire,1990,2,620613,73.6,591950,70.2,28663,4.6
New Jersey,1990,2,4040375,67.2,3855697,64.1,184678,4.6
New Mexico,1990,2,706913,63.4,660282,59.3,46631,6.6
New York,1990,2,8830158,62.9,8378789,59.7,451369,5.1
New York city,1990,2,3358805,57.6,3135033,53.8,223772,6.7
North Carolina,1990,2,3452754,68.3,3332923,65.9,119831,3.5
North Dakota,1990,2,316261,68.8,303230,66.0,13031,4.1
Ohio,1990,2,5399878,66.0,5083752,62.1,316126,5.9
Oklahoma,1990,2,1522308,64.9,1441925,61.5,80383,5.3
Oregon,1990,2,1476657,67.6,1401983,64.2,74674,5.1
Pennsylvania,1990,2,5826827,63.5,5525736,60.3,301091,5.2
Rhode Island,1990,2,522379,67.8,493497,64.1,28882,5.5
South Carolina,1990,2,1725333,66.7,1644501,63.5,80832,4.7
South Dakota,1990,2,348060,69.7,335156,67.1,12904,3.7
Tennessee,1990,2,2389486,63.9,2270073,60.7,119413,5.0
Texas,1990,2,8550665,68.1,8013387,63.8,537278,6.3
Utah,1990,2,808318,70.8,772284,67.7,36034,4.5
Vermont,1990,2,307313,72.0,294685,69.1,12628,4.1
Virginia,1990,2,3198956,69.0,3074080,66.4,124876,3.9
Washington,1990,2,2512374,68.6,2378983,64.9,133391,5.3
West Virginia,1990,2,766585,55.1,705170,50.7,61415,8.0
Wisconsin,1990,2,2591342,70.6,2484287,67.7,107055,4.1
Wyoming,1990,2,237854,72.3,225233,68.5,12621,5.3
Alabama,1990,3,1911528,62.6,1783545,58.4,127983,6.7
Alaska,1990,3,268260,72.1,248922,66.9,19338,7.2
Arizona,1990,3,1771401,64.1,1677178,60.7,94223,5.3
Arkansas,1990,3,1129580,63.8,1054379,59.5,75201,6.7
California,1990,3,15151941,67.1,14363110,63.6,788831,5.2
Los Angeles County,1990,3,4537601,66.9,4284890,63.2,252711,5.6
Colorado,1990,3,1755031,70.7,1665204,67.0,89827,5.1
Connecticut,1990,3,1810832,70.5,1728838,67.3,81994,4.5
Delaware,1990,3,359625,70.6,347069,68.1,12556,3.5
District of Columbia,1990,3,336243,69.7,318343,66.0,17900,5.3
Florida,1990,3,6451272,63.1,6072162,59.4,379110,5.9
Georgia,1990,3,3274014,67.6,3107062,64.1,166952,5.1
Hawaii,1990,3,544942,68.0,530232,66.1,14710,2.7
Idaho,1990,3,494589,68.3,468091,64.6,26498,5.4
Illinois,1990,3,5933091,68.6,5570303,64.4,362788,6.1
Indiana,1990,3,2820000,68.0,2678289,64.5,141711,5.0
Iowa,1990,3,1446077,69.5,1383184,66.4,62893,4.3
Kansas,1990,3,1265253,69.5,1214265,66.7,50988,4.0
Kentucky,1990,3,1755183,63.0,1654728,59.4,100455,5.7
Louisiana,1990,3,1856384,60.8,1748271,57.3,108113,5.8
Maine,1990,3,629526,67.3,601049,64.2,28477,4.5
Maryland,1990,3,2563241,69.6,2468739,67.0,94502,3.7
Massachusetts,1990,3,3234868,68.7,3053448,64.9,181420,5.6
Michigan,1990,3,4625015,66.1,4278969,61.2,346046,7.5
Minnesota,1990,3,2382267,73.1,2273454,69.8,108813,4.6
Mississippi,1990,3,1178069,62.7,1091404,58.1,86665,7.4
Missouri,1990,3,2593865,67.4,2450280,63.7,143585,5.5
Montana,1990,3,410344,69.0,387227,65.1,23117,5.6
Nebraska,1990,3,821364,70.9,801834,69.3,19530,2.4
Nevada,1990,3,657121,70.8,628630,67.7,28491,4.3
New Hampshire,1990,3,621822,73.6,592134,70.1,29688,4.8
New Jersey,1990,3,4048775,67.2,3861811,64.1,186964,4.6
New Mexico,1990,3,708181,63.5,662110,59.4,46071,6.5
New York,1990,3,8843802,63.0,8396155,59.8,447647,5.1
New York city,1990,3,3358067,57.5,3136724,53.7,221343,6.6
North Carolina,1990,3,3465180,68.4,3343005,66.0,122175,3.5
North Dakota,1990,3,315808,68.5,302967,65.7,12841,4.1
Ohio,1990,3,5397026,65.9,5087728,62.1,309298,5.7
Oklahoma,1990,3,1521883,64.9,1443179,61.6,78704,5.2
Oregon,1990,3,1481197,67.8,1406345,64.4,74852,5.1
Pennsylvania,1990,3,5822796,63.4,5522285,60.2,300511,5.2
Rhode Island,1990,3,522894,67.7,493200,63.9,29694,5.7
South Carolina,1990,3,1729234,66.7,1648786,63.6,80448,4.7
South Dakota,1990,3,347604,69.5,334874,67.0,12730,3.7
Tennessee,1990,3,2394887,63.9,2274685,60.7,120202,5.0
Texas,1990,3,8567278,68.2,8031650,63.9,535628,6.3
Utah,1990,3,810912,70.8,775161,67.7,35751,4.4
Vermont,1990,3,307752,72.0,294780,69.0,12972,4.2
Virginia,1990,3,3206094,69.1,3080893,66.4,125201,3.9
Washington,1990,3,2517368,68.7,2386249,65.1,131119,5.2
West Virginia,1990,3,766175,55.0,705170,50.6,61005,8.0
Wisconsin,1990,3,2591040,70.6,2485200,67.7,105840,4.1
Wyoming,1990,3,237632,72.2,225369,68.5,12263,5.2
Alabama,1990,4,1910872,62.4,1783238,58.3,127634,6.7
Alaska,1990,4,269066,72.5,249746,67.3,19320,7.2
Arizona,1990,4,1779887,64.4,1683981,60.9,95906,5.4
Arkansas,1990,4,1129115,63.6,1053985,59.4,75130,6.7
California,1990,4,15169764,67.2,14369259,63.6,800505,5.3
Los Angeles County,1990,4,4540154,67.1,4288100,63.3,252054,5.6
Colorado,1990,4,1760121,70.9,1670180,67.3,89941,5.1
Connecticut,1990,4,1815137,70.6,1731317,67.3,83820,4.6
Delaware,1990,4,359162,70.4,346602,68.0,12560,3.5
District of Columbia,1990,4,336660,69.6,318319,65.8,18341,5.4
Florida,1990,4,6467740,63.2,6084521,59.5,383219,5.9
Georgia,1990,4,3280853,67.6,3112776,64.2,168077,5.1
Hawaii,1990,4,546897,68.0,532168,66.2,14729,2.7
Idaho,1990,4,494015,68.1,467229,64.4,26786,5.4
Illinois,1990,4,5922268,68.3,5561919,64.2,360349,6.1
Indiana,1990,4,2811243,67.6,2670585,64.2,140658,5.0
Iowa,1990,4,1445850,69.4,1383037,66.4,62813,4.3
Kansas,1990,4,1267363,69.6,1216101,66.8,51262,4.0
Kentucky,1990,4,1754246,62.9,1653927,59.3,100319,5.7
Louisiana,1990,4,1856352,60.6,1748984,57.1,107368,5.8
Maine,1990,4,631243,67.4,602244,64.3,28999,4.6
Maryland,1990,4,2567353,69.7,2470826,67.0,96527,3.8
Massachusetts,1990,4,3239596,68.8,3052416,64.8,187180,5.8
Michigan,1990,4,4621206,66.0,4278850,61.1,342356,7.4
Minnesota,1990,4,2386493,73.2,2277786,69.8,108707,4.6
Mississippi,1990,4,1176984,62.4,1091266,57.9,85718,7.3
Missouri,1990,4,2594346,67.4,2451873,63.7,142473,5.5
Montana,1990,4,410684,69.0,387485,65.1,23199,5.6
Nebraska,1990,4,822684,71.0,803565,69.3,19119,2.3
Nevada,1990,4,660429,71.1,631615,68.0,28814,4.4
New Hampshire,1990,4,622607,73.6,591965,70.0,30642,4.9
New Jersey,1990,4,4055180,67.2,3865788,64.1,189392,4.7
New Mexico,1990,4,709332,63.6,663588,59.5,45744,6.4
New York,1990,4,8852412,63.0,8407481,59.8,444931,5.0
New York city,1990,4,3357117,57.5,3138033,53.7,219084,6.5
North Carolina,1990,4,3473317,68.5,3348066,66.0,125251,3.6
North Dakota,1990,4,315984,68.4,303220,65.6,12764,4.0
Ohio,1990,4,5395822,65.7,5091687,62.0,304135,5.6
Oklahoma,1990,4,1521911,64.9,1443804,61.6,78107,5.1
Oregon,1990,4,1485662,68.0,1409757,64.5,75905,5.1
Pennsylvania,1990,4,5816695,63.3,5516154,60.0,300541,5.2
Rhode Island,1990,4,523381,67.7,492773,63.7,30608,5.8
South Carolina,1990,4,1732871,66.7,1652086,63.6,80785,4.7
South Dakota,1990,4,347884,69.6,335247,67.0,12637,3.6
Tennessee,1990,4,2399121,64.0,2277676,60.7,121445,5.1
Texas,1990,4,8580702,68.2,8044789,64.0,535913,6.2
Utah,1990,4,813271,70.8,777735,67.7,35536,4.4
Vermont,1990,4,307911,71.9,294566,68.8,13345,4.3
Virginia,1990,4,3213185,69.2,3086094,66.5,127091,4.0
Washington,1990,4,2521116,68.8,2391593,65.3,129523,5.1
West Virginia,1990,4,766308,54.9,705128,50.5,61180,8.0
Wisconsin,1990,4,2590637,70.6,2485281,67.7,105356,4.1
Wyoming,1990,4,237408,72.2,225418,68.5,11990,5.1
Alabama,1990,5,1909814,62.3,1782230,58.1,127584,6.7
Alaska,1990,5,269625,72.7,250305,67.5,19320,7.2
Arizona,1990,5,1786096,64.5,1689842,61.0,96254,5.4
Arkansas,1990,5,1128863,63.5,1053507,59.3,75356,6.7
California,1990,5,15174935,67.2,14358647,63.6,816288,5.4
Los Angeles County,1990,5,4536422,67.2,4284031,63.4,252391,5.6
Colorado,1990,5,1765072,71.1,1674520,67.4,90552,5.1
Connecticut,1990,5,1818180,70.6,1732461,67.3,85719,4.7
Delaware,1990,5,358669,70.1,346021,67.7,12648,3.5
District of Columbia,1990,5,336594,69.1,317824,65.3,18770,5.6
Florida,1990,5,6479527,63.3,6091103,59.5,388424,6.0
Georgia,1990,5,3286481,67.6,3116133,64.1,170348,5.2
Hawaii,1990,5,548491,67.9,533864,66.1,14627,2.7
Idaho,1990,5,493280,67.9,466173,64.2,27107,5.5
Illinois,1990,5,5916293,68.1,5554026,64.0,362267,6.1
Indiana,1990,5,2803954,67.2,2664269,63.8,139685,5.0
Iowa,1990,5,1447358,69.4,1384407,66.3,62951,4.3
Kansas,1990,5,1269686,69.7,1217800,66.8,51886,4.1
Kentucky,1990,5,1753364,62.7,1652737,59.1,100627,5.7
Louisiana,1990,5,1857810,60.5,1749667,57.0,108143,5.8
Maine,1990,5,632319,67.3,602475,64.2,29844,4.7
Maryland,1990,5,2571006,69.7,2470966,67.0,100040,3.9
Massachusetts,1990,5,3242226,68.7,3049087,64.6,193139,6.0
Michigan,1990,5,4619803,65.9,4278991,61.1,340812,7.4
Minnesota,1990,5,2390069,73.2,2281018,69.8,109051,4.6
Mississippi,1990,5,1175679,62.2,1090503,57.7,85176,7.2
Missouri,1990,5,2596069,67.3,2453212,63.6,142857,5.5
Montana,1990,5,402017,67.6,378614,63.7,23403,5.8
Nebraska,1990,5,823736,70.9,804753,69.3,18983,2.3
Nevada,1990,5,663374,71.1,634029,67.9,29345,4.4
New Hampshire,1990,5,623133,73.5,591654,69.8,31479,5.1
New Jersey,1990,5,4059832,67.2,3867490,64.0,192342,4.7
New Mexico,1990,5,710315,63.6,664653,59.6,45662,6.4
New York,1990,5,8859219,62.9,8414252,59.8,444967,5.0
New York city,1990,5,3357655,57.4,3139567,53.6,218088,6.5
North Carolina,1990,5,3477502,68.4,3348377,65.8,129125,3.7
North Dakota,1990,5,316285,68.3,303488,65.5,12797,4.0
Ohio,1990,5,5396533,65.6,5095058,62.0,301475,5.6
Oklahoma,1990,5,1519141,64.8,1443799,61.6,75342,5.0
Oregon,1990,5,1490277,68.1,1412564,64.6,77713,5.2
Pennsylvania,1990,5,5810056,63.1,5507873,59.9,302183,5.2
Rhode Island,1990,5,523821,67.5,492268,63.4,31553,6.0
South Carolina,1990,5,1736485,66.7,1654706,63.5,81779,4.7
South Dakota,1990,5,348345,69.6,335726,67.1,12619,3.6
Tennessee,1990,5,2401363,63.9,2278317,60.6,123046,5.1
Texas,1990,5,8591857,68.3,8054096,64.0,537761,6.3
Utah,1990,5,815519,70.7,780144,67.6,35375,4.3
Vermont,1990,5,307794,71.7,294090,68.5,13704,4.5
Virginia,1990,5,3220693,69.3,3090050,66.5,130643,4.1
Washington,1990,5,2523694,68.8,2395523,65.3,128171,5.1
West Virginia,1990,5,766916,54.9,704956,50.5,61960,8.1
Wisconsin,1990,5,2590772,70.5,2484967,67.7,105805,4.1
Wyoming,1990,5,237222,72.1,225386,68.5,11836,5.0
Alabama,1990,6,1908682,62.1,1780728,57.9,127954,6.7
Alaska,1990,6,270080,73.0,250708,67.8,19372,7.2
Arizona,1990,6,1790436,64.6,1694771,61.2,95665,5.3
Arkansas,1990,6,1128936,63.4,1053069,59.1,75867,6.7
California,1990,6,15171675,67.2,14334908,63.5,836767,5.5
Los Angeles County,1990,6,4526266,67.1,4271673,63.3,254593,5.6
Colorado,1990,6,1769754,71.3,1678476,67.6,91278,5.2
Connecticut,1990,6,1819982,70.7,1732236,67.3,87746,4.8
Delaware,1990,6,358191,70.0,345326,67.5,12865,3.6
District of Columbia,1990,6,334184,68.5,314970,64.5,19214,5.7
Florida,1990,6,6488482,63.4,6093728,59.5,394754,6.1
Georgia,1990,6,3291179,67.6,3118023,64.1,173156,5.3
Hawaii,1990,6,549857,67.9,535357,66.1,14500,2.6
Idaho,1990,6,492540,67.8,465183,64.1,27357,5.6
Illinois,1990,6,5914656,68.0,5547357,63.8,367299,6.2
Indiana,1990,6,2799101,66.9,2660324,63.5,138777,5.0
Iowa,1990,6,1449812,69.4,1386567,66.4,63245,4.4
Kansas,1990,6,1271856,69.7,1219086,66.8,52770,4.1
Kentucky,1990,6,1752757,62.6,1651196,59.0,101561,5.8
Louisiana,1990,6,1860476,60.5,1750196,56.9,110280,5.9
Maine,1990,6,632795,67.3,601737,64.0,31058,4.9
Maryland,1990,6,2574397,69.8,2469588,67.0,104809,4.1
Massachusetts,1990,6,3242971,68.7,3043566,64.5,199405,6.1
Michigan,1990,6,4618903,65.9,4277488,61.0,341415,7.4
Minnesota,1990,6,2393729,73.2,2283668,69.9,110061,4.6
Mississippi,1990,6,1174685,61.9,1089409,57.4,85276,7.3
Missouri,1990,6,2598867,67.3,2453654,63.5,145213,5.6
Montana,1990,6,399533,67.2,375833,63.2,23700,5.9
Nebraska,1990,6,824469,70.9,805408,69.3,19061,2.3
Nevada,1990,6,666226,71.3,636174,68.1,30052,4.5
New Hampshire,1990,6,623426,73.4,591203,69.6,32223,5.2
New Jersey,1990,6,4063197,67.1,3866948,63.9,196249,4.8
New Mexico,1990,6,711050,63.7,665233,59.6,45817,6.4
New York,1990,6,8864926,62.9,8416361,59.7,448565,5.1
New York city,1990,6,3360419,57.4,3141157,53.6,219262,6.5
North Carolina,1990,6,3478858,68.3,3344745,65.7,134113,3.9
North Dakota,1990,6,316532,68.2,303615,65.4,12917,4.1
Ohio,1990,6,5398285,65.5,5097028,61.9,301257,5.6
Oklahoma,1990,6,1519418,64.8,1442864,61.5,76554,5.0
Oregon,1990,6,1495168,68.3,1415296,64.7,79872,5.3
Pennsylvania,1990,6,5804038,63.0,5497872,59.7,306166,5.3
Rhode Island,1990,6,524109,67.5,491664,63.3,32445,6.2
South Carolina,1990,6,1739701,66.6,1656596,63.5,83105,4.8
South Dakota,1990,6,348794,69.7,336134,67.2,12660,3.6
Tennessee,1990,6,2401543,63.8,2276773,60.5,124770,5.2
Texas,1990,6,8601024,68.4,8060932,64.1,540092,6.3
Utah,1990,6,817611,70.6,782367,67.6,35244,4.3
Vermont,1990,6,307452,71.5,293407,68.2,14045,4.6
Virginia,1990,6,3228407,69.4,3092875,66.5,135532,4.2
Washington,1990,6,2524990,68.9,2398257,65.4,126733,5.0
West Virginia,1990,6,767816,54.9,704517,50.3,63299,8.2
Wisconsin,1990,6,2591898,70.6,2484575,67.6,107323,4.1
Wyoming,1990,6,237054,72.0,225265,68.4,11789,5.0
Alabama,1990,7,1908004,61.9,1779120,57.8,128884,6.8
Alaska,1990,7,270657,73.4,251160,68.1,19497,7.2
Arizona,1990,7,1793879,64.7,1699054,61.3,94825,5.3
Arkansas,1990,7,1129432,63.3,1052819,59.0,76613,6.8
California,1990,7,15165403,67.2,14302549,63.3,862854,5.7
Los Angeles County,1990,7,4512464,67.0,4253062,63.2,259402,5.7
Colorado,1990,7,1774428,71.6,1682747,67.9,91681,5.2
Connecticut,1990,7,1821020,70.7,1731003,67.2,90017,4.9
Delaware,1990,7,357709,69.8,344418,67.2,13291,3.7
District of Columbia,1990,7,332092,67.8,312364,63.8,19728,5.9
Florida,1990,7,6497192,63.5,6094509,59.6,402683,6.2
Georgia,1990,7,3295706,67.6,3119394,64.0,176312,5.3
Hawaii,1990,7,551195,67.9,536806,66.1,14389,2.6
Idaho,1990,7,492139,67.7,464592,63.9,27547,5.6
Illinois,1990,7,5916503,67.9,5543253,63.7,373250,6.3
Indiana,1990,7,2797792,66.6,2659425,63.4,138367,4.9
Iowa,1990,7,1452717,69.5,1388974,66.4,63743,4.4
Kansas,1990,7,1273842,69.8,1220016,66.8,53826,4.2
Kentucky,1990,7,1752642,62.5,1649421,58.8,103221,5.9
Louisiana,1990,7,1864122,60.4,1750597,56.7,113525,6.1
Maine,1990,7,632853,67.2,600196,63.7,32657,5.2
Maryland,1990,7,2577752,69.9,2467184,66.9,110568,4.3
Massachusetts,1990,7,3242506,68.7,3036188,64.3,206318,6.4
Michigan,1990,7,4617093,65.8,4272813,60.9,344280,7.5
Minnesota,1990,7,2398333,73.3,2286713,69.9,111620,4.7
Mississippi,1990,7,1174601,61.7,1088314,57.2,86287,7.3
Missouri,1990,7,2603009,67.3,2453326,63.5,149683,5.8
Montana,1990,7,398906,67.1,374814,63.0,24092,6.0
Nebraska,1990,7,824987,70.9,805785,69.2,19202,2.3
Nevada,1990,7,669162,71.6,638230,68.3,30932,4.6
New Hampshire,1990,7,623645,73.3,590673,69.4,32972,5.3
New Jersey,1990,7,4066289,67.1,3864571,63.8,201718,5.0
New Mexico,1990,7,711771,63.8,665442,59.6,46329,6.5
New York,1990,7,8854042,62.8,8398147,59.6,455895,5.1
New York city,1990,7,3348852,57.1,3126176,53.3,222676,6.6
North Carolina,1990,7,3479830,68.2,3339627,65.5,140203,4.0
North Dakota,1990,7,316709,68.0,303636,65.2,13073,4.1
Ohio,1990,7,5401920,65.5,5098550,61.8,303370,5.6
Oklahoma,1990,7,1519352,64.8,1440974,61.5,78378,5.2
Oregon,1990,7,1500356,68.5,1418341,64.8,82015,5.5
Pennsylvania,1990,7,5800458,62.9,5487972,59.5,312486,5.4
Rhode Island,1990,7,524148,67.3,490936,63.1,33212,6.3
South Carolina,1990,7,1742206,66.6,1657655,63.4,84551,4.9
South Dakota,1990,7,349181,69.7,336472,67.2,12709,3.6
Tennessee,1990,7,2400673,63.7,2274113,60.3,126560,5.3
Texas,1990,7,8611478,68.4,8067965,64.1,543513,6.3
Utah,1990,7,819709,70.6,784525,67.6,35184,4.3
Vermont,1990,7,307048,71.4,292610,68.0,14438,4.7
Virginia,1990,7,3236563,69.5,3095088,66.4,141475,4.4
Washington,1990,7,2525341,68.9,2399909,65.5,125432,5.0
West Virginia,1990,7,768944,54.9,703736,50.2,65208,8.5
Wisconsin,1990,7,2594571,70.6,2484695,67.6,109876,4.2
Wyoming,1990,7,236920,72.0,225119,68.4,11801,5.0
Alabama,1990,8,1908217,61.9,1777844,57.7,130373,6.8
Alaska,1990,8,271404,73.2,251753,67.9,19651,7.2
Arizona,1990,8,1796824,64.7,1702721,61.3,94103,5.2
Arkansas,1990,8,1130231,63.3,1052617,59.0,77614,6.9
California,1990,8,15158685,67.1,14264802,63.1,893883,5.9
Los Angeles County,1990,8,4496827,66.8,4230179,62.8,266648,5.9
Colorado,1990,8,1779014,71.6,1687432,67.9,91582,5.1
Connecticut,1990,8,1821616,70.7,1729053,67.1,92563,5.1
Delaware,1990,8,357185,69.5,343342,66.8,13843,3.9
District of Columbia,1990,8,330392,67.6,310084,63.4,20308,6.1
Florida,1990,8,6506195,63.4,6094027,59.4,412168,6.3
Georgia,1990,8,3300026,67.6,3120389,63.9,179637,5.4
Hawaii,1990,8,552708,68.0,538446,66.2,14262,2.6
Idaho,1990,8,492218,67.5,464434,63.7,27784,5.6
Illinois,1990,8,5920570,68.0,5542191,63.6,378379,6.4
Indiana,1990,8,2799745,66.6,2660886,63.3,138859,5.0
Iowa,1990,8,1455634,69.6,1391150,66.5,64484,4.4
Kansas,1990,8,1275592,69.9,1220628,66.9,54964,4.3
Kentucky,1990,8,1752941,62.4,1647468,58.7,105473,6.0
Louisiana,1990,8,1868633,60.5,1751042,56.7,117591,6.3
Maine,1990,8,632761,67.2,598199,63.5,34562,5.5
Maryland,1990,8,2580624,69.9,2464203,66.8,116421,4.5
Massachusetts,1990,8,3240732,68.7,3026667,64.1,214065,6.6
Michigan,1990,8,4613031,65.7,4264309,60.7,348722,7.6
Minnesota,1990,8,2403735,73.4,2290396,69.9,113339,4.7
Mississippi,1990,8,1175648,61.7,1087486,57.1,88162,7.5
Missouri,1990,8,2608341,67.4,2452604,63.4,155737,6.0
Montana,1990,8,398874,67.0,374285,62.8,24589,6.2
Nebraska,1990,8,825514,70.9,806164,69.3,19350,2.3
Nevada,1990,8,672174,71.5,640205,68.1,31969,4.8
New Hampshire,1990,8,623855,73.3,590040,69.4,33815,5.4
New Jersey,1990,8,4069473,67.2,3860359,63.7,209114,5.1
New Mexico,1990,8,712534,63.7,665330,59.5,47204,6.6
New York,1990,8,8842225,62.7,8375109,59.4,467116,5.3
New York city,1990,8,3338853,57.0,3111036,53.1,227817,6.8
North Carolina,1990,8,3482239,68.2,3334842,65.3,147397,4.2
North Dakota,1990,8,316830,68.1,303636,65.2,13194,4.2
Ohio,1990,8,5407835,65.5,5100984,61.8,306851,5.7
Oklahoma,1990,8,1519286,64.7,1438400,61.3,80886,5.3
Oregon,1990,8,1504997,68.6,1421061,64.8,83936,5.6
Pennsylvania,1990,8,5800373,62.9,5479850,59.4,320523,5.5
Rhode Island,1990,8,523897,67.3,490098,62.9,33799,6.5
South Carolina,1990,8,1743865,66.5,1657852,63.3,86013,4.9
South Dakota,1990,8,349499,69.8,336782,67.3,12717,3.6
Tennessee,1990,8,2399623,63.6,2271008,60.2,128615,5.4
Texas,1990,8,8624978,68.4,8075798,64.1,549180,6.4
Utah,1990,8,821867,70.6,786618,67.5,35249,4.3
Vermont,1990,8,306688,71.3,291785,67.8,14903,4.9
Virginia,1990,8,3245232,69.6,3097319,66.4,147913,4.6
Washington,1990,8,2525486,68.7,2400407,65.3,125079,5.0
West Virginia,1990,8,770210,54.9,702706,50.1,67504,8.8
Wisconsin,1990,8,2598565,70.7,2485528,67.6,113037,4.3
Wyoming,1990,8,236837,71.9,224972,68.3,11865,5.0
Alabama,1990,9,1909249,61.8,1777113,57.6,132136,6.9
Alaska,1990,9,272074,73.2,252279,67.8,19795,7.3
Arizona,1990,9,1798189,64.6,1704785,61.2,93404,5.2
Arkansas,1990,9,1131052,63.3,1052207,58.9,78845,7.0
California,1990,9,15150606,67.0,14221998,62.9,928608,6.1
Los Angeles County,1990,9,4479930,66.5,4204270,62.5,275660,6.2
Colorado,1990,9,1783283,71.6,1691993,67.9,91290,5.1
Connecticut,1990,9,1821793,70.7,1726473,67.0,95320,5.2
Delaware,1990,9,361928,70.5,342185,66.6,19743,5.5
District of Columbia,1990,9,328758,67.5,307868,63.2,20890,6.4
Florida,1990,9,6512651,63.4,6090336,59.2,422315,6.5
Georgia,1990,9,3303135,67.5,3120330,63.8,182805,5.5
Hawaii,1990,9,554493,68.1,540392,66.4,14101,2.5
Idaho,1990,9,492729,67.4,464535,63.5,28194,5.7
Illinois,1990,9,5925124,68.0,5543548,63.6,381576,6.4
Indiana,1990,9,2802742,66.6,2662142,63.3,140600,5.0
Iowa,1990,9,1457887,69.7,1392448,66.5,65439,4.5
Kansas,1990,9,1277140,69.9,1220879,66.9,56261,4.4
Kentucky,1990,9,1753446,62.4,1645165,58.6,108281,6.2
Louisiana,1990,9,1873507,60.7,1751550,56.7,121957,6.5
Maine,1990,9,632988,67.1,596198,63.2,36790,5.8
Maryland,1990,9,2582620,69.9,2460650,66.6,121970,4.7
Massachusetts,1990,9,3236268,68.6,3013745,63.9,222523,6.9
Michigan,1990,9,4606563,65.5,4252163,60.5,354400,7.7
Minnesota,1990,9,2408689,73.5,2293699,70.0,114990,4.8
Mississippi,1990,9,1177675,61.8,1087153,57.0,90522,7.7
Missouri,1990,9,2614058,67.5,2451739,63.3,162319,6.2
Montana,1990,9,399073,67.0,373922,62.8,25151,6.3
Nebraska,1990,9,826284,70.9,806717,69.2,19567,2.4
Nevada,1990,9,675063,71.3,641962,67.8,33101,4.9
New Hampshire,1990,9,623964,73.3,589168,69.2,34796,5.6
New Jersey,1990,9,4071431,67.2,3853479,63.6,217952,5.4
New Mexico,1990,9,713229,63.6,664963,59.3,48266,6.8
New York,1990,9,8827378,62.6,8345814,59.2,481564,5.5
New York city,1990,9,3328943,56.8,3095272,52.8,233671,7.0
North Carolina,1990,9,3486374,68.1,3330617,65.1,155757,4.5
North Dakota,1990,9,316890,68.1,303655,65.2,13235,4.2
Ohio,1990,9,5414247,65.6,5102932,61.8,311315,5.7
Oklahoma,1990,9,1519182,64.7,1435252,61.1,83930,5.5
Oregon,1990,9,1507875,68.6,1422594,64.7,85281,5.7
Pennsylvania,1990,9,5803411,62.9,5473307,59.3,330104,5.7
Rhode Island,1990,9,523470,67.3,489141,62.8,34329,6.6
South Carolina,1990,9,1744749,66.5,1657153,63.1,87596,5.0
South Dakota,1990,9,349763,69.7,337079,67.2,12684,3.6
Tennessee,1990,9,2399079,63.5,2267637,60.0,131442,5.5
Texas,1990,9,8639220,68.4,8082803,64.0,556417,6.4
Utah,1990,9,823958,70.5,788463,67.4,35495,4.3
Vermont,1990,9,306401,71.1,290962,67.5,15439,5.0
Virginia,1990,9,3253567,69.7,3099067,66.4,154500,4.7
Washington,1990,9,2525856,68.6,2399533,65.1,126323,5.0
West Virginia,1990,9,771492,55.0,701608,50.0,69884,9.1
Wisconsin,1990,9,2602993,70.7,2486384,67.5,116609,4.5
Wyoming,1990,9,236784,71.7,224810,68.1,11974,5.1
Alabama,1990,10,1910838,61.8,1776913,57.5,133925,7.0
Alaska,1990,10,272516,73.1,252526,67.7,19990,7.3
Arizona,1990,10,1797525,64.4,1704892,61.0,92633,5.2
Arkansas,1990,10,1131679,63.3,1051456,58.8,80223,7.1
California,1990,10,15141585,66.9,14174446,62.6,967139,6.4
Los Angeles County,1990,10,4464255,66.3,4178229,62.1,286026,6.4
Colorado,1990,10,1786978,71.6,1695885,67.9,91093,5.1
Connecticut,1990,10,1821843,70.7,1723558,66.9,98285,5.4
Delaware,1990,10,362964,70.5,341085,66.3,21879,6.0
District of Columbia,1990,10,326976,67.2,305576,62.8,21400,6.5
Florida,1990,10,6513762,63.2,6081503,59.0,432259,6.6
Georgia,1990,10,3304687,67.4,3119005,63.6,185682,5.6
Hawaii,1990,10,556475,68.3,542488,66.5,13987,2.5
Idaho,1990,10,493791,67.3,464896,63.3,28895,5.9
Illinois,1990,10,5929209,68.0,5545918,63.6,383291,6.5
Indiana,1990,10,2805202,66.6,2660690,63.2,144512,5.2
Iowa,1990,10,1459038,69.7,1392418,66.5,66620,4.6
Kansas,1990,10,1278517,70.0,1220801,66.8,57716,4.5
Kentucky,1990,10,1754153,62.4,1642183,58.4,111970,6.4
Louisiana,1990,10,1878203,60.8,1752042,56.7,126161,6.7
Maine,1990,10,634042,67.3,594571,63.1,39471,6.2
Maryland,1990,10,2584403,69.9,2456531,66.4,127872,4.9
Massachusetts,1990,10,3228460,68.4,2996817,63.5,231643,7.2
Michigan,1990,10,4600120,65.4,4237334,60.2,362786,7.9
Minnesota,1990,10,2412513,73.5,2295752,70.0,116761,4.8
Mississippi,1990,10,1180524,61.9,1087283,57.0,93241,7.9
Missouri,1990,10,2619386,67.6,2450873,63.3,168513,6.4
Montana,1990,10,399423,66.9,373620,62.6,25803,6.5
Nebraska,1990,10,827368,70.9,807513,69.2,19855,2.4
Nevada,1990,10,677803,71.2,643474,67.6,34329,5.1
New Hampshire,1990,10,623898,73.3,587978,69.1,35920,5.8
New Jersey,1990,10,4070772,67.1,3843115,63.4,227657,5.6
New Mexico,1990,10,713953,63.6,664534,59.2,49419,6.9
New York,1990,10,8809893,62.5,8310905,58.9,498988,5.7
New York city,1990,10,3318514,56.6,3079014,52.5,239500,7.2
North Carolina,1990,10,3491810,68.1,3326353,64.9,165457,4.7
North Dakota,1990,10,316914,68.0,303695,65.2,13219,4.2
Ohio,1990,10,5419522,65.6,5101590,61.7,317932,5.9
Oklahoma,1990,10,1518705,64.6,1431564,60.9,87141,5.7
Oregon,1990,10,1508734,68.4,1422847,64.5,85887,5.7
Pennsylvania,1990,10,5808158,62.9,5466529,59.2,341629,5.9
Rhode Island,1990,10,523315,67.2,488144,62.7,35171,6.7
South Carolina,1990,10,1745295,66.4,1655686,63.0,89609,5.1
South Dakota,1990,10,350006,69.7,337370,67.2,12636,3.6
Tennessee,1990,10,2399490,63.4,2264011,59.8,135479,5.6
Texas,1990,10,8652417,68.4,8088034,63.9,564383,6.5
Utah,1990,10,826033,70.5,790028,67.4,36005,4.4
Vermont,1990,10,306162,71.0,290165,67.3,15997,5.2
Virginia,1990,10,3261078,69.8,3099686,66.3,161392,4.9
Washington,1990,10,2526431,68.4,2397203,64.9,129228,5.1
West Virginia,1990,10,772798,55.1,700590,49.9,72208,9.3
Wisconsin,1990,10,2607728,70.7,2486402,67.4,121326,4.7
Wyoming,1990,10,236717,71.7,224639,68.0,12078,5.1
Alabama,1990,11,1912839,61.8,1777357,57.4,135482,7.1
Alaska,1990,11,272785,73.0,252536,67.5,20249,7.4
Arizona,1990,11,1795318,64.1,1703828,60.9,91490,5.1
Arkansas,1990,11,1132115,63.2,1050565,58.6,81550,7.2
California,1990,11,15133320,66.8,14126733,62.4,1006587,6.7
Los Angeles County,1990,11,4451964,66.1,4155448,61.7,296516,6.7
Colorado,1990,11,1789892,71.5,1698879,67.9,91013,5.1
Connecticut,1990,11,1822155,70.7,1720942,66.8,101213,5.6
Delaware,1990,11,363023,70.4,340209,66.0,22814,6.3
District of Columbia,1990,11,324989,66.9,303213,62.4,21776,6.7
Florida,1990,11,6509135,63.0,6068329,58.8,440806,6.8
Georgia,1990,11,3305333,67.3,3117601,63.5,187732,5.7
Hawaii,1990,11,558485,68.3,544498,66.6,13987,2.5
Idaho,1990,11,495445,67.3,465617,63.3,29828,6.0
Illinois,1990,11,5932864,67.9,5548725,63.5,384139,6.5
Indiana,1990,11,2806904,66.6,2656612,63.0,150292,5.4
Iowa,1990,11,1459429,69.6,1391649,66.4,67780,4.6
Kansas,1990,11,1279846,70.0,1220808,66.8,59038,4.6
Kentucky,1990,11,1755300,62.4,1638906,58.2,116394,6.6
Louisiana,1990,11,1882564,60.9,1752937,56.7,129627,6.9
Maine,1990,11,636162,67.5,593526,63.0,42636,6.7
Maryland,1990,11,2587027,69.9,2452787,66.3,134240,5.2
Massachusetts,1990,11,3218213,68.3,2977442,63.2,240771,7.5
Michigan,1990,11,4596850,65.3,4222009,60.0,374841,8.2
Minnesota,1990,11,2415457,73.5,2296720,69.9,118737,4.9
Mississippi,1990,11,1183742,62.0,1087814,57.0,95928,8.1
Missouri,1990,11,2624074,67.7,2450690,63.2,173384,6.6
Montana,1990,11,399920,66.9,373352,62.5,26568,6.6
Nebraska,1990,11,828828,71.0,808712,69.3,20116,2.4
Nevada,1990,11,680562,71.0,644935,67.3,35627,5.2
New Hampshire,1990,11,623655,73.4,586546,69.0,37109,6.0
New Jersey,1990,11,4068063,67.1,3830937,63.2,237126,5.8
New Mexico,1990,11,714843,63.6,664294,59.1,50549,7.1
New York,1990,11,8792538,62.3,8273763,58.7,518775,5.9
New York city,1990,11,3308252,56.5,3063166,52.3,245086,7.4
North Carolina,1990,11,3498465,68.1,3322302,64.7,176163,5.0
North Dakota,1990,11,316979,68.2,303794,65.4,13185,4.2
Ohio,1990,11,5423676,65.6,5096945,61.6,326731,6.0
Oklahoma,1990,11,1517889,64.5,1428067,60.7,89822,5.9
Oregon,1990,11,1508366,68.3,1422212,64.4,86154,5.7
Pennsylvania,1990,11,5814060,63.0,5459489,59.1,354571,6.1
Rhode Island,1990,11,523717,67.2,487203,62.5,36514,7.0
South Carolina,1990,11,1746277,66.3,1654272,62.8,92005,5.3
South Dakota,1990,11,350322,69.6,337742,67.1,12580,3.6
Tennessee,1990,11,2401035,63.4,2260493,59.7,140542,5.9
Texas,1990,11,8665404,68.4,8092841,63.9,572563,6.6
Utah,1990,11,828259,70.4,791548,67.3,36711,4.4
Vermont,1990,11,305991,71.0,289453,67.1,16538,5.4
Virginia,1990,11,3268135,69.9,3099831,66.3,168304,5.1
Washington,1990,11,2527746,68.3,2394295,64.7,133451,5.3
West Virginia,1990,11,774179,55.1,699898,49.8,74281,9.6
Wisconsin,1990,11,2612870,70.8,2485601,67.3,127269,4.9
Wyoming,1990,11,236629,71.7,224513,68.0,12116,5.1
Alabama,1990,12,1915065,61.8,1778346,57.4,136719,7.1
Alaska,1990,12,273068,72.8,252530,67.4,20538,7.5
Arizona,1990,12,1792274,63.8,1702393,60.6,89881,5.0
Arkansas,1990,12,1132330,63.2,1049672,58.5,82658,7.3
California,1990,12,15126566,66.7,14082456,62.1,1044110,6.9
Los Angeles County,1990,12,4443412,66.0,4137033,61.5,306379,6.9
Colorado,1990,12,1791976,71.5,1700926,67.8,91050,5.1
Connecticut,1990,12,1822941,70.8,1718995,66.7,103946,5.7
Delaware,1990,12,362932,70.3,339641,65.8,23291,6.4
District of Columbia,1990,12,323794,66.7,301738,62.2,22056,6.8
Florida,1990,12,6500580,62.8,6052798,58.5,447782,6.9
Georgia,1990,12,3306010,67.2,3117320,63.4,188690,5.7
Hawaii,1990,12,560139,68.4,546068,66.7,14071,2.5
Idaho,1990,12,497540,67.4,466708,63.2,30832,6.2
Illinois,1990,12,5935407,67.9,5550669,63.5,384738,6.5
Indiana,1990,12,2808008,66.6,2651441,62.8,156567,5.6
Iowa,1990,12,1459681,69.6,1390990,66.3,68691,4.7
Kansas,1990,12,1281155,70.0,1221154,66.8,60001,4.7
Kentucky,1990,12,1757251,62.4,1636189,58.1,121062,6.9
Louisiana,1990,12,1886616,61.0,1754374,56.8,132242,7.0
Maine,1990,12,639031,67.7,592911,62.8,46120,7.2
Maryland,1990,12,2591093,70.0,2450334,66.2,140759,5.4
Massachusetts,1990,12,3206849,68.1,2957488,62.8,249361,7.8
Michigan,1990,12,4597571,65.3,4207752,59.7,389819,8.5
Minnesota,1990,12,2417780,73.5,2296934,69.8,120846,5.0
Mississippi,1990,12,1186776,62.2,1088497,57.0,98279,8.3
Missouri,1990,12,2628097,67.8,2451436,63.2,176661,6.7
Montana,1990,12,400460,67.0,373110,62.4,27350,6.8
Nebraska,1990,12,830607,71.1,810263,69.4,20344,2.4
Nevada,1990,12,683460,70.9,646533,67.1,36927,5.4
New Hampshire,1990,12,623284,73.3,585005,68.8,38279,6.1
New Jersey,1990,12,4064663,67.0,3819122,62.9,245541,6.0
New Mexico,1990,12,715952,63.6,664381,59.0,51571,7.2
New York,1990,12,8777521,62.2,8236980,58.4,540541,6.2
New York city,1990,12,3298367,56.3,3047455,52.0,250912,7.6
North Carolina,1990,12,3505592,68.2,3318782,64.5,186810,5.3
North Dakota,1990,12,317059,68.2,303871,65.4,13188,4.2
Ohio,1990,12,5425835,65.6,5089671,61.5,336164,6.2
Oklahoma,1990,12,1516939,64.5,1425415,60.6,91524,6.0
Oregon,1990,12,1507421,68.1,1421020,64.2,86401,5.7
Pennsylvania,1990,12,5820519,63.0,5452711,59.0,367808,6.3
Rhode Island,1990,12,524517,67.3,486323,62.4,38194,7.3
South Carolina,1990,12,1748009,66.2,1653563,62.7,94446,5.4
South Dakota,1990,12,350759,69.7,338241,67.2,12518,3.6
Tennessee,1990,12,2403021,63.3,2257357,59.5,145664,6.1
Texas,1990,12,8678172,68.4,8097912,63.8,580260,6.7
Utah,1990,12,830692,70.4,793245,67.3,37447,4.5
Vermont,1990,12,305863,70.9,288837,67.0,17026,5.6
Virginia,1990,12,3275009,69.9,3100358,66.2,174651,5.3
Washington,1990,12,2530134,68.2,2391948,64.5,138186,5.5
West Virginia,1990,12,775501,55.2,699511,49.8,75990,9.8
Wisconsin,1990,12,2618005,70.8,2484064,67.2,133941,5.1
Wyoming,1990,12,236536,71.4,224472,67.8,12064,5.1
Alabama,1991,1,1917535,61.9,1779517,57.4,138018,7.2
Alaska,1991,1,273423,72.7,252522,67.2,20901,7.6
Arizona,1991,1,1789402,63.6,1700897,60.4,88505,4.9
Arkansas,1991,1,1132368,63.1,1048764,58.4,83604,7.4
California,1991,1,15121927,66.7,14041881,61.9,1080046,7.1
Los Angeles County,1991,1,4438017,65.9,4121726,61.2,316291,7.1
Colorado,1991,1,1793588,71.4,1702179,67.7,91409,5.1
Connecticut,1991,1,1824241,70.8,1717520,66.7,106721,5.9
Delaware,1991,1,362868,70.2,339352,65.6,23516,6.5
District of Columbia,1991,1,320238,66.1,297870,61.4,22368,7.0
Florida,1991,1,6491296,62.6,6036418,58.2,454878,7.0
Georgia,1991,1,3307396,67.1,3118417,63.3,188979,5.7
Hawaii,1991,1,561226,68.5,546983,66.7,14243,2.5
Idaho,1991,1,499758,67.5,468000,63.2,31758,6.4
Illinois,1991,1,5936684,67.9,5549549,63.5,387135,6.5
Indiana,1991,1,2808766,66.5,2646324,62.7,162442,5.8
Iowa,1991,1,1460375,69.6,1390903,66.3,69472,4.8
Kansas,1991,1,1282339,70.1,1221724,66.8,60615,4.7
Kentucky,1991,1,1759934,62.5,1634422,58.0,125512,7.1
Louisiana,1991,1,1890423,61.1,1755975,56.8,134448,7.1
Maine,1991,1,641836,68.0,592306,62.8,49530,7.7
Maryland,1991,1,2596437,70.1,2449339,66.1,147098,5.7
Massachusetts,1991,1,3196148,67.9,2938421,62.4,257727,8.1
Michigan,1991,1,4601408,65.3,4194712,59.5,406696,8.8
Minnesota,1991,1,2419834,73.5,2296678,69.8,123156,5.1
Mississippi,1991,1,1189463,62.3,1088957,57.0,100506,8.4
Missouri,1991,1,2631542,67.8,2452633,63.2,178909,6.8
Montana,1991,1,400870,67.0,372821,62.3,28049,7.0
Nebraska,1991,1,832478,71.2,811812,69.4,20666,2.5
Nevada,1991,1,686491,70.8,648293,66.8,38198,5.6
New Hampshire,1991,1,622836,73.3,583459,68.7,39377,6.3
New Jersey,1991,1,4061618,66.9,3808593,62.8,253025,6.2
New Mexico,1991,1,717150,63.5,664673,58.9,52477,7.3
New York,1991,1,8773727,62.2,8209122,58.2,564605,6.4
New York city,1991,1,3296182,56.3,3038244,51.9,257938,7.8
North Carolina,1991,1,3511558,68.2,3315313,64.4,196245,5.6
North Dakota,1991,1,317112,68.2,303808,65.3,13304,4.2
Ohio,1991,1,5425137,65.5,5080073,61.4,345064,6.4
Oklahoma,1991,1,1515882,64.4,1423576,60.4,92306,6.1
Oregon,1991,1,1506643,67.9,1419756,64.0,86887,5.8
Pennsylvania,1991,1,5826866,63.0,5445933,58.9,380933,6.5
Rhode Island,1991,1,525458,67.4,485422,62.3,40036,7.6
South Carolina,1991,1,1750393,66.2,1653420,62.6,96973,5.5
South Dakota,1991,1,351291,69.8,338798,67.3,12493,3.6
Tennessee,1991,1,2404969,63.3,2254660,59.4,150309,6.2
Texas,1991,1,8690383,68.4,8102754,63.8,587629,6.8
Utah,1991,1,833289,70.4,795116,67.2,38173,4.6
Vermont,1991,1,305745,70.9,288284,66.8,17461,5.7
Virginia,1991,1,3281933,70.0,3101633,66.2,180300,5.5
Washington,1991,1,2533467,68.1,2390665,64.3,142802,5.6
West Virginia,1991,1,776664,55.3,699191,49.8,77473,10.0
Wisconsin,1991,1,2622474,70.9,2481785,67.1,140689,5.4
Wyoming,1991,1,236455,71.4,224499,67.8,11956,5.1
Alabama,1991,2,1920462,61.9,1780932,57.4,139530,7.3
Alaska,1991,2,273867,72.7,252497,67.0,21370,7.8
Arizona,1991,2,1788056,63.4,1700010,60.3,88046,4.9
Arkansas,1991,2,1132439,63.1,1048078,58.4,84361,7.4
California,1991,2,15120868,66.6,14007246,61.7,1113622,7.4
Los Angeles County,1991,2,4435945,65.9,4109325,61.1,326620,7.4
Colorado,1991,2,1795508,71.3,1703408,67.7,92100,5.1
Connecticut,1991,2,1826056,71.0,1716372,66.7,109684,6.0
Delaware,1991,2,362873,70.0,339382,65.5,23491,6.5
District of Columbia,1991,2,320048,66.2,297262,61.5,22786,7.1
Florida,1991,2,6485179,62.4,6022155,57.9,463024,7.1
Georgia,1991,2,3309722,67.0,3121165,63.2,188557,5.7
Hawaii,1991,2,561901,68.5,547401,66.7,14500,2.6
Idaho,1991,2,501922,67.6,469509,63.3,32413,6.5
Illinois,1991,2,5937007,67.9,5544901,63.4,392106,6.6
Indiana,1991,2,2809456,66.5,2642477,62.5,166979,5.9
Iowa,1991,2,1461977,69.7,1391902,66.3,70075,4.8
Kansas,1991,2,1283517,70.2,1222640,66.8,60877,4.7
Kentucky,1991,2,1762954,62.5,1633789,58.0,129165,7.3
Louisiana,1991,2,1894364,61.3,1757873,56.8,136491,7.2
Maine,1991,2,643789,68.2,591524,62.7,52265,8.1
Maryland,1991,2,2602498,70.2,2450001,66.1,152497,5.9
Massachusetts,1991,2,3188397,67.8,2922463,62.1,265934,8.3
Michigan,1991,2,4606567,65.3,4183683,59.3,422884,9.2
Minnesota,1991,2,2422158,73.5,2296766,69.7,125392,5.2
Mississippi,1991,2,1191734,62.4,1089242,57.0,102492,8.6
Missouri,1991,2,2634639,67.8,2454264,63.2,180375,6.8
Montana,1991,2,401099,66.9,372543,62.1,28556,7.1
Nebraska,1991,2,834301,71.3,813179,69.5,21122,2.5
Nevada,1991,2,689632,70.7,650268,66.7,39364,5.7
New Hampshire,1991,2,622463,73.3,582095,68.5,40368,6.5
New Jersey,1991,2,4060192,66.9,3800702,62.6,259490,6.4
New Mexico,1991,2,718453,63.6,665220,58.9,53233,7.4
New York,1991,2,8758006,62.1,8168428,57.9,589578,6.7
New York city,1991,2,3278314,56.0,3011996,51.4,266318,8.1
North Carolina,1991,2,3516305,68.2,3312562,64.2,203743,5.8
North Dakota,1991,2,317158,68.4,303629,65.4,13529,4.3
Ohio,1991,2,5423518,65.5,5070874,61.2,352644,6.5
Oklahoma,1991,2,1514798,64.3,1422372,60.4,92426,6.1
Oregon,1991,2,1506964,67.8,1419380,63.8,87584,5.8
Pennsylvania,1991,2,5833224,63.1,5440423,58.9,392801,6.7
Rhode Island,1991,2,526249,67.5,484517,62.1,41732,7.9
South Carolina,1991,2,1753356,66.2,1653884,62.5,99472,5.7
South Dakota,1991,2,351934,69.9,339417,67.4,12517,3.6
Tennessee,1991,2,2407238,63.3,2252883,59.3,154355,6.4
Texas,1991,2,8703445,68.4,8109131,63.7,594314,6.8
Utah,1991,2,836105,70.5,797235,67.2,38870,4.6
Vermont,1991,2,305746,70.9,287856,66.7,17890,5.9
Virginia,1991,2,3289320,70.1,3104248,66.2,185072,5.6
Washington,1991,2,2537668,68.1,2390874,64.2,146794,5.8
West Virginia,1991,2,777751,55.3,698918,49.7,78833,10.1
Wisconsin,1991,2,2625986,70.9,2479743,67.0,146243,5.6
Wyoming,1991,2,236440,71.4,224597,67.8,11843,5.0
Alabama,1991,3,1923032,62.0,1782147,57.4,140885,7.3
Alaska,1991,3,274371,72.6,252507,66.8,21864,8.0
Arizona,1991,3,1788809,63.3,1700024,60.1,88785,5.0
Arkansas,1991,3,1132526,63.0,1047778,58.3,84748,7.5
California,1991,3,15120444,66.6,13978756,61.6,1141688,7.6
Los Angeles County,1991,3,4435796,65.9,4099298,60.9,336498,7.6
Colorado,1991,3,1797611,71.3,1704804,67.6,92807,5.2
Connecticut,1991,3,1827745,71.0,1715093,66.7,112652,6.2
Delaware,1991,3,362794,70.0,339595,65.5,23199,6.4
District of Columbia,1991,3,319982,66.3,296694,61.5,23288,7.3
Florida,1991,3,6483618,62.3,6011904,57.7,471714,7.3
Georgia,1991,3,3311830,67.0,3124983,63.2,186847,5.6
Hawaii,1991,3,562317,68.4,547554,66.6,14763,2.6
Idaho,1991,3,503927,67.7,471259,63.3,32668,6.5
Illinois,1991,3,5935436,67.9,5536746,63.3,398690,6.7
Indiana,1991,3,2809123,66.4,2640135,62.4,168988,6.0
Iowa,1991,3,1464221,69.8,1393907,66.4,70314,4.8
Kansas,1991,3,1284454,70.2,1223776,66.9,60678,4.7
Kentucky,1991,3,1765211,62.6,1633636,57.9,131575,7.5
Louisiana,1991,3,1898057,61.4,1759806,56.9,138251,7.3
Maine,1991,3,644401,68.3,590615,62.6,53786,8.3
Maryland,1991,3,2607792,70.3,2451746,66.1,156046,6.0
Massachusetts,1991,3,3183590,67.7,2910214,61.9,273376,8.6
Michigan,1991,3,4608888,65.3,4174467,59.2,434421,9.4
Minnesota,1991,3,2424521,73.5,2297577,69.7,126944,5.2
Mississippi,1991,3,1192941,62.4,1089089,57.0,103852,8.7
Missouri,1991,3,2636635,67.9,2455924,63.2,180711,6.9
Montana,1991,3,401132,66.9,372366,62.1,28766,7.2
Nebraska,1991,3,835801,71.4,814213,69.6,21588,2.6
Nevada,1991,3,692630,70.6,652350,66.5,40280,5.8
New Hampshire,1991,3,622087,73.3,580901,68.5,41186,6.6
New Jersey,1991,3,4060230,66.9,3795712,62.5,264518,6.5
New Mexico,1991,3,719761,63.6,666047,58.8,53714,7.5
New York,1991,3,8766508,62.2,8153993,57.8,612515,7.0
New York city,1991,3,3283842,56.1,3008619,51.4,275223,8.4
North Carolina,1991,3,3520140,68.1,3311226,64.1,208914,5.9
North Dakota,1991,3,317102,68.3,303306,65.4,13796,4.4
Ohio,1991,3,5421606,65.5,5063841,61.1,357765,6.6
Oklahoma,1991,3,1513502,64.2,1421513,60.3,91989,6.1
Oregon,1991,3,1508331,67.7,1419952,63.7,88379,5.9
Pennsylvania,1991,3,5838195,63.1,5436534,58.8,401661,6.9
Rhode Island,1991,3,526564,67.6,483570,62.0,42994,8.2
South Carolina,1991,3,1756328,66.3,1654701,62.4,101627,5.8
South Dakota,1991,3,352607,69.9,340034,67.4,12573,3.6
Tennessee,1991,3,2409408,63.3,2252014,59.2,157394,6.5
Texas,1991,3,8716436,68.4,8117400,63.7,599036,6.9
Utah,1991,3,838943,70.6,799491,67.3,39452,4.7
Vermont,1991,3,305834,70.9,287580,66.7,18254,6.0
Virginia,1991,3,3296418,70.2,3107901,66.2,188517,5.7
Washington,1991,3,2542009,68.1,2392353,64.1,149656,5.9
West Virginia,1991,3,778658,55.4,698594,49.7,80064,10.3
Wisconsin,1991,3,2628026,70.9,2478770,66.9,149256,5.7
Wyoming,1991,3,236475,71.2,224734,67.6,11741,5.0
Alabama,1991,4,1924595,61.9,1782930,57.4,141665,7.4
Alaska,1991,4,274941,72.6,252646,66.7,22295,8.1
Arizona,1991,4,1791456,63.2,1700544,60.0,90912,5.1
Arkansas,1991,4,1132602,63.0,1047948,58.3,84654,7.5
California,1991,4,15118925,66.5,13956787,61.4,1162138,7.7
Los Angeles County,1991,4,4436291,66.0,4091262,60.8,345029,7.8
Colorado,1991,4,1799611,71.2,1706321,67.5,93290,5.2
Connecticut,1991,4,1828835,71.1,1713438,66.6,115397,6.3
Delaware,1991,4,362444,69.8,339735,65.4,22709,6.3
District of Columbia,1991,4,320101,66.4,296288,61.5,23813,7.4
Florida,1991,4,6487076,62.2,6006927,57.6,480149,7.4
Georgia,1991,4,3313068,66.9,3129497,63.2,183571,5.5
Hawaii,1991,4,562738,68.4,547736,66.5,15002,2.7
Idaho,1991,4,505761,67.7,473148,63.3,32613,6.4
Illinois,1991,4,5932103,67.8,5526693,63.1,405410,6.8
Indiana,1991,4,2807118,66.3,2639306,62.4,167812,6.0
Iowa,1991,4,1466780,69.8,1396635,66.5,70145,4.8
Kansas,1991,4,1284861,70.2,1224891,66.9,59970,4.7
Kentucky,1991,4,1765994,62.6,1633427,57.9,132567,7.5
Louisiana,1991,4,1900998,61.5,1761668,57.0,139330,7.3
Maine,1991,4,643707,68.2,589790,62.5,53917,8.4
Maryland,1991,4,2611311,70.3,2454026,66.1,157285,6.0
Massachusetts,1991,4,3180770,67.7,2901306,61.7,279464,8.8
Michigan,1991,4,4605663,65.2,4166627,59.0,439036,9.5
Minnesota,1991,4,2426660,73.5,2299259,69.7,127401,5.3
Mississippi,1991,4,1192745,62.4,1088358,56.9,104387,8.8
Missouri,1991,4,2636928,67.9,2457225,63.2,179703,6.8
Montana,1991,4,401091,66.8,372444,62.0,28647,7.1
Nebraska,1991,4,836962,71.5,814975,69.6,21987,2.6
Nevada,1991,4,695226,70.5,654411,66.4,40815,5.9
New Hampshire,1991,4,621525,73.2,579728,68.3,41797,6.7
New Jersey,1991,4,4061230,66.9,3793402,62.5,267828,6.6
New Mexico,1991,4,720983,63.6,667153,58.9,53830,7.5
New York,1991,4,8771073,62.2,8140451,57.8,630622,7.2
New York city,1991,4,3286992,56.2,3003654,51.3,283338,8.6
North Carolina,1991,4,3523932,68.1,3312104,64.0,211828,6.0
North Dakota,1991,4,316913,68.3,302893,65.3,14020,4.4
Ohio,1991,4,5419238,65.4,5059329,61.1,359909,6.6
Oklahoma,1991,4,1512104,64.1,1420833,60.2,91271,6.0
Oregon,1991,4,1510184,67.7,1421058,63.7,89126,5.9
Pennsylvania,1991,4,5840798,63.2,5434434,58.8,406364,7.0
Rhode Island,1991,4,526268,67.5,482494,61.9,43774,8.3
South Carolina,1991,4,1758962,66.3,1655639,62.4,103323,5.9
South Dakota,1991,4,353217,70.0,340585,67.5,12632,3.6
Tennessee,1991,4,2411501,63.3,2252282,59.1,159219,6.6
Texas,1991,4,8728584,68.4,8127517,63.7,601067,6.9
Utah,1991,4,841627,70.6,801759,67.3,39868,4.7
Vermont,1991,4,305958,70.9,287470,66.6,18488,6.0
Virginia,1991,4,3302942,70.3,3112468,66.2,190474,5.8
Washington,1991,4,2546073,68.1,2394626,64.0,151447,5.9
West Virginia,1991,4,779355,55.4,698212,49.6,81143,10.4
Wisconsin,1991,4,2628334,70.8,2479120,66.8,149214,5.7
Wyoming,1991,4,236518,71.2,224877,67.7,11641,4.9
Alabama,1991,5,1925021,61.9,1783310,57.3,141711,7.4
Alaska,1991,5,275554,72.5,252909,66.6,22645,8.2
Arizona,1991,5,1795600,63.2,1701072,59.9,94528,5.3
Arkansas,1991,5,1132834,62.9,1048738,58.3,84096,7.4
California,1991,5,15117199,66.5,13941896,61.3,1175303,7.8
Los Angeles County,1991,5,4438181,66.0,4086191,60.8,351990,7.9
Colorado,1991,5,1801613,71.1,1708140,67.4,93473,5.2
Connecticut,1991,5,1829360,71.1,1711538,66.5,117822,6.4
Delaware,1991,5,361824,69.5,339715,65.3,22109,6.1
District of Columbia,1991,5,320332,66.6,296020,61.5,24312,7.6
Florida,1991,5,6495058,62.1,6006811,57.4,488247,7.5
Georgia,1991,5,3313411,66.8,3134286,63.2,179125,5.4
Hawaii,1991,5,563359,68.3,548157,66.5,15202,2.7
Idaho,1991,5,507497,67.8,475131,63.4,32366,6.4
Illinois,1991,5,5927514,67.7,5515850,63.0,411664,6.9
Indiana,1991,5,2803612,66.2,2639414,62.3,164198,5.9
Iowa,1991,5,1469242,69.9,1399625,66.6,69617,4.7
Kansas,1991,5,1284732,70.2,1225852,66.9,58880,4.6
Kentucky,1991,5,1765159,62.5,1632847,57.8,132312,7.5
Louisiana,1991,5,1903280,61.5,1763693,57.0,139587,7.3
Maine,1991,5,642064,68.0,589241,62.4,52823,8.2
Maryland,1991,5,2613175,70.3,2456564,66.1,156611,6.0
Massachusetts,1991,5,3179644,67.7,2895653,61.7,283991,8.9
Michigan,1991,5,4598040,65.1,4160750,58.9,437290,9.5
Minnesota,1991,5,2428669,73.5,2302009,69.7,126660,5.2
Mississippi,1991,5,1191140,62.3,1087130,56.8,104010,8.7
Missouri,1991,5,2635908,67.8,2458158,63.2,177750,6.7
Montana,1991,5,401173,66.8,372901,62.1,28272,7.0
Nebraska,1991,5,837936,71.5,815702,69.6,22234,2.7
Nevada,1991,5,697417,70.3,656439,66.2,40978,5.9
New Hampshire,1991,5,620776,73.2,578547,68.3,42229,6.8
New Jersey,1991,5,4062784,66.9,3793148,62.5,269636,6.6
New Mexico,1991,5,722150,63.6,668589,58.9,53561,7.4
New York,1991,5,8770127,62.2,8127978,57.7,642149,7.3
New York city,1991,5,3287276,56.2,2998151,51.3,289125,8.8
North Carolina,1991,5,3528604,68.1,3316328,64.0,212276,6.0
North Dakota,1991,5,316675,68.4,302540,65.3,14135,4.5
Ohio,1991,5,5416730,65.3,5057505,61.0,359225,6.6
Oklahoma,1991,5,1511076,64.0,1420378,60.2,90698,6.0
Oregon,1991,5,1512480,67.6,1422608,63.6,89872,5.9
Pennsylvania,1991,5,5841281,63.1,5434505,58.7,406776,7.0
Rhode Island,1991,5,525498,67.4,481316,61.8,44182,8.4
South Carolina,1991,5,1761390,66.3,1656666,62.3,104724,5.9
South Dakota,1991,5,353717,70.1,341060,67.6,12657,3.6
Tennessee,1991,5,2414258,63.3,2254159,59.1,160099,6.6
Texas,1991,5,8740730,68.4,8139156,63.7,601574,6.9
Utah,1991,5,844186,70.6,804047,67.2,40139,4.8
Vermont,1991,5,306132,70.8,287553,66.5,18579,6.1
Virginia,1991,5,3309457,70.3,3118233,66.3,191224,5.8
Washington,1991,5,2550087,68.0,2397526,63.9,152561,6.0
West Virginia,1991,5,779958,55.4,697836,49.6,82122,10.5
Wisconsin,1991,5,2627396,70.7,2480780,66.8,146616,5.6
Wyoming,1991,5,236561,71.2,225029,67.7,11532,4.9
Alabama,1991,6,1924639,61.8,1783477,57.3,141162,7.3
Alaska,1991,6,276078,72.5,253159,66.5,22919,8.3
Arizona,1991,6,1800983,63.2,1701667,59.7,99316,5.5
Arkansas,1991,6,1133439,62.9,1050221,58.3,83218,7.3
California,1991,6,15116654,66.4,13933881,61.2,1182773,7.8
Los Angeles County,1991,6,4442156,66.1,4084712,60.7,357444,8.0
Colorado,1991,6,1803501,71.1,1709984,67.4,93517,5.2
Connecticut,1991,6,1829659,71.2,1709742,66.5,119917,6.6
Delaware,1991,6,361178,69.4,339713,65.3,21465,5.9
District of Columbia,1991,6,320539,66.8,295819,61.7,24720,7.7
Florida,1991,6,6505646,62.1,6009923,57.3,495723,7.6
Georgia,1991,6,3313061,66.6,3138864,63.1,174197,5.3
Hawaii,1991,6,564193,68.3,548847,66.4,15346,2.7
Idaho,1991,6,509206,67.8,477179,63.5,32027,6.3
Illinois,1991,6,5922582,67.6,5504263,62.8,418319,7.1
Indiana,1991,6,2799571,66.0,2640172,62.3,159399,5.7
Iowa,1991,6,1471200,70.0,1402348,66.7,68852,4.7
Kansas,1991,6,1284298,70.1,1226704,67.0,57594,4.5
Kentucky,1991,6,1762978,62.4,1631860,57.7,131118,7.4
Louisiana,1991,6,1905238,61.6,1766104,57.1,139134,7.3
Maine,1991,6,640061,67.8,589171,62.4,50890,8.0
Maryland,1991,6,2614101,70.3,2459366,66.2,154735,5.9
Massachusetts,1991,6,3180055,67.7,2893087,61.6,286968,9.0
Michigan,1991,6,4589307,64.9,4158046,58.8,431261,9.4
Minnesota,1991,6,2430715,73.5,2305497,69.7,125218,5.2
Mississippi,1991,6,1188333,62.1,1085707,56.7,102626,8.6
Missouri,1991,6,2634334,67.7,2459139,63.2,175195,6.7
Montana,1991,6,401463,66.8,373682,62.1,27781,6.9
Nebraska,1991,6,838836,71.5,816468,69.6,22368,2.7
Nevada,1991,6,699341,70.1,658447,66.0,40894,5.8
New Hampshire,1991,6,620018,73.1,577523,68.1,42495,6.9
New Jersey,1991,6,4064304,66.9,3793412,62.5,270892,6.7
New Mexico,1991,6,723180,63.6,670221,58.9,52959,7.3
New York,1991,6,8764102,62.2,8116914,57.6,647188,7.4
New York city,1991,6,3285453,56.2,2993178,51.2,292275,8.9
North Carolina,1991,6,3534738,68.1,3324083,64.0,210655,6.0
North Dakota,1991,6,316451,68.3,302339,65.3,14112,4.5
Ohio,1991,6,5414446,65.3,5058473,61.0,355973,6.6
Oklahoma,1991,6,1510553,64.0,1420243,60.1,90310,6.0
Oregon,1991,6,1514913,67.5,1424161,63.5,90752,6.0
Pennsylvania,1991,6,5840939,63.1,5436748,58.7,404191,6.9
Rhode Island,1991,6,524593,67.3,480228,61.6,44365,8.5
South Carolina,1991,6,1764073,66.3,1657936,62.3,106137,6.0
South Dakota,1991,6,354125,70.2,341496,67.7,12629,3.6
Tennessee,1991,6,2418086,63.3,2257568,59.1,160518,6.6
Texas,1991,6,8753963,68.4,8151807,63.7,602156,6.9
Utah,1991,6,846724,70.6,806416,67.3,40308,4.8
Vermont,1991,6,306356,70.8,287849,66.6,18507,6.0
Virginia,1991,6,3316321,70.4,3125041,66.4,191280,5.8
Washington,1991,6,2554325,68.0,2400885,63.9,153440,6.0
West Virginia,1991,6,780501,55.4,697535,49.5,82966,10.6
Wisconsin,1991,6,2626293,70.6,2483596,66.8,142697,5.4
Wyoming,1991,6,236606,71.0,225179,67.5,11427,4.8
Alabama,1991,7,1923943,61.7,1783529,57.2,140414,7.3
Alaska,1991,7,276462,72.4,253312,66.3,23150,8.4
Arizona,1991,7,1807201,63.3,1702473,59.6,104728,5.8
Arkansas,1991,7,1134366,62.9,1052135,58.3,82231,7.2
California,1991,7,15118028,66.4,13930842,61.2,1187186,7.9
Los Angeles County,1991,7,4447838,66.2,4086102,60.8,361736,8.1
Colorado,1991,7,1804875,71.0,1711091,67.3,93784,5.2
Connecticut,1991,7,1829855,71.2,1708138,66.4,121717,6.7
Delaware,1991,7,360770,69.2,339951,65.2,20819,5.8
District of Columbia,1991,7,320533,66.9,295532,61.7,25001,7.8
Florida,1991,7,6515929,62.0,6013813,57.3,502116,7.7
Georgia,1991,7,3312566,66.5,3143241,63.1,169325,5.1
Hawaii,1991,7,565159,68.3,549649,66.4,15510,2.7
Idaho,1991,7,510881,67.8,479113,63.6,31768,6.2
Illinois,1991,7,5918182,67.5,5491052,62.6,427130,7.2
Indiana,1991,7,2795542,65.9,2640755,62.2,154787,5.5
Iowa,1991,7,1472315,70.0,1404249,66.8,68066,4.6
Kansas,1991,7,1283949,70.1,1227613,67.0,56336,4.4
Kentucky,1991,7,1759998,62.3,1630537,57.7,129461,7.4
Louisiana,1991,7,1906913,61.6,1768782,57.1,138131,7.2
Maine,1991,7,638327,67.7,589596,62.5,48731,7.6
Maryland,1991,7,2615072,70.3,2462412,66.2,152660,5.8
Massachusetts,1991,7,3181084,67.8,2892555,61.7,288529,9.1
Michigan,1991,7,4582570,64.8,4158466,58.8,424104,9.3
Minnesota,1991,7,2432505,73.5,2308747,69.8,123758,5.1
Mississippi,1991,7,1184643,61.9,1084244,56.6,100399,8.5
Missouri,1991,7,2632736,67.6,2460526,63.2,172210,6.5
Montana,1991,7,402007,66.7,374649,62.2,27358,6.8
Nebraska,1991,7,839706,71.5,817204,69.6,22502,2.7
Nevada,1991,7,701158,69.9,660375,65.8,40783,5.8
New Hampshire,1991,7,619313,73.0,576691,68.0,42622,6.9
New Jersey,1991,7,4065073,66.9,3792270,62.4,272803,6.7
New Mexico,1991,7,723874,63.6,671761,59.0,52113,7.2
New York,1991,7,8753769,62.1,8105713,57.5,648056,7.4
New York city,1991,7,3282798,56.1,2988981,51.1,293817,9.0
North Carolina,1991,7,3541651,68.1,3333187,64.1,208464,5.9
North Dakota,1991,7,316253,68.3,302284,65.2,13969,4.4
Ohio,1991,7,5411862,65.2,5060524,61.0,351338,6.5
Oklahoma,1991,7,1510398,63.9,1420382,60.1,90016,6.0
Oregon,1991,7,1516934,67.5,1425035,63.4,91899,6.1
Pennsylvania,1991,7,5840418,63.1,5439481,58.7,400937,6.9
Rhode Island,1991,7,523938,67.2,479441,61.5,44497,8.5
South Carolina,1991,7,1767316,66.3,1659436,62.2,107880,6.1
South Dakota,1991,7,354487,70.1,341924,67.6,12563,3.5
Tennessee,1991,7,2422005,63.3,2261164,59.1,160841,6.6
Texas,1991,7,8767631,68.4,8164477,63.7,603154,6.9
Utah,1991,7,849244,70.6,808810,67.3,40434,4.8
Vermont,1991,7,306610,70.9,288318,66.7,18292,6.0
Virginia,1991,7,3323469,70.5,3132235,66.4,191234,5.8
Washington,1991,7,2558757,67.9,2404135,63.8,154622,6.0
West Virginia,1991,7,780933,55.4,697322,49.5,83611,10.7
Wisconsin,1991,7,2625846,70.5,2486773,66.8,139073,5.3
Wyoming,1991,7,236647,71.0,225289,67.6,11358,4.8
Alabama,1991,8,1923588,61.7,1783691,57.2,139897,7.3
Alaska,1991,8,276825,72.3,253404,66.2,23421,8.5
Arizona,1991,8,1813889,63.3,1703299,59.5,110590,6.1
Arkansas,1991,8,1135831,62.9,1054326,58.4,81505,7.2
California,1991,8,15123234,66.3,13930143,61.1,1193091,7.9
Los Angeles County,1991,8,4454805,66.2,4088948,60.8,365857,8.2
Colorado,1991,8,1805987,70.8,1711313,67.1,94674,5.2
Connecticut,1991,8,1830030,71.2,1706671,66.4,123359,6.7
Delaware,1991,8,360796,69.0,340480,65.2,20316,5.6
District of Columbia,1991,8,320345,67.0,295128,61.7,25217,7.9
Florida,1991,8,6524509,62.0,6016467,57.2,508042,7.8
Georgia,1991,8,3313316,66.4,3147833,63.1,165483,5.0
Hawaii,1991,8,566138,68.3,550345,66.4,15793,2.8
Idaho,1991,8,512493,67.9,480798,63.7,31695,6.2
Illinois,1991,8,5916745,67.4,5477621,62.4,439124,7.4
Indiana,1991,8,2792629,65.7,2640826,62.2,151803,5.4
Iowa,1991,8,1472722,69.9,1405115,66.7,67607,4.6
Kansas,1991,8,1284211,70.0,1228907,67.0,55304,4.3
Kentucky,1991,8,1757296,62.1,1629249,57.6,128047,7.3
Louisiana,1991,8,1908430,61.6,1771424,57.2,137006,7.2
Maine,1991,8,637358,67.5,590259,62.5,47099,7.4
Maryland,1991,8,2617357,70.3,2465492,66.2,151865,5.8
Massachusetts,1991,8,3182436,67.8,2893323,61.7,289113,9.1
Michigan,1991,8,4580408,64.7,4160909,58.8,419499,9.2
Minnesota,1991,8,2433997,73.5,2311214,69.8,122783,5.0
Mississippi,1991,8,1180678,61.6,1082778,56.5,97900,8.3
Missouri,1991,8,2631837,67.6,2462416,63.2,169421,6.4
Montana,1991,8,402821,66.8,375656,62.3,27165,6.7
Nebraska,1991,8,840553,71.5,817897,69.6,22656,2.7
Nevada,1991,8,703096,69.8,662179,65.7,40917,5.8
New Hampshire,1991,8,618701,73.0,575983,67.9,42718,6.9
New Jersey,1991,8,4065222,66.9,3788873,62.3,276349,6.8
New Mexico,1991,8,724363,63.5,673050,59.0,51313,7.1
New York,1991,8,8741406,62.0,8092762,57.4,648644,7.4
New York city,1991,8,3280502,56.1,2985091,51.0,295411,9.0
North Carolina,1991,8,3548465,68.2,3341427,64.2,207038,5.8
North Dakota,1991,8,316111,68.2,302331,65.2,13780,4.4
Ohio,1991,8,5409862,65.2,5062366,61.0,347496,6.4
Oklahoma,1991,8,1510398,63.8,1420912,60.1,89486,5.9
Oregon,1991,8,1518893,67.5,1425256,63.3,93637,6.2
Pennsylvania,1991,8,5841185,63.1,5441458,58.7,399727,6.8
Rhode Island,1991,8,523778,67.2,479017,61.4,44761,8.5
South Carolina,1991,8,1771230,66.3,1661063,62.2,110167,6.2
South Dakota,1991,8,354858,70.2,342388,67.7,12470,3.5
Tennessee,1991,8,2425271,63.3,2263930,59.1,161341,6.7
Texas,1991,8,8783264,68.4,8176567,63.7,606697,6.9
Utah,1991,8,851728,70.6,811176,67.2,40552,4.8
Vermont,1991,8,306910,71.0,288835,66.8,18075,5.9
Virginia,1991,8,3330867,70.6,3138983,66.5,191884,5.8
Washington,1991,8,2563623,67.9,2407055,63.8,156568,6.1
West Virginia,1991,8,781414,55.4,697165,49.5,84249,10.8
Wisconsin,1991,8,2626953,70.5,2489998,66.8,136955,5.2
Wyoming,1991,8,236726,70.8,225349,67.4,11377,4.8
Alabama,1991,9,1924313,61.6,1784311,57.1,140002,7.3
Alaska,1991,9,277400,72.3,253585,66.1,23815,8.6
Arizona,1991,9,1821144,63.4,1704266,59.3,116878,6.4
Arkansas,1991,9,1138127,63.0,1056762,58.5,81365,7.1
California,1991,9,15134655,66.3,13929655,61.0,1205000,8.0
Los Angeles County,1991,9,4462413,66.3,4091424,60.8,370989,8.3
Colorado,1991,9,1807265,70.7,1711057,66.9,96208,5.3
Connecticut,1991,9,1830298,71.3,1705240,66.4,125058,6.8
Delaware,1991,9,361287,69.1,341264,65.3,20023,5.5
District of Columbia,1991,9,320193,67.0,294727,61.7,25466,8.0
Florida,1991,9,6531951,62.0,6017182,57.1,514769,7.9
Georgia,1991,9,3316575,66.3,3152742,63.1,163833,4.9
Hawaii,1991,9,567020,68.3,550764,66.4,16256,2.9
Idaho,1991,9,514089,67.9,482220,63.7,31869,6.2
Illinois,1991,9,5921232,67.4,5466879,62.2,454353,7.7
Indiana,1991,9,2792502,65.7,2641294,62.1,151208,5.4
Iowa,1991,9,1472938,69.9,1405265,66.7,67673,4.6
Kansas,1991,9,1285335,70.0,1230817,67.0,54518,4.2
Kentucky,1991,9,1755940,62.0,1628648,57.5,127292,7.2
Louisiana,1991,9,1910234,61.6,1773739,57.2,136495,7.1
Maine,1991,9,637304,67.5,590869,62.6,46435,7.3
Maryland,1991,9,2621427,70.4,2468216,66.3,153211,5.8
Massachusetts,1991,9,3184956,67.9,2895604,61.7,289352,9.1
Michigan,1991,9,4584138,64.7,4164642,58.8,419496,9.2
Minnesota,1991,9,2435406,73.4,2312925,69.7,122481,5.0
Mississippi,1991,9,1177305,61.4,1081486,56.4,95819,8.1
Missouri,1991,9,2632086,67.5,2464747,63.2,167339,6.4
Montana,1991,9,403890,66.8,376604,62.3,27286,6.8
Nebraska,1991,9,841405,71.5,818575,69.5,22830,2.7
Nevada,1991,9,705438,69.7,663868,65.6,41570,5.9
New Hampshire,1991,9,618266,72.9,575383,67.9,42883,6.9
New Jersey,1991,9,4065899,66.9,3783699,62.2,282200,6.9
New Mexico,1991,9,725070,63.4,674050,58.9,51020,7.0
New York,1991,9,8729813,61.9,8076760,57.3,653053,7.5
New York city,1991,9,3279604,56.1,2980768,51.0,298836,9.1
North Carolina,1991,9,3554838,68.2,3347360,64.2,207478,5.8
North Dakota,1991,9,316061,68.2,302430,65.2,13631,4.3
Ohio,1991,9,5411059,65.1,5064430,61.0,346629,6.4
Oklahoma,1991,9,1510859,63.8,1421951,60.0,88908,5.9
Oregon,1991,9,1521482,67.5,1425201,63.2,96281,6.3
Pennsylvania,1991,9,5845348,63.1,5442800,58.7,402548,6.9
Rhode Island,1991,9,524145,67.2,478928,61.4,45217,8.6
South Carolina,1991,9,1775597,66.4,1662811,62.2,112786,6.4
South Dakota,1991,9,355315,70.1,342954,67.7,12361,3.5
Tennessee,1991,9,2427555,63.3,2265430,59.1,162125,6.7
Texas,1991,9,8803379,68.5,8188254,63.7,615125,7.0
Utah,1991,9,854237,70.5,813521,67.2,40716,4.8
Vermont,1991,9,307264,71.0,289282,66.9,17982,5.9
Virginia,1991,9,3338749,70.6,3144759,66.5,193990,5.8
Washington,1991,9,2569594,67.9,2409991,63.7,159603,6.2
West Virginia,1991,9,782165,55.5,697056,49.4,85109,10.9
Wisconsin,1991,9,2629896,70.5,2493582,66.8,136314,5.2
Wyoming,1991,9,236913,70.8,225381,67.4,11532,4.9
Alabama,1991,10,1925981,61.6,1785187,57.1,140794,7.3
Alaska,1991,10,278258,72.1,253941,65.8,24317,8.7
Arizona,1991,10,1828754,63.4,1705230,59.2,123524,6.8
Arkansas,1991,10,1141159,63.1,1059331,58.6,81828,7.2
California,1991,10,15150777,66.3,13926208,60.9,1224569,8.1
Los Angeles County,1991,10,4467594,66.3,4090013,60.7,377581,8.5
Colorado,1991,10,1808912,70.6,1710534,66.7,98378,5.4
Connecticut,1991,10,1830312,71.3,1703402,66.3,126910,6.9
Delaware,1991,10,361953,69.1,342071,65.3,19882,5.5
District of Columbia,1991,10,320098,67.0,294284,61.6,25814,8.1
Florida,1991,10,6538939,61.9,6015959,57.0,522980,8.0
Georgia,1991,10,3322128,66.3,3157237,63.0,164891,5.0
Hawaii,1991,10,567773,68.3,550870,66.3,16903,3.0
Idaho,1991,10,515566,67.9,483298,63.7,32268,6.3
Illinois,1991,10,5931886,67.5,5460625,62.1,471261,7.9
Indiana,1991,10,2795359,65.7,2642723,62.1,152636,5.5
Iowa,1991,10,1473292,69.8,1405140,66.6,68152,4.6
Kansas,1991,10,1287224,70.0,1233184,67.0,54040,4.2
Kentucky,1991,10,1755725,61.9,1628678,57.4,127047,7.2
Louisiana,1991,10,1912495,61.6,1775371,57.2,137124,7.2
Maine,1991,10,637932,67.5,591194,62.6,46738,7.3
Maryland,1991,10,2626469,70.4,2469815,66.2,156654,6.0
Massachusetts,1991,10,3188344,68.0,2898728,61.8,289616,9.1
Michigan,1991,10,4593016,64.8,4169363,58.8,423653,9.2
Minnesota,1991,10,2436492,73.4,2313826,69.7,122666,5.0
Mississippi,1991,10,1174894,61.2,1080377,56.3,94517,8.0
Missouri,1991,10,2632893,67.5,2466995,63.2,165898,6.3
Montana,1991,10,405034,66.9,377406,62.4,27628,6.8
Nebraska,1991,10,842156,71.5,819148,69.5,23008,2.7
Nevada,1991,10,708111,69.7,665356,65.5,42755,6.0
New Hampshire,1991,10,617879,72.9,574756,67.8,43123,7.0
New Jersey,1991,10,4067637,66.9,3777465,62.1,290172,7.1
New Mexico,1991,10,726006,63.3,674697,58.8,51309,7.1
New York,1991,10,8719869,61.8,8056199,57.1,663670,7.6
New York city,1991,10,3280086,56.1,2974971,50.8,305115,9.3
North Carolina,1991,10,3560128,68.2,3349884,64.2,210244,5.9
North Dakota,1991,10,316074,68.0,302489,65.1,13585,4.3
Ohio,1991,10,5415826,65.1,5066306,60.9,349520,6.5
Oklahoma,1991,10,1512303,63.8,1423212,60.0,89091,5.9
Oregon,1991,10,1524648,67.5,1424726,63.0,99922,6.6
Pennsylvania,1991,10,5852629,63.1,5443299,58.7,409330,7.0
Rhode Island,1991,10,524883,67.3,479051,61.4,45832,8.7
South Carolina,1991,10,1779663,66.5,1664345,62.2,115318,6.5
South Dakota,1991,10,355855,70.2,343597,67.8,12258,3.4
Tennessee,1991,10,2429140,63.3,2265941,59.0,163199,6.7
Texas,1991,10,8827072,68.6,8198985,63.7,628087,7.1
Utah,1991,10,856691,70.5,815717,67.1,40974,4.8
Vermont,1991,10,307643,71.0,289562,66.8,18081,5.9
Virginia,1991,10,3346755,70.7,3149000,66.5,197755,5.9
Washington,1991,10,2577068,68.0,2413302,63.7,163766,6.4
West Virginia,1991,10,783168,55.5,696919,49.4,86249,11.0
Wisconsin,1991,10,2633894,70.5,2497657,66.9,136237,5.2
Wyoming,1991,10,237199,70.7,225367,67.2,11832,5.0
Alabama,1991,11,1928281,61.6,1786147,57.1,142134,7.4
Alaska,1991,11,279304,72.2,254443,65.8,24861,8.9
Arizona,1991,11,1836537,63.5,1706280,59.0,130257,7.1
Arkansas,1991,11,1144692,63.2,1062055,58.6,82637,7.2
California,1991,11,15169339,66.3,13918928,60.8,1250411,8.2
Los Angeles County,1991,11,4468741,66.3,4083557,60.6,385184,8.6
Colorado,1991,11,1811284,70.5,1710283,66.5,101001,5.6
Connecticut,1991,11,1829625,71.3,1700802,66.2,128823,7.0
Delaware,1991,11,362563,69.2,342743,65.4,19820,5.5
District of Columbia,1991,11,320064,67.0,293836,61.5,26228,8.2
Florida,1991,11,6546044,61.9,6013806,56.9,532238,8.1
Georgia,1991,11,3329180,66.3,3160744,63.0,168436,5.1
Hawaii,1991,11,568437,68.3,550798,66.2,17639,3.1
Idaho,1991,11,516975,67.9,484163,63.6,32812,6.3
Illinois,1991,11,5946284,67.6,5459501,62.1,486783,8.2
Indiana,1991,11,2800590,65.7,2645103,62.1,155487,5.6
Iowa,1991,11,1480975,70.1,1412112,66.9,68863,4.6
Kansas,1991,11,1289776,70.0,1235798,67.1,53978,4.2
Kentucky,1991,11,1756068,61.9,1629195,57.4,126873,7.2
Louisiana,1991,11,1915211,61.7,1776222,57.2,138989,7.3
Maine,1991,11,638896,67.6,591217,62.6,47679,7.5
Maryland,1991,11,2631768,70.6,2470045,66.2,161723,6.1
Massachusetts,1991,11,3191316,68.0,2901425,61.9,289891,9.1
Michigan,1991,11,4604970,64.9,4174922,58.8,430048,9.3
Minnesota,1991,11,2437255,73.4,2314287,69.6,122968,5.0
Mississippi,1991,11,1173620,61.1,1079503,56.2,94117,8.0
Missouri,1991,11,2633743,67.5,2468710,63.2,165033,6.3
Montana,1991,11,406073,67.0,378108,62.4,27965,6.9
Nebraska,1991,11,842679,71.4,819507,69.5,23172,2.7
Nevada,1991,11,710875,69.7,666657,65.4,44218,6.2
New Hampshire,1991,11,617449,72.8,574046,67.7,43403,7.0
New Jersey,1991,11,4070028,66.9,3770967,62.0,299061,7.3
New Mexico,1991,11,727146,63.3,675134,58.8,52012,7.2
New York,1991,11,8712428,61.8,8032894,56.9,679534,7.8
New York city,1991,11,3281515,56.1,2967897,50.7,313618,9.6
North Carolina,1991,11,3563951,68.2,3349245,64.1,214706,6.0
North Dakota,1991,11,316139,68.0,302473,65.1,13666,4.3
Ohio,1991,11,5423461,65.2,5067461,60.9,356000,6.6
Oklahoma,1991,11,1514622,63.8,1424475,60.0,90147,6.0
Oregon,1991,11,1528091,67.5,1423962,62.9,104129,6.8
Pennsylvania,1991,11,5861046,63.2,5442841,58.7,418205,7.1
Rhode Island,1991,11,525839,67.4,479310,61.4,46529,8.8
South Carolina,1991,11,1782877,66.5,1665462,62.2,117415,6.6
South Dakota,1991,11,356427,70.3,344263,67.9,12164,3.4
Tennessee,1991,11,2430780,63.2,2266570,59.0,164210,6.8
Texas,1991,11,8852283,68.6,8209310,63.7,642973,7.3
Utah,1991,11,859122,70.4,817761,67.0,41361,4.8
Vermont,1991,11,308006,71.0,289658,66.8,18348,6.0
Virginia,1991,11,3354232,70.8,3151509,66.5,202723,6.0
Washington,1991,11,2585606,68.0,2417226,63.6,168380,6.5
West Virginia,1991,11,784271,55.5,696738,49.3,87533,11.2
Wisconsin,1991,11,2638180,70.5,2502425,66.9,135755,5.1
Wyoming,1991,11,237518,70.8,225318,67.2,12200,5.1
Alabama,1991,12,1931005,61.6,1787353,57.1,143652,7.4
Alaska,1991,12,280379,72.3,255040,65.8,25339,9.0
Arizona,1991,12,1844148,63.6,1707766,58.9,136382,7.4
Arkansas,1991,12,1148438,63.3,1065036,58.7,83402,7.3
California,1991,12,15187585,66.3,13908998,60.7,1278587,8.4
Los Angeles County,1991,12,4465915,66.2,4073188,60.4,392727,8.8
Colorado,1991,12,1814286,70.4,1710621,66.4,103665,5.7
Connecticut,1991,12,1828095,71.2,1697588,66.2,130507,7.1
Delaware,1991,12,363066,69.2,343313,65.4,19753,5.4
District of Columbia,1991,12,320064,67.1,293470,61.6,26594,8.3
Florida,1991,12,6553413,61.9,6012430,56.8,540983,8.3
Georgia,1991,12,3336765,66.4,3163383,62.9,173382,5.2
Hawaii,1991,12,569137,68.3,550709,66.1,18428,3.2
Idaho,1991,12,518503,68.0,485146,63.6,33357,6.4
Illinois,1991,12,5961920,67.7,5463670,62.1,498250,8.4
Indiana,1991,12,2807625,65.8,2648239,62.1,159386,5.7
Iowa,1991,12,1489064,70.4,1419539,67.2,69525,4.7
Kansas,1991,12,1292757,70.1,1238457,67.2,54300,4.2
Kentucky,1991,12,1756510,61.8,1630202,57.4,126308,7.2
Louisiana,1991,12,1918027,61.7,1776474,57.2,141553,7.4
Maine,1991,12,639888,67.8,591141,62.6,48747,7.6
Maryland,1991,12,2636759,70.7,2469455,66.2,167304,6.3
Massachusetts,1991,12,3192694,68.1,2902960,61.9,289734,9.1
Michigan,1991,12,4617574,65.0,4181404,58.9,436170,9.4
Minnesota,1991,12,2438224,73.3,2315149,69.6,123075,5.0
Mississippi,1991,12,1173376,61.1,1079023,56.2,94353,8.0
Missouri,1991,12,2634225,67.4,2469709,63.2,164516,6.2
Montana,1991,12,408575,67.4,380397,62.8,28178,6.9
Nebraska,1991,12,842942,71.4,819660,69.4,23282,2.8
Nevada,1991,12,713515,69.8,667861,65.3,45654,6.4
New Hampshire,1991,12,617011,72.7,573330,67.6,43681,7.1
New Jersey,1991,12,4072382,66.9,3764835,61.9,307547,7.6
New Mexico,1991,12,728381,63.3,675579,58.7,52802,7.2
New York,1991,12,8707458,61.7,8010067,56.8,697391,8.0
New York city,1991,12,3283470,56.1,2960697,50.6,322773,9.8
North Carolina,1991,12,3566272,68.2,3346590,64.0,219682,6.2
North Dakota,1991,12,316238,68.0,302391,65.1,13847,4.4
Ohio,1991,12,5434275,65.3,5068932,60.9,365343,6.7
Oklahoma,1991,12,1517452,63.9,1425953,60.0,91499,6.0
Oregon,1991,12,1531788,67.6,1423672,62.8,108116,7.1
Pennsylvania,1991,12,5868176,63.3,5441550,58.7,426626,7.3
Rhode Island,1991,12,526861,67.6,479657,61.5,47204,9.0
South Carolina,1991,12,1785179,66.6,1666383,62.1,118796,6.7
South Dakota,1991,12,357006,70.3,344906,67.9,12100,3.4
Tennessee,1991,12,2432760,63.2,2268034,59.0,164726,6.8
Texas,1991,12,8877275,68.7,8220393,63.7,656882,7.4
Utah,1991,12,861646,70.4,819750,67.0,41896,4.9
Vermont,1991,12,308343,71.1,289656,66.8,18687,6.1
Virginia,1991,12,3360738,70.8,3152783,66.5,207955,6.2
Washington,1991,12,2594587,68.2,2421896,63.6,172691,6.7
West Virginia,1991,12,785324,55.6,696685,49.3,88639,11.3
Wisconsin,1991,12,2642819,70.6,2508325,67.0,134494,5.1
Wyoming,1991,12,237818,70.7,225283,66.9,12535,5.3
Alabama,1992,1,1934181,61.7,1789192,57.1,144989,7.5
Alaska,1992,1,281503,72.4,255818,65.8,25685,9.1
Arizona,1992,1,1851118,63.7,1709964,58.8,141154,7.6
Arkansas,1992,1,1152189,63.5,1068343,58.9,83846,7.3
California,1992,1,15206059,66.3,13899792,60.6,1306267,8.6
Los Angeles County,1992,1,4460706,66.1,4060940,60.2,399766,9.0
Colorado,1992,1,1817886,70.4,1711771,66.3,106115,5.8
Connecticut,1992,1,1825890,71.2,1694154,66.1,131736,7.2
Delaware,1992,1,363492,69.2,343793,65.5,19699,5.4
District of Columbia,1992,1,320084,67.2,293244,61.6,26840,8.4
Florida,1992,1,6561712,61.9,6013854,56.7,547858,8.3
Georgia,1992,1,3344636,66.4,3165974,62.9,178662,5.3
Hawaii,1992,1,570014,68.3,550706,66.0,19308,3.4
Idaho,1992,1,520233,68.1,486455,63.7,33778,6.5
Illinois,1992,1,5978245,67.9,5473832,62.1,504413,8.4
Indiana,1992,1,2816059,66.0,2652476,62.1,163583,5.8
Iowa,1992,1,1497472,70.8,1427587,67.5,69885,4.7
Kansas,1992,1,1295931,70.2,1240968,67.2,54963,4.2
Kentucky,1992,1,1757189,61.8,1631945,57.4,125244,7.1
Louisiana,1992,1,1920929,61.8,1776664,57.2,144265,7.5
Maine,1992,1,640742,67.8,591208,62.6,49534,7.7
Maryland,1992,1,2641402,70.7,2469142,66.1,172260,6.5
Massachusetts,1992,1,3192203,68.1,2903383,61.9,288820,9.0
Michigan,1992,1,4629279,65.2,4189184,59.0,440095,9.5
Minnesota,1992,1,2439907,73.3,2316995,69.6,122912,5.0
Mississippi,1992,1,1174084,61.1,1079279,56.1,94805,8.1
Missouri,1992,1,2634536,67.4,2470302,63.2,164234,6.2
Montana,1992,1,411021,67.7,382762,63.0,28259,6.9
Nebraska,1992,1,843169,71.3,819808,69.4,23361,2.8
Nevada,1992,1,715946,69.8,669110,65.2,46836,6.5
New Hampshire,1992,1,616736,72.7,572765,67.5,43971,7.1
New Jersey,1992,1,4074691,66.9,3759579,61.8,315112,7.7
New Mexico,1992,1,729765,63.3,676272,58.7,53493,7.3
New York,1992,1,8706178,61.7,7991644,56.7,714534,8.2
New York city,1992,1,3286316,56.2,2954706,50.5,331610,10.1
North Carolina,1992,1,3568783,68.2,3344578,63.9,224205,6.3
North Dakota,1992,1,316361,68.1,302290,65.0,14071,4.4
Ohio,1992,1,5448349,65.5,5071532,60.9,376817,6.9
Oklahoma,1992,1,1520469,63.9,1427798,60.0,92671,6.1
Oregon,1992,1,1535704,67.6,1424524,62.7,111180,7.2
Pennsylvania,1992,1,5873673,63.3,5440757,58.7,432916,7.4
Rhode Island,1992,1,527828,67.7,480041,61.6,47787,9.1
South Carolina,1992,1,1786871,66.6,1667562,62.1,119309,6.7
South Dakota,1992,1,357619,70.4,345532,68.0,12087,3.4
Tennessee,1992,1,2435572,63.2,2270941,59.0,164631,6.8
Texas,1992,1,8902377,68.9,8233551,63.7,668826,7.5
Utah,1992,1,864371,70.4,821872,66.9,42499,4.9
Vermont,1992,1,308692,71.2,289678,66.8,19014,6.2
Virginia,1992,1,3366056,70.9,3153608,66.4,212448,6.3
Washington,1992,1,2603648,68.2,2427399,63.6,176249,6.8
West Virginia,1992,1,786277,55.6,696939,49.3,89338,11.4
Wisconsin,1992,1,2648565,70.7,2515774,67.2,132791,5.0
Wyoming,1992,1,238119,70.8,225311,66.9,12808,5.4
Alabama,1992,2,1938121,61.8,1791892,57.1,146229,7.5
Alaska,1992,2,282674,72.5,256792,65.9,25882,9.2
Arizona,1992,2,1857234,63.7,1712875,58.8,144359,7.8
Arkansas,1992,2,1155693,63.6,1071763,59.0,83930,7.3
California,1992,2,15226784,66.3,13893263,60.5,1333521,8.8
Los Angeles County,1992,2,4455029,66.0,4048116,60.0,406913,9.1
Colorado,1992,2,1822277,70.4,1713914,66.2,108363,5.9
Connecticut,1992,2,1823465,71.1,1690847,66.0,132618,7.3
Delaware,1992,2,363912,69.2,344216,65.4,19696,5.4
District of Columbia,1992,2,320004,67.3,293014,61.6,26990,8.4
Florida,1992,2,6572281,61.9,6019056,56.7,553225,8.4
Georgia,1992,2,3423071,67.9,3169079,62.8,253992,7.4
Hawaii,1992,2,571113,68.4,550829,65.9,20284,3.6
Idaho,1992,2,522120,68.2,488093,63.7,34027,6.5
Illinois,1992,2,5994309,68.0,5488248,62.3,506061,8.4
Indiana,1992,2,2825888,66.2,2658134,62.2,167754,5.9
Iowa,1992,2,1505891,71.1,1435929,67.8,69962,4.6
Kansas,1992,2,1299108,70.3,1243186,67.3,55922,4.3
Kentucky,1992,2,1758648,61.8,1634632,57.5,124016,7.1
Louisiana,1992,2,1924000,61.9,1777004,57.1,146996,7.6
Maine,1992,2,641375,67.9,591568,62.6,49807,7.8
Maryland,1992,2,2646055,70.9,2470060,66.1,175995,6.7
Massachusetts,1992,2,3190492,68.1,2902936,61.9,287556,9.0
Michigan,1992,2,4640269,65.3,4198338,59.1,441931,9.5
Minnesota,1992,2,2442760,73.4,2320081,69.7,122679,5.0
Mississippi,1992,2,1175900,61.2,1080489,56.2,95411,8.1
Missouri,1992,2,2635307,67.4,2470905,63.2,164402,6.2
Montana,1992,2,413457,68.0,385207,63.3,28250,6.8
Nebraska,1992,2,843687,71.4,820208,69.4,23479,2.8
Nevada,1992,2,718214,69.7,670502,65.1,47712,6.6
New Hampshire,1992,2,616721,72.7,572424,67.5,44297,7.2
New Jersey,1992,2,4077504,67.0,3754884,61.7,322620,7.9
New Mexico,1992,2,731343,63.3,677317,58.7,54026,7.4
New York,1992,2,8709813,61.7,7979433,56.6,730380,8.4
New York city,1992,2,3290950,56.3,2950604,50.4,340346,10.3
North Carolina,1992,2,3572951,68.2,3345585,63.8,227366,6.4
North Dakota,1992,2,316509,68.1,302205,65.0,14304,4.5
Ohio,1992,2,5464225,65.6,5075302,61.0,388923,7.1
Oklahoma,1992,2,1523340,64.0,1429879,60.1,93461,6.1
Oregon,1992,2,1539960,67.7,1426921,62.7,113039,7.3
Pennsylvania,1992,2,5878157,63.4,5441213,58.7,436944,7.4
Rhode Island,1992,2,528771,67.8,480468,61.6,48303,9.1
South Carolina,1992,2,1788485,66.6,1669233,62.1,119252,6.7
South Dakota,1992,2,358261,70.5,346127,68.1,12134,3.4
Tennessee,1992,2,2439709,63.3,2275867,59.0,163842,6.7
Texas,1992,2,8927979,69.0,8248679,63.7,679300,7.6
Utah,1992,2,867284,70.4,824256,66.9,43028,5.0
Vermont,1992,2,309027,71.3,289787,66.8,19240,6.2
Virginia,1992,2,3370521,70.9,3154950,66.4,215571,6.4
Washington,1992,2,2612610,68.4,2433547,63.7,179063,6.9
West Virginia,1992,2,787108,55.7,697441,49.4,89667,11.4
Wisconsin,1992,2,2656035,70.8,2524441,67.3,131594,5.0
Wyoming,1992,2,238427,70.6,225403,66.8,13024,5.5
Alabama,1992,3,1943590,61.9,1796132,57.2,147458,7.6
Alaska,1992,3,283799,72.6,257848,66.0,25951,9.1
Arizona,1992,3,1862604,63.7,1716566,58.7,146038,7.8
Arkansas,1992,3,1158770,63.8,1075055,59.2,83715,7.2
California,1992,3,15252804,66.4,13892272,60.5,1360532,8.9
Los Angeles County,1992,3,4451550,66.0,4036775,59.8,414775,9.3
Colorado,1992,3,1827756,70.5,1717315,66.2,110441,6.0
Connecticut,1992,3,1821758,71.1,1688472,65.9,133286,7.3
Delaware,1992,3,364493,69.3,344778,65.5,19715,5.4
District of Columbia,1992,3,319786,67.3,292716,61.6,27070,8.5
Florida,1992,3,6586010,61.9,6028403,56.7,557607,8.5
Georgia,1992,3,3422747,67.7,3173382,62.8,249365,7.3
Hawaii,1992,3,572594,68.4,551223,65.9,21371,3.7
Idaho,1992,3,524224,68.3,490066,63.8,34158,6.5
Illinois,1992,3,6009454,68.1,5504928,62.4,504526,8.4
Indiana,1992,3,2837280,66.4,2665500,62.4,171780,6.1
Iowa,1992,3,1514047,71.5,1444272,68.2,69775,4.6
Kansas,1992,3,1302460,70.4,1245424,67.3,57036,4.4
Kentucky,1992,3,1761664,61.9,1638717,57.6,122947,7.0
Louisiana,1992,3,1927337,61.9,1777754,57.1,149583,7.8
Maine,1992,3,641895,68.0,592404,62.7,49491,7.7
Maryland,1992,3,2651126,71.0,2473081,66.2,178045,6.7
Massachusetts,1992,3,3189057,68.1,2902747,61.9,286310,9.0
Michigan,1992,3,4652221,65.4,4209679,59.2,442542,9.5
Minnesota,1992,3,2447334,73.4,2324621,69.8,122713,5.0
Mississippi,1992,3,1179254,61.3,1083092,56.3,96162,8.2
Missouri,1992,3,2637368,67.4,2472390,63.2,164978,6.3
Montana,1992,3,415830,68.3,387613,63.6,28217,6.8
Nebraska,1992,3,844776,71.4,821103,69.4,23673,2.8
Nevada,1992,3,720506,69.7,672169,65.1,48337,6.7
New Hampshire,1992,3,617021,72.7,572399,67.5,44622,7.2
New Jersey,1992,3,4081586,67.0,3750764,61.6,330822,8.1
New Mexico,1992,3,733004,63.4,678704,58.7,54300,7.4
New York,1992,3,8719632,61.8,7975334,56.5,744298,8.5
New York city,1992,3,3298220,56.4,2949079,50.4,349141,10.6
North Carolina,1992,3,3579800,68.2,3350986,63.9,228814,6.4
North Dakota,1992,3,316758,68.1,302255,65.0,14503,4.6
Ohio,1992,3,5481324,65.8,5081073,61.0,400251,7.3
Oklahoma,1992,3,1525799,64.1,1432175,60.1,93624,6.1
Oregon,1992,3,1544862,67.8,1431142,62.8,113720,7.4
Pennsylvania,1992,3,5883544,63.4,5444143,58.7,439401,7.5
Rhode Island,1992,3,529778,68.0,481048,61.7,48730,9.2
South Carolina,1992,3,1790893,66.6,1671737,62.2,119156,6.7
South Dakota,1992,3,358990,70.5,346755,68.1,12235,3.4
Tennessee,1992,3,2445566,63.4,2283117,59.2,162449,6.6
Texas,1992,3,8954554,69.1,8266572,63.8,687982,7.7
Utah,1992,3,870481,70.5,827066,67.0,43415,5.0
Vermont,1992,3,309447,71.4,290081,66.9,19366,6.3
Virginia,1992,3,3375056,70.9,3158006,66.4,217050,6.4
Washington,1992,3,2621521,68.5,2440160,63.7,181361,6.9
West Virginia,1992,3,787857,55.7,698169,49.4,89688,11.4
Wisconsin,1992,3,2665739,71.0,2534019,67.5,131720,4.9
Wyoming,1992,3,238729,70.7,225569,66.8,13160,5.5
Alabama,1992,4,1950784,62.1,1802202,57.4,148582,7.6
Alaska,1992,4,284893,72.7,258949,66.1,25944,9.1
Arizona,1992,4,1867620,63.7,1721280,58.7,146340,7.8
Arkansas,1992,4,1161177,63.9,1077828,59.3,83349,7.2
California,1992,4,15284004,66.4,13895942,60.4,1388062,9.1
Los Angeles County,1992,4,4451694,65.9,4028014,59.7,423680,9.5
Colorado,1992,4,1833930,70.5,1721563,66.2,112367,6.1
Connecticut,1992,4,1821161,71.1,1687288,65.9,133873,7.4
Delaware,1992,4,365327,69.3,345640,65.6,19687,5.4
District of Columbia,1992,4,319353,67.3,292234,61.6,27119,8.5
Florida,1992,4,6601969,62.0,6040524,56.7,561445,8.5
Georgia,1992,4,3423953,67.6,3179158,62.8,244795,7.1
Hawaii,1992,4,574305,68.6,551898,65.9,22407,3.9
Idaho,1992,4,526504,68.4,492203,63.9,34301,6.5
Illinois,1992,4,6023607,68.3,5522450,62.6,501157,8.3
Indiana,1992,4,2849655,66.6,2673870,62.5,175785,6.2
Iowa,1992,4,1521547,71.8,1452196,68.5,69351,4.6
Kansas,1992,4,1306127,70.5,1247845,67.4,58282,4.5
Kentucky,1992,4,1766494,62.0,1644175,57.7,122319,6.9
Louisiana,1992,4,1930826,62.0,1778742,57.1,152084,7.9
Maine,1992,4,642382,68.0,593684,62.9,48698,7.6
Maryland,1992,4,2656269,71.1,2477833,66.3,178436,6.7
Massachusetts,1992,4,3188503,68.1,2903166,62.0,285337,8.9
Michigan,1992,4,4665646,65.6,4223179,59.3,442467,9.5
Minnesota,1992,4,2453473,73.5,2330167,69.8,123306,5.0
Mississippi,1992,4,1184186,61.5,1087184,56.5,97002,8.2
Missouri,1992,4,2640697,67.5,2475060,63.2,165637,6.3
Montana,1992,4,417997,68.5,389765,63.9,28232,6.8
Nebraska,1992,4,846344,71.4,822394,69.4,23950,2.8
Nevada,1992,4,722946,69.7,674099,65.0,48847,6.8
New Hampshire,1992,4,617563,72.8,572617,67.5,44946,7.3
New Jersey,1992,4,4086659,67.1,3746929,61.5,339730,8.3
New Mexico,1992,4,734621,63.4,680250,58.7,54371,7.4
New York,1992,4,8735103,61.9,7978590,56.6,756513,8.7
New York city,1992,4,3308541,56.6,2950318,50.4,358223,10.8
North Carolina,1992,4,3589256,68.3,3359909,64.0,229347,6.4
North Dakota,1992,4,317056,68.2,302423,65.0,14633,4.6
Ohio,1992,4,5498465,66.0,5088566,61.1,409899,7.5
Oklahoma,1992,4,1527715,64.1,1434461,60.2,93254,6.1
Oregon,1992,4,1550180,67.9,1436582,63.0,113598,7.3
Pennsylvania,1992,4,5890526,63.5,5449001,58.7,441525,7.5
Rhode Island,1992,4,530822,68.1,481766,61.8,49056,9.2
South Carolina,1992,4,1794331,66.7,1674964,62.2,119367,6.7
South Dakota,1992,4,359828,70.6,347456,68.2,12372,3.4
Tennessee,1992,4,2452179,63.5,2291366,59.3,160813,6.6
Texas,1992,4,8980902,69.2,8286008,63.8,694894,7.7
Utah,1992,4,873923,70.5,830284,67.0,43639,5.0
Vermont,1992,4,310052,71.5,290606,67.0,19446,6.3
Virginia,1992,4,3379433,70.9,3162444,66.4,216989,6.4
Washington,1992,4,2630176,68.6,2446735,63.8,183441,7.0
West Virginia,1992,4,788493,55.8,698933,49.4,89560,11.4
Wisconsin,1992,4,2677568,71.3,2544049,67.7,133519,5.0
Wyoming,1992,4,239018,70.6,225785,66.7,13233,5.5
Alabama,1992,5,1958510,62.3,1809171,57.5,149339,7.6
Alaska,1992,5,285886,72.6,260009,66.0,25877,9.1
Arizona,1992,5,1872182,63.7,1726652,58.7,145530,7.8
Arkansas,1992,5,1162581,63.9,1079672,59.3,82909,7.1
California,1992,5,15313501,66.5,13898720,60.4,1414781,9.2
Los Angeles County,1992,5,4453627,65.9,4020753,59.5,432874,9.7
Colorado,1992,5,1839985,70.6,1726015,66.2,113970,6.2
Connecticut,1992,5,1820951,71.2,1686633,65.9,134318,7.4
Delaware,1992,5,366238,69.5,346602,65.7,19636,5.4
District of Columbia,1992,5,318702,67.3,291549,61.6,27153,8.5
Florida,1992,5,6617368,62.1,6053065,56.8,564303,8.5
Georgia,1992,5,3425547,67.6,3185546,62.8,240001,7.0
Hawaii,1992,5,575898,68.7,552632,65.9,23266,4.0
Idaho,1992,5,528646,68.5,494127,64.0,34519,6.5
Illinois,1992,5,6034908,68.3,5539365,62.7,495543,8.2
Indiana,1992,5,2861099,66.8,2681856,62.6,179243,6.3
Iowa,1992,5,1524751,71.9,1455865,68.6,68886,4.5
Kansas,1992,5,1309643,70.6,1250128,67.4,59515,4.5
Kentucky,1992,5,1772372,62.2,1650137,57.9,122235,6.9
Louisiana,1992,5,1933378,62.1,1779111,57.1,154267,8.0
Maine,1992,5,642726,68.1,595054,63.0,47672,7.4
Maryland,1992,5,2660381,71.1,2482740,66.4,177641,6.7
Massachusetts,1992,5,3187794,68.1,2903322,62.0,284472,8.9
Michigan,1992,5,4678090,65.7,4236541,59.5,441549,9.4
Minnesota,1992,5,2459926,73.7,2335712,70.0,124214,5.0
Mississippi,1992,5,1189836,61.8,1092033,56.7,97803,8.2
Missouri,1992,5,2643901,67.5,2478076,63.3,165825,6.3
Montana,1992,5,419760,68.7,391449,64.1,28311,6.7
Nebraska,1992,5,847991,71.5,823701,69.4,24290,2.9
Nevada,1992,5,725401,69.7,676078,65.0,49323,6.8
New Hampshire,1992,5,617994,72.8,572769,67.5,45225,7.3
New Jersey,1992,5,4074406,66.9,3726018,61.2,348388,8.6
New Mexico,1992,5,735912,63.4,681635,58.7,54277,7.4
New York,1992,5,8750871,62.0,7983836,56.6,767035,8.8
New York city,1992,5,3319644,56.8,2952291,50.5,367353,11.1
North Carolina,1992,5,3599235,68.5,3369815,64.1,229420,6.4
North Dakota,1992,5,317250,68.1,302573,64.9,14677,4.6
Ohio,1992,5,5512427,66.1,5095487,61.1,416940,7.6
Oklahoma,1992,5,1528811,64.1,1436384,60.2,92427,6.0
Oregon,1992,5,1555119,68.1,1442001,63.1,113118,7.3
Pennsylvania,1992,5,5897454,63.6,5453699,58.8,443755,7.5
Rhode Island,1992,5,531631,68.2,482424,61.9,49207,9.3
South Carolina,1992,5,1798080,66.7,1678118,62.3,119962,6.7
South Dakota,1992,5,360625,70.8,348127,68.3,12498,3.5
Tennessee,1992,5,2458124,63.6,2299076,59.4,159048,6.5
Texas,1992,5,9002828,69.3,8303448,63.9,699380,7.8
Utah,1992,5,877286,70.5,833634,67.0,43652,5.0
Vermont,1992,5,310751,71.5,291247,67.0,19504,6.3
Virginia,1992,5,3382472,70.9,3166897,66.4,215575,6.4
Washington,1992,5,2638183,68.6,2452461,63.8,185722,7.0
West Virginia,1992,5,788801,55.8,699398,49.4,89403,11.3
Wisconsin,1992,5,2689984,71.6,2553255,67.9,136729,5.1
Wyoming,1992,5,239229,70.6,225972,66.7,13257,5.5
Alabama,1992,6,1965499,62.4,1815979,57.7,149520,7.6
Alaska,1992,6,286706,72.6,260927,66.1,25779,9.0
Arizona,1992,6,1875975,63.6,1731919,58.7,144056,7.7
Arkansas,1992,6,1162903,63.8,1080500,59.3,82403,7.1
California,1992,6,15335503,66.5,13896281,60.3,1439222,9.4
Los Angeles County,1992,6,4455076,65.9,4013675,59.4,441401,9.9
Colorado,1992,6,1845448,70.6,1730561,66.2,114887,6.2
Connecticut,1992,6,1820482,71.2,1685973,65.9,134509,7.4
Delaware,1992,6,367025,69.5,347445,65.8,19580,5.3
District of Columbia,1992,6,317867,67.1,290668,61.3,27199,8.6
Florida,1992,6,6630094,62.1,6064621,56.8,565473,8.5
Georgia,1992,6,3426474,67.5,3191734,62.8,234740,6.9
Hawaii,1992,6,577269,68.7,553244,65.9,24025,4.2
Idaho,1992,6,530490,68.6,495626,64.1,34864,6.6
Illinois,1992,6,6042066,68.4,5555635,62.9,486431,8.1
Indiana,1992,6,2869810,67.0,2688445,62.7,181365,6.3
Iowa,1992,6,1534006,72.2,1465536,69.0,68470,4.5
Kansas,1992,6,1312557,70.7,1252036,67.4,60521,4.6
Kentucky,1992,6,1778264,62.3,1655712,58.0,122552,6.9
Louisiana,1992,6,1934036,62.0,1778416,57.0,155620,8.0
Maine,1992,6,642875,68.0,596129,63.1,46746,7.3
Maryland,1992,6,2662701,71.2,2486447,66.5,176254,6.6
Massachusetts,1992,6,3186400,68.0,2903049,62.0,283351,8.9
Michigan,1992,6,4687166,65.8,4248123,59.6,439043,9.4
Minnesota,1992,6,2465704,73.8,2340626,70.0,125078,5.1
Mississippi,1992,6,1195232,62.0,1096908,56.9,98324,8.2
Missouri,1992,6,2645762,67.5,2480604,63.3,165158,6.2
Montana,1992,6,420408,68.7,391991,64.1,28417,6.8
Nebraska,1992,6,849412,71.5,824825,69.5,24587,2.9
Nevada,1992,6,727777,69.7,677988,64.9,49789,6.8
New Hampshire,1992,6,618105,72.8,572677,67.5,45428,7.3
New Jersey,1992,6,4064027,66.7,3708756,60.9,355271,8.7
New Mexico,1992,6,736935,63.3,682843,58.7,54092,7.3
New York,1992,6,8762742,62.1,7987488,56.6,775254,8.8
New York city,1992,6,3328635,56.9,2953294,50.5,375341,11.3
North Carolina,1992,6,3608205,68.5,3378878,64.2,229327,6.4
North Dakota,1992,6,317309,68.1,302654,64.9,14655,4.6
Ohio,1992,6,5520732,66.2,5099813,61.2,420919,7.6
Oklahoma,1992,6,1528974,64.0,1437877,60.2,91097,6.0
Oregon,1992,6,1559314,68.1,1446705,63.2,112609,7.2
Pennsylvania,1992,6,5903094,63.6,5457431,58.8,445663,7.5
Rhode Island,1992,6,532024,68.2,482910,61.9,49114,9.2
South Carolina,1992,6,1801256,66.8,1680557,62.3,120699,6.7
South Dakota,1992,6,361271,70.7,348693,68.3,12578,3.5
Tennessee,1992,6,2463473,63.6,2306059,59.6,157414,6.4
Texas,1992,6,9017991,69.3,8316986,63.9,701005,7.8
Utah,1992,6,880437,70.6,836956,67.1,43481,4.9
Vermont,1992,6,311474,71.6,291901,67.1,19573,6.3
Virginia,1992,6,3383683,70.9,3170553,66.4,213130,6.3
Washington,1992,6,2645598,68.7,2457154,63.8,188444,7.1
West Virginia,1992,6,788728,55.7,699479,49.4,89249,11.3
Wisconsin,1992,6,2701212,71.8,2560869,68.0,140343,5.2
Wyoming,1992,6,239355,70.5,226118,66.6,13237,5.5
Alabama,1992,7,1971012,62.6,1821865,57.8,149147,7.6
Alaska,1992,7,287403,72.6,261731,66.1,25672,8.9
Arizona,1992,7,1879078,63.6,1736581,58.7,142497,7.6
Arkansas,1992,7,1162420,63.7,1080621,59.3,81799,7.0
California,1992,7,15348541,66.5,13887168,60.2,1461373,9.5
Los Angeles County,1992,7,4454683,65.9,4005957,59.2,448726,10.1
Colorado,1992,7,1850344,70.6,1735277,66.2,115067,6.2
Connecticut,1992,7,1819636,71.2,1685166,65.9,134470,7.4
Delaware,1992,7,367628,69.6,348141,65.9,19487,5.3
District of Columbia,1992,7,316884,66.9,289616,61.2,27268,8.6
Florida,1992,7,6639938,62.1,6075212,56.8,564726,8.5
Georgia,1992,7,3426382,67.3,3197496,62.8,228886,6.7
Hawaii,1992,7,578451,68.8,553707,65.8,24744,4.3
Idaho,1992,7,531981,68.6,496771,64.1,35210,6.6
Illinois,1992,7,6045836,68.4,5571744,63.0,474092,7.8
Indiana,1992,7,2875176,67.0,2693344,62.8,181832,6.3
Iowa,1992,7,1532916,72.1,1464790,68.9,68126,4.4
Kansas,1992,7,1314694,70.7,1253491,67.5,61203,4.7
Kentucky,1992,7,1783350,62.5,1660332,58.1,123018,6.9
Louisiana,1992,7,1932627,61.9,1776675,57.0,155952,8.1
Maine,1992,7,642894,68.0,596718,63.1,46176,7.2
Maryland,1992,7,2663077,71.1,2488241,66.5,174836,6.6
Massachusetts,1992,7,3184450,68.0,2902646,62.0,281804,8.8
Michigan,1992,7,4692240,65.8,4257805,59.7,434435,9.3
Minnesota,1992,7,2470533,73.9,2344845,70.1,125688,5.1
Mississippi,1992,7,1199647,62.2,1101374,57.1,98273,8.2
Missouri,1992,7,2646060,67.5,2482299,63.3,163761,6.2
Montana,1992,7,422407,68.9,393943,64.3,28464,6.7
Nebraska,1992,7,850386,71.5,825713,69.5,24673,2.9
Nevada,1992,7,730090,69.6,679842,64.8,50248,6.9
New Hampshire,1992,7,618036,72.8,572488,67.4,45548,7.4
New Jersey,1992,7,4055139,66.5,3695732,60.6,359407,8.9
New Mexico,1992,7,737953,63.3,683983,58.7,53970,7.3
New York,1992,7,8770278,62.2,7989659,56.6,780619,8.9
New York city,1992,7,3334308,57.0,2953226,50.5,381082,11.4
North Carolina,1992,7,3615497,68.6,3386452,64.3,229045,6.3
North Dakota,1992,7,317298,68.1,302680,64.9,14618,4.6
Ohio,1992,7,5522052,66.2,5100285,61.1,421767,7.6
Oklahoma,1992,7,1528726,63.9,1439054,60.2,89672,5.9
Oregon,1992,7,1562869,68.2,1450379,63.3,112490,7.2
Pennsylvania,1992,7,5907106,63.6,5460239,58.8,446867,7.6
Rhode Island,1992,7,532039,68.3,483243,62.0,48796,9.2
South Carolina,1992,7,1803398,66.8,1682141,62.3,121257,6.7
South Dakota,1992,7,361743,70.8,349150,68.4,12593,3.5
Tennessee,1992,7,2469585,63.7,2313056,59.7,156529,6.3
Texas,1992,7,9027021,69.2,8326355,63.9,700666,7.8
Utah,1992,7,883507,70.6,840265,67.1,43242,4.9
Vermont,1992,7,312179,71.8,292534,67.3,19645,6.3
Virginia,1992,7,3383262,70.8,3173032,66.4,210230,6.2
Washington,1992,7,2652742,68.7,2461279,63.8,191463,7.2
West Virginia,1992,7,788425,55.7,699314,49.4,89111,11.3
Wisconsin,1992,7,2710555,72.0,2567243,68.1,143312,5.3
Wyoming,1992,7,239437,70.5,226255,66.6,13182,5.5
Alabama,1992,8,1974481,62.6,1826061,57.9,148420,7.5
Alaska,1992,8,287956,72.6,262466,66.2,25490,8.9
Arizona,1992,8,1881916,63.4,1740819,58.7,141097,7.5
Arkansas,1992,8,1161246,63.6,1080315,59.1,80931,7.0
California,1992,8,15351559,66.5,13872275,60.1,1479284,9.6
Los Angeles County,1992,8,4450861,65.8,3996939,59.1,453922,10.2
Colorado,1992,8,1855029,70.6,1740201,66.2,114828,6.2
Connecticut,1992,8,1818284,71.1,1684105,65.9,134179,7.4
Delaware,1992,8,368095,69.5,348802,65.9,19293,5.2
District of Columbia,1992,8,315786,66.8,288469,61.0,27317,8.7
Florida,1992,8,6647205,62.0,6085597,56.8,561608,8.4
Georgia,1992,8,3429840,67.3,3203075,62.8,226765,6.6
Hawaii,1992,8,579439,68.9,554028,65.9,25411,4.4
Idaho,1992,8,533111,68.5,497732,64.0,35379,6.6
Illinois,1992,8,6046163,68.3,5586117,63.1,460046,7.6
Indiana,1992,8,2877285,67.0,2696809,62.8,180476,6.3
Iowa,1992,8,1532226,72.0,1464439,68.8,67787,4.4
Kansas,1992,8,1315985,70.7,1254437,67.4,61548,4.7
Kentucky,1992,8,1786918,62.5,1663675,58.2,123243,6.9
Louisiana,1992,8,1929126,61.8,1773983,56.8,155143,8.0
Maine,1992,8,642631,68.0,596707,63.1,45924,7.1
Maryland,1992,8,2661566,71.1,2488134,66.4,173432,6.5
Massachusetts,1992,8,3182139,67.9,2902565,62.0,279574,8.8
Michigan,1992,8,4692848,65.8,4265990,59.8,426858,9.1
Minnesota,1992,8,2474238,73.9,2348347,70.1,125891,5.1
Mississippi,1992,8,1202326,62.3,1105011,57.2,97315,8.1
Missouri,1992,8,2645106,67.4,2483216,63.3,161890,6.1
Montana,1992,8,421930,68.7,393556,64.1,28374,6.7
Nebraska,1992,8,850841,71.5,826276,69.4,24565,2.9
Nevada,1992,8,732320,69.6,681698,64.8,50622,6.9
New Hampshire,1992,8,617986,72.7,572423,67.3,45563,7.4
New Jersey,1992,8,4047447,66.4,3687108,60.4,360339,8.9
New Mexico,1992,8,738955,63.3,685049,58.7,53906,7.3
New York,1992,8,8773672,62.2,7991445,56.6,782227,8.9
New York city,1992,8,3336539,57.0,2952300,50.4,384239,11.5
North Carolina,1992,8,3620131,68.6,3392057,64.2,228074,6.3
North Dakota,1992,8,317303,68.0,302713,64.9,14590,4.6
Ohio,1992,8,5517277,66.1,5097690,61.1,419587,7.6
Oklahoma,1992,8,1528223,63.9,1439737,60.2,88486,5.8
Oregon,1992,8,1565538,68.1,1452587,63.2,112951,7.2
Pennsylvania,1992,8,5908535,63.6,5461969,58.8,446566,7.6
Rhode Island,1992,8,531728,68.2,483486,62.0,48242,9.1
South Carolina,1992,8,1804552,66.8,1683049,62.3,121503,6.7
South Dakota,1992,8,362055,70.7,349491,68.3,12564,3.5
Tennessee,1992,8,2476780,63.8,2320277,59.8,156503,6.3
Texas,1992,8,9031146,69.1,8332373,63.8,698773,7.7
Utah,1992,8,886670,70.6,843660,67.2,43010,4.9
Vermont,1992,8,312810,71.9,293140,67.4,19670,6.3
Virginia,1992,8,3381298,70.6,3174114,66.3,207184,6.1
Washington,1992,8,2659603,68.7,2464918,63.7,194685,7.3
West Virginia,1992,8,787895,55.6,699107,49.3,88788,11.3
Wisconsin,1992,8,2717326,72.0,2572543,68.2,144783,5.3
Wyoming,1992,8,239458,70.3,226404,66.5,13054,5.5
Alabama,1992,9,1975981,62.5,1828276,57.9,147705,7.5
Alaska,1992,9,288319,72.5,263151,66.2,25168,8.7
Arizona,1992,9,1884697,63.3,1744809,58.6,139888,7.4
Arkansas,1992,9,1159589,63.3,1079890,59.0,79699,6.9
California,1992,9,15345438,66.4,13854154,60.0,1491284,9.7
Los Angeles County,1992,9,4443146,65.7,3986590,58.9,456556,10.3
Colorado,1992,9,1859979,70.5,1745401,66.2,114578,6.2
Connecticut,1992,9,1816280,71.1,1682697,65.8,133583,7.4
Delaware,1992,9,368519,69.5,349539,65.9,18980,5.2
District of Columbia,1992,9,314727,66.5,287394,60.8,27333,8.7
Florida,1992,9,6653040,62.0,6096766,56.8,556274,8.4
Georgia,1992,9,3422398,67.0,3208888,62.8,213510,6.2
Hawaii,1992,9,580163,68.9,554182,65.8,25981,4.5
Idaho,1992,9,533917,68.5,498646,63.9,35271,6.6
Illinois,1992,9,6042677,68.2,5595529,63.1,447148,7.4
Indiana,1992,9,2876696,66.9,2699134,62.8,177562,6.2
Iowa,1992,9,1532346,72.0,1464900,68.8,67446,4.4
Kansas,1992,9,1316587,70.7,1254862,67.3,61725,4.7
Kentucky,1992,9,1788775,62.5,1666016,58.2,122759,6.9
Louisiana,1992,9,1923811,61.6,1770672,56.7,153139,8.0
Maine,1992,9,641736,67.8,595970,63.0,45766,7.1
Maryland,1992,9,2658616,70.9,2486847,66.3,171769,6.5
Massachusetts,1992,9,3179638,67.9,2903153,62.0,276485,8.7
Michigan,1992,9,4688790,65.7,4273070,59.8,415720,8.9
Minnesota,1992,9,2476888,73.9,2351239,70.1,125649,5.1
Mississippi,1992,9,1202908,62.3,1107531,57.3,95377,7.9
Missouri,1992,9,2643835,67.3,2483588,63.2,160247,6.1
Montana,1992,9,421429,68.5,393291,64.0,28138,6.7
Nebraska,1992,9,850814,71.4,826457,69.4,24357,2.9
Nevada,1992,9,734469,69.5,683644,64.7,50825,6.9
New Hampshire,1992,9,618163,72.6,572646,67.3,45517,7.4
New Jersey,1992,9,4040657,66.2,3682300,60.3,358357,8.9
New Mexico,1992,9,739788,63.2,686027,58.6,53761,7.3
New York,1992,9,8773887,62.1,7994081,56.6,779806,8.9
New York city,1992,9,3336410,57.0,2951171,50.4,385239,11.5
North Carolina,1992,9,3621649,68.5,3395997,64.2,225652,6.2
North Dakota,1992,9,317361,67.9,302788,64.8,14573,4.6
Ohio,1992,9,5508926,65.9,5093805,61.0,415121,7.5
Oklahoma,1992,9,1527288,63.8,1439928,60.1,87360,5.7
Oregon,1992,9,1567268,68.0,1453570,63.1,113698,7.3
Pennsylvania,1992,9,5906782,63.6,5463012,58.8,443770,7.5
Rhode Island,1992,9,531091,68.2,483675,62.1,47416,8.9
South Carolina,1992,9,1805220,66.7,1683448,62.2,121772,6.7
South Dakota,1992,9,362256,70.8,349702,68.3,12554,3.5
Tennessee,1992,9,2484525,63.9,2327731,59.9,156794,6.3
Texas,1992,9,9032430,69.0,8336409,63.7,696021,7.7
Utah,1992,9,890046,70.6,847269,67.2,42777,4.8
Vermont,1992,9,313341,71.9,293712,67.4,19629,6.3
Virginia,1992,9,3378342,70.5,3174530,66.2,203812,6.0
Washington,1992,9,2665619,68.7,2467788,63.6,197831,7.4
West Virginia,1992,9,787152,55.5,699040,49.3,88112,11.2
Wisconsin,1992,9,2721209,72.0,2576728,68.2,144481,5.3
Wyoming,1992,9,239422,70.3,226583,66.5,12839,5.4
Alabama,1992,10,1976841,62.5,1829571,57.8,147270,7.4
Alaska,1992,10,288616,72.6,263900,66.4,24716,8.6
Arizona,1992,10,1887517,63.2,1748822,58.6,138695,7.3
Arkansas,1992,10,1158061,63.1,1079853,58.9,78208,6.8
California,1992,10,15333868,66.3,13836474,59.9,1497394,9.8
Los Angeles County,1992,10,4433072,65.5,3975975,58.8,457097,10.3
Colorado,1992,10,1865867,70.5,1751400,66.2,114467,6.1
Connecticut,1992,10,1813956,70.9,1681294,65.8,132662,7.3
Delaware,1992,10,369048,69.4,350448,65.9,18600,5.0
District of Columbia,1992,10,314007,66.5,286705,60.7,27302,8.7
Florida,1992,10,6659556,61.9,6110057,56.8,549499,8.3
Georgia,1992,10,3429265,67.0,3215648,62.8,213617,6.2
Hawaii,1992,10,580631,68.8,554227,65.7,26404,4.5
Idaho,1992,10,534508,68.3,499612,63.8,34896,6.5
Illinois,1992,10,6037609,68.1,5598998,63.1,438611,7.3
Indiana,1992,10,2875194,66.8,2701581,62.7,173613,6.0
Iowa,1992,10,1533501,72.0,1466376,68.8,67125,4.4
Kansas,1992,10,1316907,70.6,1254962,67.3,61945,4.7
Kentucky,1992,10,1789933,62.4,1668442,58.2,121491,6.8
Louisiana,1992,10,1917636,61.3,1767415,56.5,150221,7.8
Maine,1992,10,640100,67.6,594632,62.8,45468,7.1
Maryland,1992,10,2655348,70.8,2485728,66.3,169620,6.4
Massachusetts,1992,10,3177616,67.8,2905023,62.0,272593,8.6
Michigan,1992,10,4681115,65.5,4279910,59.9,401205,8.6
Minnesota,1992,10,2479083,73.8,2354069,70.1,125014,5.0
Mississippi,1992,10,1202235,62.1,1109463,57.4,92772,7.7
Missouri,1992,10,2643768,67.2,2484097,63.2,159671,6.0
Montana,1992,10,421088,68.3,393278,63.8,27810,6.6
Nebraska,1992,10,850700,71.3,826451,69.3,24249,2.9
Nevada,1992,10,736739,69.5,685848,64.7,50891,6.9
New Hampshire,1992,10,618773,72.6,573278,67.3,45495,7.4
New Jersey,1992,10,4034954,66.1,3680462,60.3,354492,8.8
New Mexico,1992,10,740667,63.2,687037,58.6,53630,7.2
New York,1992,10,8772922,62.1,7999640,56.6,773282,8.8
New York city,1992,10,3335505,56.9,2951023,50.4,384482,11.5
North Carolina,1992,10,3620760,68.3,3399374,64.1,221386,6.1
North Dakota,1992,10,317495,67.9,302947,64.8,14548,4.6
Ohio,1992,10,5500364,65.8,5091057,60.9,409307,7.4
Oklahoma,1992,10,1525921,63.6,1439988,60.1,85933,5.6
Oregon,1992,10,1568769,67.9,1454559,63.0,114210,7.3
Pennsylvania,1992,10,5903032,63.5,5464528,58.8,438504,7.4
Rhode Island,1992,10,530112,68.0,483833,62.1,46279,8.7
South Carolina,1992,10,1806253,66.6,1683767,62.1,122486,6.8
South Dakota,1992,10,362474,70.7,349856,68.2,12618,3.5
Tennessee,1992,10,2492036,64.0,2335053,60.0,156983,6.3
Texas,1992,10,9034416,68.9,8341121,63.6,693295,7.7
Utah,1992,10,893795,70.6,851334,67.2,42461,4.8
Vermont,1992,10,313763,72.0,294235,67.5,19528,6.2
Virginia,1992,10,3375347,70.3,3175382,66.1,199965,5.9
Washington,1992,10,2670486,68.7,2470030,63.5,200456,7.5
West Virginia,1992,10,786373,55.4,699304,49.3,87069,11.1
Wisconsin,1992,10,2723095,72.0,2580598,68.2,142497,5.2
Wyoming,1992,10,239442,70.1,226825,66.4,12617,5.3
Alabama,1992,11,1978029,62.4,1830691,57.8,147338,7.4
Alaska,1992,11,288935,72.5,264738,66.4,24197,8.4
Arizona,1992,11,1890018,63.1,1752487,58.5,137531,7.3
Arkansas,1992,11,1157114,63.0,1080386,58.8,76728,6.6
California,1992,11,15319026,66.3,13819527,59.8,1499499,9.8
Los Angeles County,1992,11,4421996,65.4,3965291,58.6,456705,10.3
Colorado,1992,11,1872608,70.6,1758145,66.2,114463,6.1
Connecticut,1992,11,1811370,70.9,1679801,65.7,131569,7.3
Delaware,1992,11,369659,69.5,351440,66.1,18219,4.9
District of Columbia,1992,11,313710,66.4,286465,60.6,27245,8.7
Florida,1992,11,6667641,61.9,6125163,56.9,542478,8.1
Georgia,1992,11,3435921,67.0,3223093,62.8,212828,6.2
Hawaii,1992,11,580876,68.8,554191,65.6,26685,4.6
Idaho,1992,11,534838,68.1,500417,63.7,34421,6.4
Illinois,1992,11,6033167,67.9,5596092,63.0,437075,7.2
Indiana,1992,11,2875050,66.7,2705603,62.8,169447,5.9
Iowa,1992,11,1535286,72.0,1468401,68.9,66885,4.4
Kansas,1992,11,1317003,70.5,1254680,67.2,62323,4.7
Kentucky,1992,11,1791230,62.4,1671293,58.2,119937,6.7
Louisiana,1992,11,1911588,61.1,1764455,56.4,147133,7.7
Maine,1992,11,637799,67.3,592872,62.6,44927,7.0
Maryland,1992,11,2652383,70.7,2485195,66.2,167188,6.3
Massachusetts,1992,11,3176651,67.8,2908336,62.0,268315,8.4
Michigan,1992,11,4672041,65.3,4287208,60.0,384833,8.2
Minnesota,1992,11,2481189,73.8,2356904,70.1,124285,5.0
Mississippi,1992,11,1201351,62.0,1111230,57.4,90121,7.5
Missouri,1992,11,2645411,67.2,2484946,63.1,160465,6.1
Montana,1992,11,420977,68.1,393495,63.7,27482,6.5
Nebraska,1992,11,850852,71.3,826499,69.2,24353,2.9
Nevada,1992,11,739227,69.5,688242,64.7,50985,6.9
New Hampshire,1992,11,619625,72.7,574153,67.4,45472,7.3
New Jersey,1992,11,4029987,66.0,3679636,60.2,350351,8.7
New Mexico,1992,11,741740,63.2,688050,58.6,53690,7.2
New York,1992,11,8770480,62.0,8006960,56.6,763520,8.7
New York city,1992,11,3333879,56.9,2951378,50.3,382501,11.5
North Carolina,1992,11,3618461,68.1,3402390,64.1,216071,6.0
North Dakota,1992,11,317648,67.9,303152,64.8,14496,4.6
Ohio,1992,11,5493262,65.7,5089793,60.8,403469,7.3
Oklahoma,1992,11,1524303,63.5,1439766,60.0,84537,5.5
Oregon,1992,11,1570738,67.9,1456383,62.9,114355,7.3
Pennsylvania,1992,11,5898329,63.4,5466080,58.8,432249,7.3
Rhode Island,1992,11,528850,67.8,483854,62.0,44996,8.5
South Carolina,1992,11,1808058,66.6,1684033,62.0,124025,6.9
South Dakota,1992,11,362771,70.6,349979,68.1,12792,3.5
Tennessee,1992,11,2497978,64.1,2340837,60.0,157141,6.3
Texas,1992,11,9038283,68.8,8347206,63.6,691077,7.6
Utah,1992,11,897789,70.7,855771,67.3,42018,4.7
Vermont,1992,11,314024,72.0,294647,67.6,19377,6.2
Virginia,1992,11,3372692,70.1,3176727,66.1,195965,5.8
Washington,1992,11,2674147,68.6,2471655,63.4,202492,7.6
West Virginia,1992,11,785696,55.3,699821,49.3,85875,10.9
Wisconsin,1992,11,2720767,71.8,2584438,68.2,136329,5.0
Wyoming,1992,11,239564,70.1,227082,66.4,12482,5.2
Alabama,1992,12,1979921,62.4,1832107,57.8,147814,7.5
Alaska,1992,12,289305,72.4,265602,66.5,23703,8.2
Arizona,1992,12,1892368,63.0,1756062,58.4,136306,7.2
Arkansas,1992,12,1157121,62.9,1081645,58.8,75476,6.5
California,1992,12,15303615,66.2,13804709,59.7,1498906,9.8
Los Angeles County,1992,12,4411020,65.2,3955008,58.5,456012,10.3
Colorado,1992,12,1880045,70.6,1765582,66.3,114463,6.1
Connecticut,1992,12,1808469,70.8,1678090,65.7,130379,7.2
Delaware,1992,12,370233,69.5,352343,66.1,17890,4.8
District of Columbia,1992,12,313764,66.5,286607,60.7,27157,8.7
Florida,1992,12,6677988,61.9,6142148,57.0,535840,8.0
Georgia,1992,12,3442534,67.0,3231106,62.9,211428,6.1
Hawaii,1992,12,581041,68.7,554274,65.5,26767,4.6
Idaho,1992,12,535008,67.9,500989,63.6,34019,6.4
Illinois,1992,12,6031255,67.9,5588698,62.9,442557,7.3
Indiana,1992,12,2878102,66.7,2712192,62.8,165910,5.8
Iowa,1992,12,1537372,72.0,1470667,68.9,66705,4.3
Kansas,1992,12,1317047,70.5,1254166,67.1,62881,4.8
Kentucky,1992,12,1792955,62.4,1674322,58.2,118633,6.6
Louisiana,1992,12,1906779,60.9,1762204,56.3,144575,7.6
Maine,1992,12,635176,67.1,590985,62.4,44191,7.0
Maryland,1992,12,2650100,70.6,2485297,66.2,164803,6.2
Massachusetts,1992,12,3176975,67.8,2913066,62.1,263909,8.3
Michigan,1992,12,4665151,65.2,4295967,60.1,369184,7.9
Minnesota,1992,12,2483732,73.8,2359879,70.1,123853,5.0
Mississippi,1992,12,1201180,62.0,1113229,57.4,87951,7.3
Missouri,1992,12,2648802,67.2,2486475,63.1,162327,6.1
Montana,1992,12,421081,68.0,393898,63.7,27183,6.5
Nebraska,1992,12,851487,71.3,826877,69.2,24610,2.9
Nevada,1992,12,742011,69.5,690790,64.7,51221,6.9
New Hampshire,1992,12,620324,72.7,575070,67.4,45254,7.3
New Jersey,1992,12,4025743,65.9,3679035,60.2,346708,8.6
New Mexico,1992,12,743088,63.2,689128,58.6,53960,7.3
New York,1992,12,8766588,62.0,8014958,56.7,751630,8.6
New York city,1992,12,3331376,56.8,2951937,50.3,379439,11.4
North Carolina,1992,12,3616276,68.0,3405497,64.0,210779,5.8
North Dakota,1992,12,317838,68.0,303435,64.9,14403,4.5
Ohio,1992,12,5488046,65.6,5089891,60.8,398155,7.3
Oklahoma,1992,12,1522805,63.4,1439081,59.9,83724,5.5
Oregon,1992,12,1573372,67.9,1459031,62.9,114341,7.3
Pennsylvania,1992,12,5893992,63.4,5467665,58.8,426327,7.2
Rhode Island,1992,12,527538,67.7,483733,62.1,43805,8.3
South Carolina,1992,12,1810847,66.6,1684312,62.0,126535,7.0
South Dakota,1992,12,363138,70.5,350126,68.0,13012,3.6
Tennessee,1992,12,2502203,64.1,2344887,60.1,157316,6.3
Texas,1992,12,9044485,68.8,8355849,63.5,688636,7.6
Utah,1992,12,901952,70.7,860523,67.5,41429,4.6
Vermont,1992,12,314110,71.9,294942,67.5,19168,6.1
Virginia,1992,12,3370676,70.0,3178635,66.0,192041,5.7
Washington,1992,12,2676812,68.6,2473075,63.4,203737,7.6
West Virginia,1992,12,785197,55.3,700347,49.3,84850,10.8
Wisconsin,1992,12,2718776,71.7,2588427,68.3,130349,4.8
Wyoming,1992,12,239783,70.0,227314,66.3,12469,5.2
Alabama,1993,1,1982813,62.4,1834554,57.8,148259,7.5
Alaska,1993,1,289801,72.5,266501,66.7,23300,8.0
Arizona,1993,1,1895248,62.9,1760662,58.4,134586,7.1
Arkansas,1993,1,1158246,62.9,1083745,58.8,74501,6.4
California,1993,1,15289957,66.1,13794715,59.6,1495242,9.8
Los Angeles County,1993,1,4400977,65.1,3946413,58.3,454564,10.3
Colorado,1993,1,1887890,70.7,1773832,66.4,114058,6.0
Connecticut,1993,1,1805654,70.7,1676706,65.6,128948,7.1
Delaware,1993,1,370820,69.5,353183,66.2,17637,4.8
District of Columbia,1993,1,314032,66.5,287036,60.7,26996,8.6
Florida,1993,1,6691256,62.0,6161848,57.1,529408,7.9
Georgia,1993,1,3449688,67.0,3240226,62.9,209462,6.1
Hawaii,1993,1,581283,68.7,554692,65.6,26591,4.6
Idaho,1993,1,535474,67.8,501615,63.5,33859,6.3
Illinois,1993,1,6032572,67.8,5579967,62.7,452605,7.5
Indiana,1993,1,2885573,66.8,2721878,63.0,163695,5.7
Iowa,1993,1,1539756,72.1,1473402,69.0,66354,4.3
Kansas,1993,1,1317529,70.4,1253911,67.0,63618,4.8
Kentucky,1993,1,1795300,62.4,1677526,58.3,117774,6.6
Louisiana,1993,1,1903889,60.8,1761123,56.2,142766,7.5
Maine,1993,1,632804,66.8,589394,62.2,43410,6.9
Maryland,1993,1,2648973,70.5,2486279,66.2,162694,6.1
Massachusetts,1993,1,3178624,67.8,2919461,62.3,259163,8.2
Michigan,1993,1,4663640,65.2,4306941,60.2,356699,7.6
Minnesota,1993,1,2487321,73.8,2363409,70.1,123912,5.0
Mississippi,1993,1,1202381,62.0,1115964,57.5,86417,7.2
Missouri,1993,1,2653974,67.3,2489256,63.1,164718,6.2
Montana,1993,1,421431,68.0,394519,63.7,26912,6.4
Nebraska,1993,1,852762,71.3,827837,69.2,24925,2.9
Nevada,1993,1,745239,69.5,693603,64.7,51636,6.9
New Hampshire,1993,1,620649,72.7,576006,67.5,44643,7.2
New Jersey,1993,1,4022603,65.8,3679589,60.2,343014,8.5
New Mexico,1993,1,744832,63.2,690420,58.6,54412,7.3
New York,1993,1,8762058,62.0,8023792,56.7,738266,8.4
New York city,1993,1,3327906,56.7,2953209,50.3,374697,11.3
North Carolina,1993,1,3615043,67.8,3409012,64.0,206031,5.7
North Dakota,1993,1,318122,67.9,303848,64.8,14274,4.5
Ohio,1993,1,5484708,65.5,5092052,60.8,392656,7.2
Oklahoma,1993,1,1522100,63.3,1438465,59.9,83635,5.5
Oregon,1993,1,1576788,67.8,1462517,62.9,114271,7.2
Pennsylvania,1993,1,5890752,63.3,5469561,58.8,421191,7.2
Rhode Island,1993,1,526431,67.5,483604,62.0,42827,8.1
South Carolina,1993,1,1814786,66.7,1685033,61.9,129753,7.1
South Dakota,1993,1,363589,70.6,350410,68.0,13179,3.6
Tennessee,1993,1,2505004,64.1,2347753,60.1,157251,6.3
Texas,1993,1,9053364,68.7,8368981,63.5,684383,7.6
Utah,1993,1,906443,70.8,865682,67.7,40761,4.5
Vermont,1993,1,314124,71.9,295253,67.6,18871,6.0
Virginia,1993,1,3369520,69.9,3181460,66.0,188060,5.6
Washington,1993,1,2679093,68.5,2475153,63.3,203940,7.6
West Virginia,1993,1,784850,55.2,700742,49.3,84108,10.7
Wisconsin,1993,1,2718337,71.6,2593030,68.3,125307,4.6
Wyoming,1993,1,240078,70.0,227552,66.4,12526,5.2
Alabama,1993,2,1986436,62.5,1838024,57.8,148412,7.5
Alaska,1993,2,290471,72.5,267451,66.8,23020,7.9
Arizona,1993,2,1899125,62.8,1766991,58.4,132134,7.0
Arkansas,1993,2,1160423,62.9,1086633,58.9,73790,6.4
California,1993,2,15278528,66.1,13789592,59.6,1488936,9.7
Los Angeles County,1993,2,4391947,64.9,3939941,58.3,452006,10.3
Colorado,1993,2,1895876,70.8,1782922,66.6,112954,6.0
Connecticut,1993,2,1803358,70.6,1676192,65.6,127166,7.1
Delaware,1993,2,371487,69.6,353984,66.3,17503,4.7
District of Columbia,1993,2,314316,66.6,287544,60.9,26772,8.5
Florida,1993,2,6706639,62.0,6183624,57.2,523015,7.8
Georgia,1993,2,3457373,67.0,3250375,63.0,206998,6.0
Hawaii,1993,2,581604,68.7,555408,65.6,26196,4.5
Idaho,1993,2,536588,67.8,502627,63.5,33961,6.3
Illinois,1993,2,6037582,67.8,5574177,62.6,463405,7.7
Indiana,1993,2,2897673,67.0,2734700,63.3,162973,5.6
Iowa,1993,2,1542591,72.2,1476612,69.1,65979,4.3
Kansas,1993,2,1318724,70.4,1254248,67.0,64476,4.9
Kentucky,1993,2,1798032,62.4,1680749,58.3,117283,6.5
Louisiana,1993,2,1902611,60.7,1761069,56.2,141542,7.4
Maine,1993,2,631060,66.6,588297,62.0,42763,6.8
Maryland,1993,2,2648963,70.5,2487811,66.2,161152,6.1
Massachusetts,1993,2,3181158,67.8,2927212,62.4,253946,8.0
Michigan,1993,2,4668623,65.2,4320000,60.3,348623,7.5
Minnesota,1993,2,2491973,73.8,2367553,70.1,124420,5.0
Mississippi,1993,2,1204648,62.0,1119344,57.6,85304,7.1
Missouri,1993,2,2660360,67.4,2493295,63.2,167065,6.3
Montana,1993,2,422040,68.0,395331,63.7,26709,6.3
Nebraska,1993,2,854565,71.4,829397,69.3,25168,2.9
Nevada,1993,2,748921,69.6,696728,64.7,52193,7.0
New Hampshire,1993,2,620591,72.6,577007,67.5,43584,7.0
New Jersey,1993,2,4019948,65.7,3681488,60.2,338460,8.4
New Mexico,1993,2,746858,63.2,691930,58.6,54928,7.4
New York,1993,2,8756783,61.9,8032552,56.8,724231,8.3
New York city,1993,2,3323264,56.6,2955453,50.3,367811,11.1
North Carolina,1993,2,3614942,67.7,3413024,64.0,201918,5.6
North Dakota,1993,2,318499,67.9,304368,64.9,14131,4.4
Ohio,1993,2,5483046,65.5,5096435,60.8,386611,7.1
Oklahoma,1993,2,1522707,63.3,1438462,59.8,84245,5.5
Oregon,1993,2,1580937,67.9,1466626,63.0,114311,7.2
Pennsylvania,1993,2,5888683,63.3,5471550,58.8,417133,7.1
Rhode Island,1993,2,525599,67.4,483556,62.0,42043,8.0
South Carolina,1993,2,1819403,66.8,1686178,61.9,133225,7.3
South Dakota,1993,2,364120,70.5,350868,67.9,13252,3.6
Tennessee,1993,2,2507282,64.1,2350409,60.1,156873,6.3
Texas,1993,2,9064817,68.7,8386732,63.6,678085,7.5
Utah,1993,2,911363,71.0,871243,67.9,40120,4.4
Vermont,1993,2,314163,71.9,295673,67.7,18490,5.9
Virginia,1993,2,3368837,69.8,3184656,66.0,184181,5.5
Washington,1993,2,2681685,68.4,2478375,63.2,203310,7.6
West Virginia,1993,2,784561,55.2,700950,49.3,83611,10.7
Wisconsin,1993,2,2720019,71.6,2598337,68.4,121682,4.5
Wyoming,1993,2,240467,69.9,227852,66.3,12615,5.2
Alabama,1993,3,1990369,62.5,1842086,57.9,148283,7.5
Alaska,1993,3,291297,72.5,268411,66.8,22886,7.9
Arizona,1993,3,1904411,62.8,1775344,58.5,129067,6.8
Arkansas,1993,3,1163508,63.0,1090192,59.0,73316,6.3
California,1993,3,15271158,66.0,13789663,59.6,1481495,9.7
Los Angeles County,1993,3,4384341,64.8,3936049,58.2,448292,10.2
Colorado,1993,3,1904000,70.9,1792908,66.8,111092,5.8
Connecticut,1993,3,1801806,70.6,1676702,65.7,125104,6.9
Delaware,1993,3,372273,69.6,354738,66.3,17535,4.7
District of Columbia,1993,3,314502,66.6,287941,61.0,26561,8.4
Florida,1993,3,6723186,62.1,6206293,57.3,516893,7.7
Georgia,1993,3,3465803,67.1,3261462,63.1,204341,5.9
Hawaii,1993,3,581963,68.6,556255,65.6,25708,4.4
Idaho,1993,3,538537,67.7,504334,63.4,34203,6.4
Illinois,1993,3,6047333,67.9,5575718,62.6,471615,7.8
Indiana,1993,3,2914157,67.3,2750687,63.6,163470,5.6
Iowa,1993,3,1546098,72.3,1480233,69.2,65865,4.3
Kansas,1993,3,1320656,70.5,1255309,67.0,65347,4.9
Kentucky,1993,3,1800814,62.4,1683780,58.4,117034,6.5
Louisiana,1993,3,1902581,60.7,1761801,56.2,140780,7.4
Maine,1993,3,630110,66.5,587713,62.0,42397,6.7
Maryland,1993,3,2650334,70.5,2489703,66.2,160631,6.1
Massachusetts,1993,3,3184264,67.9,2935746,62.6,248518,7.8
Michigan,1993,3,4679471,65.3,4334572,60.5,344899,7.4
Minnesota,1993,3,2497323,73.9,2372288,70.2,125035,5.0
Mississippi,1993,3,1207300,62.1,1122977,57.8,84323,7.0
Missouri,1993,3,2667439,67.6,2498484,63.3,168955,6.3
Montana,1993,3,422935,67.9,396337,63.6,26598,6.3
Nebraska,1993,3,856756,71.5,831521,69.4,25235,2.9
Nevada,1993,3,753018,69.8,700205,64.9,52813,7.0
New Hampshire,1993,3,620350,72.6,578172,67.6,42178,6.8
New Jersey,1993,3,4017223,65.7,3684420,60.2,332803,8.3
New Mexico,1993,3,749152,63.3,693644,58.6,55508,7.4
New York,1993,3,8751392,61.9,8040290,56.8,711102,8.1
New York city,1993,3,3318019,56.5,2958735,50.4,359284,10.8
North Carolina,1993,3,3616420,67.7,3418144,64.0,198276,5.5
North Dakota,1993,3,318985,68.0,304983,65.1,14002,4.4
Ohio,1993,3,5483474,65.4,5103600,60.9,379874,6.9
Oklahoma,1993,3,1524937,63.4,1439477,59.8,85460,5.6
Oregon,1993,3,1585427,67.9,1470833,63.0,114594,7.2
Pennsylvania,1993,3,5888614,63.2,5474080,58.8,414534,7.0
Rhode Island,1993,3,525048,67.3,483684,62.0,41364,7.9
South Carolina,1993,3,1823950,66.9,1687596,61.9,136354,7.5
South Dakota,1993,3,364728,70.6,351515,68.1,13213,3.6
Tennessee,1993,3,2510794,64.1,2354538,60.1,156256,6.2
Texas,1993,3,9080228,68.7,8409093,63.6,671135,7.4
Utah,1993,3,916756,71.2,877204,68.1,39552,4.3
Vermont,1993,3,314272,71.9,296232,67.8,18040,5.7
Virginia,1993,3,3368563,69.7,3187807,66.0,180756,5.4
Washington,1993,3,2685137,68.4,2482786,63.2,202351,7.5
West Virginia,1993,3,784366,55.1,701056,49.3,83310,10.6
Wisconsin,1993,3,2724096,71.6,2604497,68.5,119599,4.4
Wyoming,1993,3,241010,70.1,228255,66.4,12755,5.3
Alabama,1993,4,1994118,62.6,1846262,58.0,147856,7.4
Alaska,1993,4,292134,72.7,269288,67.0,22846,7.8
Arizona,1993,4,1911180,62.8,1785549,58.7,125631,6.6
Arkansas,1993,4,1166994,63.1,1094070,59.1,72924,6.2
California,1993,4,15267468,66.0,13794804,59.6,1472664,9.6
Los Angeles County,1993,4,4377834,64.7,3934576,58.2,443258,10.1
Colorado,1993,4,1911964,71.0,1803373,67.0,108591,5.7
Connecticut,1993,4,1800960,70.6,1678191,65.7,122769,6.8
Delaware,1993,4,373231,69.8,355515,66.4,17716,4.7
District of Columbia,1993,4,314552,66.7,288161,61.1,26391,8.4
Florida,1993,4,6739356,62.2,6228655,57.5,510701,7.6
Georgia,1993,4,3475005,67.2,3273413,63.3,201592,5.8
Hawaii,1993,4,582332,68.7,557056,65.7,25276,4.3
Idaho,1993,4,541369,67.9,506997,63.6,34372,6.3
Illinois,1993,4,6060654,68.0,5585213,62.7,475441,7.8
Indiana,1993,4,2933276,67.7,2768722,63.9,164554,5.6
Iowa,1993,4,1550145,72.5,1484237,69.4,65908,4.3
Kansas,1993,4,1323167,70.6,1257236,67.0,65931,5.0
Kentucky,1993,4,1803128,62.5,1686459,58.4,116669,6.5
Louisiana,1993,4,1902924,60.6,1762858,56.2,140066,7.4
Maine,1993,4,629945,66.4,587571,62.0,42374,6.7
Maryland,1993,4,2653065,70.5,2492128,66.3,160937,6.1
Massachusetts,1993,4,3187448,68.0,2944494,62.8,242954,7.6
Michigan,1993,4,4693827,65.5,4349571,60.7,344256,7.3
Minnesota,1993,4,2502621,74.0,2377390,70.3,125231,5.0
Mississippi,1993,4,1209736,62.2,1126502,57.9,83234,6.9
Missouri,1993,4,2674790,67.7,2504743,63.4,170047,6.4
Montana,1993,4,424003,68.0,397476,63.7,26527,6.3
Nebraska,1993,4,859171,71.7,834136,69.6,25035,2.9
Nevada,1993,4,757401,69.9,704023,65.0,53378,7.0
New Hampshire,1993,4,620187,72.5,579631,67.7,40556,6.5
New Jersey,1993,4,4013903,65.6,3687690,60.2,326213,8.1
New Mexico,1993,4,751607,63.4,695586,58.7,56021,7.5
New York,1993,4,8745154,61.8,8045683,56.9,699471,8.0
New York city,1993,4,3312121,56.4,2962285,50.4,349836,10.6
North Carolina,1993,4,3618875,67.6,3424387,64.0,194488,5.4
North Dakota,1993,4,319602,68.2,305712,65.2,13890,4.3
Ohio,1993,4,5486482,65.4,5114136,61.0,372346,6.8
Oklahoma,1993,4,1528375,63.5,1441628,59.9,86747,5.7
Oregon,1993,4,1589941,68.0,1474876,63.1,115065,7.2
Pennsylvania,1993,4,5890798,63.3,5477947,58.8,412851,7.0
Rhode Island,1993,4,524700,67.3,484068,62.1,40632,7.7
South Carolina,1993,4,1827677,66.9,1689203,61.9,138474,7.6
South Dakota,1993,4,365401,70.6,352337,68.1,13064,3.6
Tennessee,1993,4,2516652,64.2,2361432,60.2,155220,6.2
Texas,1993,4,9100173,68.8,8436016,63.7,664157,7.3
Utah,1993,4,922585,71.4,883523,68.4,39062,4.2
Vermont,1993,4,314436,71.8,296914,67.8,17522,5.6
Virginia,1993,4,3368674,69.6,3190843,66.0,177831,5.3
Washington,1993,4,2689446,68.4,2488073,63.2,201373,7.5
West Virginia,1993,4,784248,55.1,701251,49.2,82997,10.6
Wisconsin,1993,4,2729960,71.7,2611474,68.6,118486,4.3
Wyoming,1993,4,241684,70.1,228781,66.3,12903,5.3
Alabama,1993,5,1997263,62.6,1850022,58.0,147241,7.4
Alaska,1993,5,292919,72.7,270050,67.1,22869,7.8
Arizona,1993,5,1919395,62.9,1797064,58.9,122331,6.4
Arkansas,1993,5,1170394,63.1,1097819,59.2,72575,6.2
California,1993,5,15267275,66.0,13802686,59.7,1464589,9.6
Los Angeles County,1993,5,4371476,64.7,3933534,58.2,437942,10.0
Colorado,1993,5,1919228,71.1,1813304,67.1,105924,5.5
Connecticut,1993,5,1800731,70.6,1680395,65.8,120336,6.7
Delaware,1993,5,374411,69.8,356424,66.5,17987,4.8
District of Columbia,1993,5,314506,66.8,288209,61.2,26297,8.4
Florida,1993,5,6753816,62.2,6248870,57.6,504946,7.5
Georgia,1993,5,3485115,67.2,3285844,63.4,199271,5.7
Hawaii,1993,5,582680,68.6,557705,65.7,24975,4.3
Idaho,1993,5,545005,68.2,510603,63.9,34402,6.3
Illinois,1993,5,6075064,68.1,5599394,62.8,475670,7.8
Indiana,1993,5,2952768,68.1,2786716,64.3,166052,5.6
Iowa,1993,5,1554425,72.6,1488523,69.5,65902,4.2
Kansas,1993,5,1326074,70.7,1259861,67.1,66213,5.0
Kentucky,1993,5,1804466,62.4,1688569,58.4,115897,6.4
Louisiana,1993,5,1903162,60.6,1763802,56.2,139360,7.3
Maine,1993,5,630417,66.5,587742,62.0,42675,6.8
Maryland,1993,5,2656708,70.6,2495176,66.3,161532,6.1
Massachusetts,1993,5,3190371,68.0,2952736,63.0,237635,7.4
Michigan,1993,5,4709205,65.7,4363890,60.9,345315,7.3
Minnesota,1993,5,2507334,74.0,2382446,70.4,124888,5.0
Mississippi,1993,5,1211694,62.2,1129578,58.0,82116,6.8
Missouri,1993,5,2682062,67.8,2511563,63.5,170499,6.4
Montana,1993,5,425058,68.1,398594,63.8,26464,6.2
Nebraska,1993,5,861559,71.8,836936,69.7,24623,2.9
Nevada,1993,5,761877,70.1,708049,65.1,53828,7.1
New Hampshire,1993,5,620315,72.5,581330,67.9,38985,6.3
New Jersey,1993,5,4015225,65.6,3695739,60.4,319486,8.0
New Mexico,1993,5,754143,63.5,697747,58.7,56396,7.5
New York,1993,5,8738912,61.8,8048317,56.9,690595,7.9
New York city,1993,5,3306852,56.3,2965746,50.5,341106,10.3
North Carolina,1993,5,3621422,67.5,3430821,64.0,190601,5.3
North Dakota,1993,5,320325,68.3,306519,65.4,13806,4.3
Ohio,1993,5,5492274,65.5,5126754,61.1,365520,6.7
Oklahoma,1993,5,1532158,63.6,1444414,59.9,87744,5.7
Oregon,1993,5,1594213,68.0,1478666,63.1,115547,7.2
Pennsylvania,1993,5,5894799,63.3,5482806,58.9,411993,7.0
Rhode Island,1993,5,524483,67.2,484630,62.1,39853,7.6
South Carolina,1993,5,1830201,66.9,1690942,61.8,139259,7.6
South Dakota,1993,5,366134,70.6,353264,68.1,12870,3.5
Tennessee,1993,5,2524457,64.3,2370675,60.4,153782,6.1
Texas,1993,5,9124710,68.8,8465902,63.9,658808,7.2
Utah,1993,5,928695,71.6,890018,68.7,38677,4.2
Vermont,1993,5,314644,71.8,297664,68.0,16980,5.4
Virginia,1993,5,3369062,69.5,3193461,65.9,175601,5.2
Washington,1993,5,2694345,68.3,2493724,63.2,200621,7.4
West Virginia,1993,5,784239,55.0,701666,49.2,82573,10.5
Wisconsin,1993,5,2738075,71.8,2618950,68.7,119125,4.4
Wyoming,1993,5,242439,70.3,229413,66.5,13026,5.4
Alabama,1993,6,1999503,62.6,1852992,58.0,146511,7.3
Alaska,1993,6,293787,72.8,270865,67.1,22922,7.8
Arizona,1993,6,1929173,63.0,1809449,59.1,119724,6.2
Arkansas,1993,6,1173490,63.2,1101228,59.3,72262,6.2
California,1993,6,15268668,66.0,13809845,59.7,1458823,9.6
Los Angeles County,1993,6,4362963,64.5,3929462,58.1,433501,9.9
Colorado,1993,6,1925905,71.1,1822290,67.3,103615,5.4
Connecticut,1993,6,1800410,70.6,1682462,65.9,117948,6.6
Delaware,1993,6,375712,69.9,357429,66.5,18283,4.9
District of Columbia,1993,6,314385,66.7,288090,61.1,26295,8.4
Florida,1993,6,6765740,62.2,6265583,57.6,500157,7.4
Georgia,1993,6,3496010,67.3,3298249,63.5,197761,5.7
Hawaii,1993,6,582878,68.5,558144,65.6,24734,4.2
Idaho,1993,6,549091,68.5,514846,64.2,34245,6.2
Illinois,1993,6,6087885,68.2,5614494,62.9,473391,7.8
Indiana,1993,6,2970870,68.4,2802870,64.6,168000,5.7
Iowa,1993,6,1558366,72.8,1492643,69.7,65723,4.2
Kansas,1993,6,1329034,70.7,1262688,67.2,66346,5.0
Kentucky,1993,6,1804659,62.4,1690110,58.4,114549,6.3
Louisiana,1993,6,1903594,60.6,1764423,56.2,139171,7.3
Maine,1993,6,631114,66.5,587988,62.0,43126,6.8
Maryland,1993,6,2660639,70.7,2498730,66.4,161909,6.1
Massachusetts,1993,6,3192647,68.1,2959736,63.1,232911,7.3
Michigan,1993,6,4723458,65.9,4376416,61.0,347042,7.3
Minnesota,1993,6,2511474,74.1,2387452,70.4,124022,4.9
Mississippi,1993,6,1213073,62.2,1131976,58.1,81097,6.7
Missouri,1993,6,2688893,67.9,2518263,63.6,170630,6.3
Montana,1993,6,425917,68.1,399527,63.9,26390,6.2
Nebraska,1993,6,863719,71.9,839612,69.9,24107,2.8
Nevada,1993,6,766261,70.2,712154,65.3,54107,7.1
New Hampshire,1993,6,620677,72.4,582996,68.0,37681,6.1
New Jersey,1993,6,4020752,65.6,3707523,60.5,313229,7.8
New Mexico,1993,6,756598,63.6,700025,58.8,56573,7.5
New York,1993,6,8734009,61.7,8048434,56.9,685575,7.8
New York city,1993,6,3303699,56.2,2968785,50.5,334914,10.1
North Carolina,1993,6,3623217,67.5,3436590,64.0,186627,5.2
North Dakota,1993,6,321078,68.3,307331,65.4,13747,4.3
Ohio,1993,6,5500451,65.5,5139658,61.2,360793,6.6
Oklahoma,1993,6,1535719,63.7,1447185,60.0,88534,5.8
Oregon,1993,6,1598347,68.1,1482633,63.1,115714,7.2
Pennsylvania,1993,6,5899502,63.3,5487751,58.9,411751,7.0
Rhode Island,1993,6,524234,67.3,485113,62.2,39121,7.5
South Carolina,1993,6,1831399,66.9,1692708,61.8,138691,7.6
South Dakota,1993,6,366892,70.7,354200,68.3,12692,3.5
Tennessee,1993,6,2532615,64.4,2380758,60.5,151857,6.0
Texas,1993,6,9152639,68.9,8496074,64.0,656565,7.2
Utah,1993,6,934860,71.9,896528,68.9,38332,4.1
Vermont,1993,6,314830,71.9,298380,68.1,16450,5.2
Virginia,1993,6,3369503,69.5,3195385,65.9,174118,5.2
Washington,1993,6,2699323,68.3,2499447,63.3,199876,7.4
West Virginia,1993,6,784316,55.0,702305,49.3,82011,10.5
Wisconsin,1993,6,2742467,71.9,2626257,68.8,116210,4.2
Wyoming,1993,6,243209,70.3,230089,66.5,13120,5.4
Alabama,1993,7,2000343,62.6,1854984,58.0,145359,7.3
Alaska,1993,7,294642,73.0,271717,67.3,22925,7.8
Arizona,1993,7,1939882,63.2,1821831,59.3,118051,6.1
Arkansas,1993,7,1176229,63.2,1104352,59.4,71877,6.1
California,1993,7,15265798,65.9,13813359,59.7,1452439,9.5
Los Angeles County,1993,7,4350078,64.3,3920380,58.0,429698,9.9
Colorado,1993,7,1932228,71.1,1830566,67.4,101662,5.3
Connecticut,1993,7,1798730,70.5,1683311,66.0,115419,6.4
Delaware,1993,7,376897,70.2,358327,66.7,18570,4.9
District of Columbia,1993,7,314258,66.8,287951,61.2,26307,8.4
Florida,1993,7,6773849,62.2,6278475,57.7,495374,7.3
Georgia,1993,7,3506571,67.4,3309729,63.6,196842,5.6
Hawaii,1993,7,582758,68.5,558215,65.6,24543,4.2
Idaho,1993,7,553070,68.8,519203,64.6,33867,6.1
Illinois,1993,7,6095971,68.2,5628304,63.0,467667,7.7
Indiana,1993,7,2955351,68.0,2816180,64.8,139171,4.7
Iowa,1993,7,1561311,72.9,1496146,69.8,65165,4.2
Kansas,1993,7,1331417,70.8,1265084,67.3,66333,5.0
Kentucky,1993,7,1803554,62.3,1691116,58.4,112438,6.2
Louisiana,1993,7,1904463,60.6,1764949,56.1,139514,7.3
Maine,1993,7,631422,66.5,587969,62.0,43453,6.9
Maryland,1993,7,2664136,70.8,2502554,66.5,161582,6.1
Massachusetts,1993,7,3193434,68.1,2965009,63.2,228425,7.2
Michigan,1993,7,4734367,66.0,4386395,61.1,347972,7.3
Minnesota,1993,7,2515110,74.1,2392639,70.5,122471,4.9
Mississippi,1993,7,1213807,62.2,1133651,58.1,80156,6.6
Missouri,1993,7,2694376,68.0,2524099,63.7,170277,6.3
Montana,1993,7,426376,68.1,400147,63.9,26229,6.2
Nebraska,1993,7,865505,72.0,841891,70.0,23614,2.7
Nevada,1993,7,770273,70.4,716191,65.4,54082,7.0
New Hampshire,1993,7,620923,72.4,584277,68.2,36646,5.9
New Jersey,1993,7,4024409,65.7,3717097,60.7,307312,7.6
New Mexico,1993,7,758645,63.6,702294,58.9,56351,7.4
New York,1993,7,8728275,61.6,8045221,56.8,683054,7.8
New York city,1993,7,3301492,56.1,2969892,50.5,331600,10.0
North Carolina,1993,7,3623876,67.3,3441571,64.0,182305,5.0
North Dakota,1993,7,321756,68.4,308073,65.5,13683,4.3
Ohio,1993,7,5509394,65.6,5151218,61.3,358176,6.5
Oklahoma,1993,7,1538255,63.7,1449501,60.0,88754,5.8
Oregon,1993,7,1602678,68.1,1487665,63.2,115013,7.2
Pennsylvania,1993,7,5903091,63.3,5492507,58.9,410584,7.0
Rhode Island,1993,7,523664,67.1,485219,62.2,38445,7.3
South Carolina,1993,7,1831113,66.8,1694264,61.8,136849,7.5
South Dakota,1993,7,367586,70.7,355027,68.3,12559,3.4
Tennessee,1993,7,2539492,64.5,2390470,60.7,149022,5.9
Texas,1993,7,9180267,69.0,8524094,64.1,656173,7.1
Utah,1993,7,940708,72.1,902845,69.2,37863,4.0
Vermont,1993,7,314863,71.7,298925,68.1,15938,5.1
Virginia,1993,7,3369538,69.4,3196819,65.8,172719,5.1
Washington,1993,7,2703620,68.3,2505099,63.3,198521,7.3
West Virginia,1993,7,784208,55.0,703119,49.3,81089,10.3
Wisconsin,1993,7,2750116,72.0,2632761,68.9,117355,4.3
Wyoming,1993,7,243892,70.5,230735,66.7,13157,5.4
Alabama,1993,8,2000375,62.5,1856654,58.0,143721,7.2
Alaska,1993,8,295416,73.0,272535,67.4,22881,7.7
Arizona,1993,8,1951235,63.3,1833816,59.5,117419,6.0
Arkansas,1993,8,1178870,63.3,1107469,59.5,71401,6.1
California,1993,8,15258689,65.9,13813918,59.7,1444771,9.5
Los Angeles County,1993,8,4334215,64.1,3907404,57.8,426811,9.8
Colorado,1993,8,1938520,71.1,1838695,67.5,99825,5.1
Connecticut,1993,8,1795266,70.4,1682535,65.9,112731,6.3
Delaware,1993,8,377823,70.2,359002,66.7,18821,5.0
District of Columbia,1993,8,314269,66.7,287971,61.1,26298,8.4
Florida,1993,8,6779573,62.1,6289078,57.7,490495,7.2
Georgia,1993,8,3516546,67.4,3320002,63.7,196544,5.6
Hawaii,1993,8,582430,68.4,557922,65.5,24508,4.2
Idaho,1993,8,556736,69.1,523323,64.9,33413,6.0
Illinois,1993,8,6099394,68.2,5640571,63.1,458823,7.5
Indiana,1993,8,2958569,68.0,2826522,65.0,132047,4.5
Iowa,1993,8,1563031,72.9,1498853,69.9,64178,4.1
Kansas,1993,8,1333017,70.8,1266806,67.3,66211,5.0
Kentucky,1993,8,1801536,62.1,1691845,58.3,109691,6.1
Louisiana,1993,8,1906552,60.6,1766098,56.1,140454,7.4
Maine,1993,8,631097,66.5,587599,61.9,43498,6.9
Maryland,1993,8,2666949,70.8,2506580,66.5,160369,6.0
Massachusetts,1993,8,3192494,68.0,2968432,63.2,224062,7.0
Michigan,1993,8,4742889,66.1,4395067,61.2,347822,7.3
Minnesota,1993,8,2519057,74.1,2398442,70.6,120615,4.8
Mississippi,1993,8,1214536,62.2,1135165,58.1,79371,6.5
Missouri,1993,8,2698270,68.0,2529051,63.7,169219,6.3
Montana,1993,8,426558,67.9,400636,63.7,25922,6.1
Nebraska,1993,8,867001,72.0,843801,70.1,23200,2.7
Nevada,1993,8,773912,70.3,720159,65.4,53753,6.9
New Hampshire,1993,8,620886,72.3,585092,68.2,35794,5.8
New Jersey,1993,8,4027118,65.7,3725248,60.8,301870,7.5
New Mexico,1993,8,760403,63.6,704640,58.9,55763,7.3
New York,1993,8,8721868,61.6,8040565,56.8,681303,7.8
New York city,1993,8,3299447,56.1,2968978,50.5,330469,10.0
North Carolina,1993,8,3624114,67.2,3446111,63.9,178003,4.9
North Dakota,1993,8,322327,68.6,308714,65.7,13613,4.2
Ohio,1993,8,5517289,65.7,5160078,61.4,357211,6.5
Oklahoma,1993,8,1539824,63.7,1451526,60.1,88298,5.7
Oregon,1993,8,1607704,68.2,1494512,63.4,113192,7.0
Pennsylvania,1993,8,5904805,63.3,5497078,58.9,407727,6.9
Rhode Island,1993,8,522789,67.0,484844,62.1,37945,7.3
South Carolina,1993,8,1829637,66.7,1695549,61.8,134088,7.3
South Dakota,1993,8,368206,70.7,355729,68.3,12477,3.4
Tennessee,1993,8,2545017,64.5,2399612,60.9,145405,5.7
Texas,1993,8,9205425,69.1,8549772,64.2,655653,7.1
Utah,1993,8,946161,72.2,908920,69.4,37241,3.9
Vermont,1993,8,314710,71.7,299239,68.2,15471,4.9
Virginia,1993,8,3369472,69.3,3198412,65.8,171060,5.1
Washington,1993,8,2707113,68.2,2511039,63.3,196074,7.2
West Virginia,1993,8,783935,54.9,704054,49.3,79881,10.2
Wisconsin,1993,8,2756538,72.1,2638766,69.0,117772,4.3
Wyoming,1993,8,244486,70.5,231338,66.7,13148,5.4
Alabama,1993,9,2000625,62.5,1858865,58.0,141760,7.1
Alaska,1993,9,296232,73.2,273380,67.6,22852,7.7
Arizona,1993,9,1963799,63.4,1845990,59.6,117809,6.0
Arkansas,1993,9,1181693,63.4,1110829,59.6,70864,6.0
California,1993,9,15252455,65.8,13815494,59.6,1436961,9.4
Los Angeles County,1993,9,4318708,63.9,3893549,57.6,425159,9.8
Colorado,1993,9,1945497,71.2,1847328,67.6,98169,5.0
Connecticut,1993,9,1790639,70.2,1680578,65.9,110061,6.1
Delaware,1993,9,378555,70.2,359516,66.6,19039,5.0
District of Columbia,1993,9,314339,66.8,288090,61.2,26249,8.4
Florida,1993,9,6786784,62.1,6300797,57.6,485987,7.2
Georgia,1993,9,3527050,67.5,3330101,63.7,196949,5.6
Hawaii,1993,9,582258,68.3,557491,65.4,24767,4.3
Idaho,1993,9,560213,69.2,527224,65.2,32989,5.9
Illinois,1993,9,6100971,68.2,5652834,63.2,448137,7.3
Indiana,1993,9,2966890,68.1,2834918,65.1,131972,4.4
Iowa,1993,9,1563742,72.8,1500766,69.9,62976,4.0
Kansas,1993,9,1334130,70.8,1268104,67.3,66026,4.9
Kentucky,1993,9,1799435,62.0,1692468,58.3,106967,5.9
Louisiana,1993,9,1910860,60.7,1768624,56.2,142236,7.4
Maine,1993,9,630412,66.4,587103,61.8,43309,6.9
Maryland,1993,9,2669417,70.8,2510964,66.6,158453,5.9
Massachusetts,1993,9,3190426,67.9,2970390,63.2,220036,6.9
Michigan,1993,9,4752235,66.1,4404559,61.3,347676,7.3
Minnesota,1993,9,2524282,74.2,2405393,70.7,118889,4.7
Mississippi,1993,9,1215998,62.2,1137048,58.1,78950,6.5
Missouri,1993,9,2701283,68.0,2533911,63.8,167372,6.2
Montana,1993,9,426746,67.8,401245,63.7,25501,6.0
Nebraska,1993,9,868634,72.1,845718,70.2,22916,2.6
Nevada,1993,9,777461,70.3,724214,65.4,53247,6.8
New Hampshire,1993,9,620636,72.2,585649,68.2,34987,5.6
New Jersey,1993,9,4030774,65.7,3733580,60.8,297194,7.4
New Mexico,1993,9,762153,63.6,707193,59.1,54960,7.2
New York,1993,9,8717155,61.5,8038014,56.7,679141,7.8
New York city,1993,9,3297560,56.0,2967299,50.4,330261,10.0
North Carolina,1993,9,3624992,67.1,3450732,63.9,174260,4.8
North Dakota,1993,9,322861,68.5,309323,65.6,13538,4.2
Ohio,1993,9,5524166,65.7,5167183,61.5,356983,6.5
Oklahoma,1993,9,1541252,63.7,1453637,60.1,87615,5.7
Oregon,1993,9,1613569,68.3,1502993,63.7,110576,6.9
Pennsylvania,1993,9,5904806,63.3,5501233,59.0,403573,6.8
Rhode Island,1993,9,521899,66.9,484169,62.1,37730,7.2
South Carolina,1993,9,1828129,66.5,1697110,61.8,131019,7.2
South Dakota,1993,9,368820,70.7,356407,68.3,12413,3.4
Tennessee,1993,9,2550105,64.6,2408380,61.0,141725,5.6
Texas,1993,9,9228929,69.1,8574677,64.2,654252,7.1
Utah,1993,9,951456,72.3,914886,69.6,36570,3.8
Vermont,1993,9,314451,71.6,299385,68.2,15066,4.8
Virginia,1993,9,3370048,69.2,3200590,65.7,169458,5.0
Washington,1993,9,2710651,68.2,2517940,63.4,192711,7.1
West Virginia,1993,9,783809,54.9,705106,49.4,78703,10.0
Wisconsin,1993,9,2763514,72.2,2645195,69.1,118319,4.3
Wyoming,1993,9,245051,70.4,231928,66.7,13123,5.4
Alabama,1993,10,2001456,62.4,1861721,58.1,139735,7.0
Alaska,1993,10,297112,73.3,274242,67.6,22870,7.7
Arizona,1993,10,1978201,63.6,1859101,59.8,119100,6.0
Arkansas,1993,10,1184585,63.4,1114240,59.7,70345,5.9
California,1993,10,15250959,65.8,13821036,59.6,1429923,9.4
Los Angeles County,1993,10,4306307,63.8,3881792,57.5,424515,9.9
Colorado,1993,10,1953568,71.2,1856680,67.7,96888,5.0
Connecticut,1993,10,1785581,70.0,1677928,65.8,107653,6.0
Delaware,1993,10,379232,70.3,359990,66.7,19242,5.1
District of Columbia,1993,10,314159,66.9,287976,61.3,26183,8.3
Florida,1993,10,6797955,62.1,6315414,57.7,482541,7.1
Georgia,1993,10,3538578,67.5,3340671,63.8,197907,5.6
Hawaii,1993,10,582384,68.2,557009,65.2,25375,4.4
Idaho,1993,10,563715,69.5,531071,65.5,32644,5.8
Illinois,1993,10,6102433,68.2,5665453,63.3,436980,7.2
Indiana,1993,10,2977209,68.3,2842410,65.2,134799,4.5
Iowa,1993,10,1563772,72.8,1501879,69.9,61893,4.0
Kansas,1993,10,1335137,70.8,1269245,67.3,65892,4.9
Kentucky,1993,10,1797894,61.9,1693077,58.3,104817,5.8
Louisiana,1993,10,1917465,60.9,1772662,56.3,144803,7.6
Maine,1993,10,629651,66.3,586622,61.8,43029,6.8
Maryland,1993,10,2671689,70.8,2515421,66.6,156268,5.8
Massachusetts,1993,10,3188258,67.8,2971639,63.2,216619,6.8
Michigan,1993,10,4763933,66.3,4415547,61.4,348386,7.3
Minnesota,1993,10,2530908,74.3,2413260,70.8,117648,4.6
Mississippi,1993,10,1218158,62.2,1139234,58.2,78924,6.5
Missouri,1993,10,2704139,68.0,2539252,63.9,164887,6.1
Montana,1993,10,427114,67.7,402044,63.8,25070,5.9
Nebraska,1993,10,870672,72.2,847814,70.3,22858,2.6
Nevada,1993,10,781131,70.3,728410,65.5,52721,6.7
New Hampshire,1993,10,620333,72.1,586233,68.1,34100,5.5
New Jersey,1993,10,4036452,65.7,3742860,61.0,293592,7.3
New Mexico,1993,10,763947,63.6,709874,59.1,54073,7.1
New York,1993,10,8715402,61.5,8038806,56.7,676596,7.8
New York city,1993,10,3296081,56.0,2965967,50.4,330114,10.0
North Carolina,1993,10,3627028,67.0,3455603,63.9,171425,4.7
North Dakota,1993,10,323428,68.6,309946,65.8,13482,4.2
Ohio,1993,10,5531837,65.8,5174820,61.5,357017,6.5
Oklahoma,1993,10,1542875,63.7,1455795,60.1,87080,5.6
Oregon,1993,10,1619726,68.4,1511903,63.9,107823,6.7
Pennsylvania,1993,10,5903909,63.2,5504642,59.0,399267,6.8
Rhode Island,1993,10,521226,66.8,483433,61.9,37793,7.3
South Carolina,1993,10,1827593,66.4,1699242,61.8,128351,7.0
South Dakota,1993,10,369499,70.6,357123,68.3,12376,3.3
Tennessee,1993,10,2555744,64.6,2417105,61.1,138639,5.4
Texas,1993,10,9251521,69.2,8598569,64.3,652952,7.1
Utah,1993,10,956777,72.5,920769,69.8,36008,3.8
Vermont,1993,10,314223,71.4,299487,68.0,14736,4.7
Virginia,1993,10,3371441,69.2,3203080,65.7,168361,5.0
Washington,1993,10,2714629,68.2,2525361,63.4,189268,7.0
West Virginia,1993,10,784030,54.9,706202,49.4,77828,9.9
Wisconsin,1993,10,2771882,72.3,2652046,69.2,119836,4.3
Wyoming,1993,10,245618,70.6,232524,66.8,13094,5.3
Alabama,1993,11,2003156,62.4,1865241,58.1,137915,6.9
Alaska,1993,11,298013,73.5,275031,67.8,22982,7.7
Arizona,1993,11,1994504,63.9,1873490,60.0,121014,6.1
Arkansas,1993,11,1187385,63.5,1117434,59.8,69951,5.9
California,1993,11,15256636,65.8,13831117,59.7,1425519,9.3
Los Angeles County,1993,11,4298918,63.7,3873949,57.4,424969,9.9
Colorado,1993,11,1962702,71.4,1866517,67.9,96185,4.9
Connecticut,1993,11,1780862,69.8,1675116,65.6,105746,5.9
Delaware,1993,11,379904,70.3,360445,66.7,19459,5.1
District of Columbia,1993,11,313712,66.9,287564,61.3,26148,8.3
Florida,1993,11,6814100,62.1,6332846,57.7,481254,7.1
Georgia,1993,11,3550732,67.6,3351506,63.8,199226,5.6
Hawaii,1993,11,582789,68.2,556467,65.1,26322,4.5
Idaho,1993,11,567445,69.7,535057,65.7,32388,5.7
Illinois,1993,11,6104681,68.2,5678151,63.4,426530,7.0
Indiana,1993,11,2988256,68.5,2849201,65.3,139055,4.7
Iowa,1993,11,1563624,72.7,1502434,69.9,61190,3.9
Kansas,1993,11,1336432,70.8,1270388,67.3,66044,4.9
Kentucky,1993,11,1797480,61.8,1694082,58.2,103398,5.8
Louisiana,1993,11,1925458,61.1,1777631,56.4,147827,7.7
Maine,1993,11,628953,66.2,586189,61.7,42764,6.8
Maryland,1993,11,2673674,70.8,2519557,66.7,154117,5.8
Massachusetts,1993,11,3186739,67.8,2972567,63.2,214172,6.7
Michigan,1993,11,4777517,66.4,4427728,61.5,349789,7.3
Minnesota,1993,11,2538381,74.4,2421384,71.0,116997,4.6
Mississippi,1993,11,1220881,62.3,1141589,58.2,79292,6.5
Missouri,1993,11,2707341,68.0,2545165,63.9,162176,6.0
Montana,1993,11,427773,67.6,403029,63.7,24744,5.8
Nebraska,1993,11,873013,72.4,849916,70.4,23097,2.6
Nevada,1993,11,785042,70.2,732704,65.6,52338,6.7
New Hampshire,1993,11,620257,72.1,587103,68.2,33154,5.3
New Jersey,1993,11,4039717,65.8,3748238,61.0,291479,7.2
New Mexico,1993,11,765725,63.6,712498,59.2,53227,7.0
New York,1993,11,8716941,61.5,8042306,56.7,674635,7.7
New York city,1993,11,3296061,55.9,2966245,50.4,329816,10.0
North Carolina,1993,11,3630412,67.0,3460948,63.9,169464,4.7
North Dakota,1993,11,325908,69.1,312427,66.3,13481,4.1
Ohio,1993,11,5541577,65.9,5184165,61.6,357412,6.4
Oklahoma,1993,11,1544856,63.8,1457876,60.2,86980,5.6
Oregon,1993,11,1625278,68.6,1520004,64.1,105274,6.5
Pennsylvania,1993,11,5903034,63.2,5506832,59.0,396202,6.7
Rhode Island,1993,11,520748,66.7,482800,61.8,37948,7.3
South Carolina,1993,11,1828517,66.4,1701767,61.8,126750,6.9
South Dakota,1993,11,370277,70.8,357895,68.4,12382,3.3
Tennessee,1993,11,2563458,64.7,2427033,61.3,136425,5.3
Texas,1993,11,9274088,69.2,8620928,64.3,653160,7.0
Utah,1993,11,962209,72.7,926496,70.0,35713,3.7
Vermont,1993,11,314128,71.4,299642,68.1,14486,4.6
Virginia,1993,11,3374027,69.1,3205870,65.7,168157,5.0
Washington,1993,11,2718910,68.2,2532384,63.5,186526,6.9
West Virginia,1993,11,784660,54.9,707243,49.5,77417,9.9
Wisconsin,1993,11,2781296,72.5,2658852,69.3,122444,4.4
Wyoming,1993,11,246217,70.5,233127,66.8,13090,5.3
Alabama,1993,12,2006031,62.4,1869779,58.2,136252,6.8
Alaska,1993,12,298901,73.5,275712,67.8,23189,7.8
Arizona,1993,12,2012268,64.2,1889168,60.2,123100,6.1
Arkansas,1993,12,1190118,63.6,1120466,59.9,69652,5.9
California,1993,12,15268411,65.9,13845982,59.7,1422429,9.3
Los Angeles County,1993,12,4297052,63.7,3871215,57.4,425837,9.9
Colorado,1993,12,1972836,71.6,1876955,68.1,95881,4.9
Connecticut,1993,12,1776945,69.7,1672663,65.6,104282,5.9
Delaware,1993,12,380608,70.4,360925,66.8,19683,5.2
District of Columbia,1993,12,313114,66.8,286995,61.3,26119,8.3
Florida,1993,12,6834333,62.2,6352544,57.8,481789,7.0
Georgia,1993,12,3562676,67.7,3362332,63.9,200344,5.6
Hawaii,1993,12,583337,68.2,555855,65.0,27482,4.7
Idaho,1993,12,571468,70.0,539284,66.1,32184,5.6
Illinois,1993,12,6107986,68.2,5691519,63.5,416467,6.8
Indiana,1993,12,2999139,68.7,2855982,65.4,143157,4.8
Iowa,1993,12,1563681,72.7,1502851,69.9,60830,3.9
Kansas,1993,12,1338253,70.8,1271866,67.3,66387,5.0
Kentucky,1993,12,1798836,61.8,1696308,58.3,102528,5.7
Louisiana,1993,12,1933286,61.3,1782625,56.5,150661,7.8
Maine,1993,12,628385,66.1,585860,61.6,42525,6.8
Maryland,1993,12,2675527,70.8,2523417,66.7,152110,5.7
Massachusetts,1993,12,3186200,67.8,2973668,63.2,212532,6.7
Michigan,1993,12,4790667,66.5,4440881,61.7,349786,7.3
Minnesota,1993,12,2545963,74.5,2429645,71.1,116318,4.6
Mississippi,1993,12,1224074,62.4,1144213,58.3,79861,6.5
Missouri,1993,12,2711011,68.0,2551798,64.1,159213,5.9
Montana,1993,12,428790,67.7,404247,63.8,24543,5.7
Nebraska,1993,12,875491,72.5,851961,70.5,23530,2.7
Nevada,1993,12,789210,70.3,737101,65.6,52109,6.6
New Hampshire,1993,12,620594,72.0,588362,68.3,32232,5.2
New Jersey,1993,12,4054811,66.0,3764326,61.3,290485,7.2
New Mexico,1993,12,767480,63.6,714972,59.2,52508,6.8
New York,1993,12,8719570,61.5,8047617,56.8,671953,7.7
New York city,1993,12,3297403,56.0,2968993,50.4,328410,10.0
North Carolina,1993,12,3634909,67.0,3466961,63.9,167948,4.6
North Dakota,1993,12,328429,69.5,314936,66.7,13493,4.1
Ohio,1993,12,5553466,66.0,5195731,61.7,357735,6.4
Oklahoma,1993,12,1547225,63.8,1459961,60.2,87264,5.6
Oregon,1993,12,1629680,68.6,1526793,64.3,102887,6.3
Pennsylvania,1993,12,5902449,63.2,5507784,59.0,394665,6.7
Rhode Island,1993,12,520241,66.6,482359,61.7,37882,7.3
South Carolina,1993,12,1830629,66.4,1704412,61.8,126217,6.9
South Dakota,1993,12,371167,70.8,358741,68.4,12426,3.3
Tennessee,1993,12,2574529,64.9,2439642,61.5,134887,5.2
Texas,1993,12,9297086,69.3,8642673,64.4,654413,7.0
Utah,1993,12,967791,72.8,932101,70.2,35690,3.7
Vermont,1993,12,314212,71.2,299899,68.0,14313,4.6
Virginia,1993,12,3378041,69.1,3209234,65.7,168807,5.0
Washington,1993,12,2723098,68.2,2538354,63.5,184744,6.8
West Virginia,1993,12,785635,54.9,708375,49.5,77260,9.8
Wisconsin,1993,12,2790858,72.7,2665632,69.4,125226,4.5
Wyoming,1993,12,246884,70.7,233773,67.0,13111,5.3
Alabama,1994,1,2009497,62.5,1875035,58.3,134462,6.7
Alaska,1994,1,299594,73.7,276202,67.9,23392,7.8
Arizona,1994,1,2030213,64.5,1905081,60.5,125132,6.2
Arkansas,1994,1,1192747,63.6,1123416,59.9,69331,5.8
California,1994,1,15280494,65.9,13863654,59.8,1416840,9.3
Los Angeles County,1994,1,4299244,63.8,3873367,57.5,425877,9.9
Colorado,1994,1,1983097,71.7,1887673,68.3,95424,4.8
Connecticut,1994,1,1773499,69.5,1670478,65.5,103021,5.8
Delaware,1994,1,381306,70.4,361460,66.7,19846,5.2
District of Columbia,1994,1,312450,66.8,286421,61.2,26029,8.3
Florida,1994,1,6855397,62.3,6373118,57.9,482279,7.0
Georgia,1994,1,3572920,67.8,3372684,64.0,200236,5.6
Hawaii,1994,1,583696,68.2,555125,64.9,28571,4.9
Idaho,1994,1,575487,70.4,543532,66.4,31955,5.6
Illinois,1994,1,6111087,68.2,5705574,63.6,405513,6.6
Indiana,1994,1,3008700,68.9,2863131,65.6,145569,4.8
Iowa,1994,1,1564177,72.7,1503584,69.9,60593,3.9
Kansas,1994,1,1340210,70.9,1273736,67.4,66474,5.0
Kentucky,1994,1,1801677,61.9,1699894,58.4,101783,5.6
Louisiana,1994,1,1939183,61.4,1786629,56.6,152554,7.9
Maine,1994,1,627821,66.0,585553,61.6,42268,6.7
Maryland,1994,1,2677017,70.8,2526939,66.8,150078,5.6
Massachusetts,1994,1,3186163,67.7,2975067,63.2,211096,6.6
Michigan,1994,1,4799540,66.6,4453975,61.8,345565,7.2
Minnesota,1994,1,2552802,74.7,2437976,71.3,114826,4.5
Mississippi,1994,1,1227249,62.5,1146958,58.4,80291,6.5
Missouri,1994,1,2714420,68.1,2558738,64.2,155682,5.7
Montana,1994,1,430000,67.8,405619,63.9,24381,5.7
Nebraska,1994,1,877736,72.6,853829,70.6,23907,2.7
Nevada,1994,1,793383,70.3,741457,65.7,51926,6.5
New Hampshire,1994,1,621226,72.0,589881,68.4,31345,5.0
New Jersey,1994,1,4053973,66.0,3764111,61.2,289862,7.2
New Mexico,1994,1,769069,63.6,717210,59.3,51859,6.7
New York,1994,1,8719039,61.5,8052875,56.8,666164,7.6
New York city,1994,1,3298805,56.0,2973968,50.5,324837,9.8
North Carolina,1994,1,3640132,67.0,3473504,63.9,166628,4.6
North Dakota,1994,1,330847,70.0,317418,67.2,13429,4.1
Ohio,1994,1,5565818,66.1,5208940,61.9,356878,6.4
Oklahoma,1994,1,1549364,63.9,1461772,60.3,87592,5.7
Oregon,1994,1,1632670,68.7,1532084,64.4,100586,6.2
Pennsylvania,1994,1,5902169,63.2,5508420,59.0,393749,6.7
Rhode Island,1994,1,519489,66.5,482088,61.7,37401,7.2
South Carolina,1994,1,1832918,66.4,1706850,61.8,126068,6.9
South Dakota,1994,1,372077,70.8,359605,68.5,12472,3.4
Tennessee,1994,1,2588784,65.2,2455254,61.8,133530,5.2
Texas,1994,1,9318616,69.3,8663719,64.5,654897,7.0
Utah,1994,1,973250,73.0,937464,70.3,35786,3.7
Vermont,1994,1,314412,71.3,300224,68.0,14188,4.5
Virginia,1994,1,3383003,69.2,3213179,65.7,169824,5.0
Washington,1994,1,2726284,68.1,2542783,63.6,183501,6.7
West Virginia,1994,1,786704,55.0,709709,49.6,76995,9.8
Wisconsin,1994,1,2799236,72.9,2672111,69.5,127125,4.5
Wyoming,1994,1,247563,70.7,234438,67.0,13125,5.3
Alabama,1994,2,2012659,62.6,1880447,58.5,132212,6.6
Alaska,1994,2,299978,73.8,276458,68.0,23520,7.8
Arizona,1994,2,2046720,64.8,1919830,60.8,126890,6.2
Arkansas,1994,2,1195139,63.7,1126245,60.0,68894,5.8
California,1994,2,15285958,66.0,13880192,59.9,1405766,9.2
Los Angeles County,1994,2,4302373,63.9,3878295,57.6,424078,9.9
Colorado,1994,2,1992261,71.9,1897944,68.5,94317,4.7
Connecticut,1994,2,1769918,69.4,1668209,65.4,101709,5.7
Delaware,1994,2,381938,70.5,362059,66.8,19879,5.2
District of Columbia,1994,2,311844,66.7,286021,61.2,25823,8.3
Florida,1994,2,6873541,62.4,6392868,58.0,480673,7.0
Georgia,1994,2,3580602,67.8,3382216,64.0,198386,5.5
Hawaii,1994,2,583635,68.1,554256,64.7,29379,5.0
Idaho,1994,2,579147,70.6,547422,66.8,31725,5.5
Illinois,1994,2,6111788,68.1,5718309,63.8,393479,6.4
Indiana,1994,2,3015428,69.0,2869525,65.7,145903,4.8
Iowa,1994,2,1565121,72.7,1505132,69.9,59989,3.8
Kansas,1994,2,1341690,70.9,1275643,67.4,66047,4.9
Kentucky,1994,2,1805211,62.0,1704309,58.5,100902,5.6
Louisiana,1994,2,1942270,61.5,1789169,56.7,153101,7.9
Maine,1994,2,627187,66.0,585163,61.5,42024,6.7
Maryland,1994,2,2677814,70.8,2530041,66.9,147773,5.5
Massachusetts,1994,2,3186010,67.7,2976737,63.3,209273,6.6
Michigan,1994,2,4801178,66.6,4465125,62.0,336053,7.0
Minnesota,1994,2,2558073,74.7,2445829,71.4,112244,4.4
Mississippi,1994,2,1230167,62.6,1149748,58.5,80419,6.5
Missouri,1994,2,2716752,68.1,2565280,64.3,151472,5.6
Montana,1994,2,431148,67.9,406960,64.1,24188,5.6
Nebraska,1994,2,879348,72.7,855322,70.7,24026,2.7
Nevada,1994,2,797215,70.3,745536,65.7,51679,6.5
New Hampshire,1994,2,621906,72.1,591405,68.5,30501,4.9
New Jersey,1994,2,4051525,65.9,3762757,61.2,288768,7.1
New Mexico,1994,2,770404,63.6,719181,59.4,51223,6.6
New York,1994,2,8712773,61.5,8056402,56.9,656371,7.5
New York city,1994,2,3298696,56.0,2979780,50.6,318916,9.7
North Carolina,1994,2,3644821,66.9,3479505,63.9,165316,4.5
North Dakota,1994,2,333038,70.5,319793,67.7,13245,4.0
Ohio,1994,2,5574928,66.2,5220943,62.0,353985,6.3
Oklahoma,1994,2,1550498,63.9,1462939,60.3,87559,5.6
Oregon,1994,2,1634095,68.6,1535979,64.5,98116,6.0
Pennsylvania,1994,2,5901585,63.2,5509307,59.0,392278,6.6
Rhode Island,1994,2,518409,66.3,481869,61.7,36540,7.0
South Carolina,1994,2,1834349,66.4,1708974,61.9,125375,6.8
South Dakota,1994,2,372882,71.0,360412,68.6,12470,3.3
Tennessee,1994,2,2604269,65.5,2472379,62.2,131890,5.1
Texas,1994,2,9336299,69.4,8683410,64.5,652889,7.0
Utah,1994,2,978262,73.1,942353,70.5,35909,3.7
Vermont,1994,2,314607,71.3,300540,68.1,14067,4.5
Virginia,1994,2,3387912,69.2,3217421,65.7,170491,5.0
Washington,1994,2,2727628,68.1,2545550,63.5,182078,6.7
West Virginia,1994,2,787490,55.1,711168,49.7,76322,9.7
Wisconsin,1994,2,2805251,73.0,2677780,69.6,127471,4.5
Wyoming,1994,2,248142,70.9,235056,67.1,13086,5.3
Alabama,1994,3,2015266,62.6,1885645,58.6,129621,6.4
Alaska,1994,3,300133,73.6,276557,67.9,23576,7.9
Arizona,1994,3,2061175,65.0,1932703,60.9,128472,6.2
Arkansas,1994,3,1197349,63.8,1128950,60.1,68399,5.7
California,1994,3,15281558,65.9,13891567,59.9,1389991,9.1
Los Angeles County,1994,3,4303132,63.9,3882530,57.7,420602,9.8
Colorado,1994,3,2000275,72.0,1907743,68.6,92532,4.6
Connecticut,1994,3,1766008,69.3,1665680,65.4,100328,5.7
Delaware,1994,3,382495,70.5,362738,66.8,19757,5.2
District of Columbia,1994,3,311398,66.7,285880,61.3,25518,8.2
Florida,1994,3,6887315,62.4,6410980,58.1,476335,6.9
Georgia,1994,3,3585824,67.8,3390752,64.1,195072,5.4
Hawaii,1994,3,583129,68.1,553262,64.6,29867,5.1
Idaho,1994,3,582144,70.8,550581,67.0,31563,5.4
Illinois,1994,3,6108715,68.1,5727208,63.8,381507,6.2
Indiana,1994,3,3019086,69.0,2874092,65.7,144994,4.8
Iowa,1994,3,1566457,72.7,1507639,70.0,58818,3.8
Kansas,1994,3,1342532,70.9,1277261,67.5,65271,4.9
Kentucky,1994,3,1808883,62.0,1709026,58.6,99857,5.5
Louisiana,1994,3,1943107,61.5,1790511,56.7,152596,7.9
Maine,1994,3,626474,65.9,584581,61.5,41893,6.7
Maryland,1994,3,2677975,70.7,2532660,66.9,145315,5.4
Massachusetts,1994,3,3185717,67.7,2978743,63.3,206974,6.5
Michigan,1994,3,4796361,66.5,4473259,62.1,323102,6.7
Minnesota,1994,3,2561665,74.8,2452644,71.6,109021,4.3
Mississippi,1994,3,1232960,62.6,1152642,58.6,80318,6.5
Missouri,1994,3,2718168,68.1,2571084,64.4,147084,5.4
Montana,1994,3,432162,67.9,408203,64.2,23959,5.5
Nebraska,1994,3,880202,72.7,856369,70.7,23833,2.7
Nevada,1994,3,800589,70.3,749217,65.8,51372,6.4
New Hampshire,1994,3,622500,72.1,592727,68.6,29773,4.8
New Jersey,1994,3,4048180,65.8,3761389,61.2,286791,7.1
New Mexico,1994,3,771623,63.5,720970,59.3,50653,6.6
New York,1994,3,8701585,61.4,8057665,56.9,643920,7.4
New York city,1994,3,3296570,55.9,2984953,50.6,311617,9.5
North Carolina,1994,3,3648306,66.9,3484105,63.9,164201,4.5
North Dakota,1994,3,334972,70.9,321993,68.1,12979,3.9
Ohio,1994,3,5576973,66.2,5227714,62.1,349259,6.3
Oklahoma,1994,3,1550408,63.9,1463315,60.3,87093,5.6
Oregon,1994,3,1634809,68.6,1539425,64.6,95384,5.8
Pennsylvania,1994,3,5899798,63.2,5510011,59.0,389787,6.6
Rhode Island,1994,3,517125,66.2,481555,61.7,35570,6.9
South Carolina,1994,3,1834584,66.4,1710943,61.9,123641,6.7
South Dakota,1994,3,373538,70.9,361119,68.6,12419,3.3
Tennessee,1994,3,2618993,65.8,2488951,62.5,130042,5.0
Texas,1994,3,9349793,69.4,8701323,64.6,648470,6.9
Utah,1994,3,982731,73.2,946647,70.5,36084,3.7
Vermont,1994,3,314747,71.3,300790,68.2,13957,4.4
Virginia,1994,3,3392137,69.2,3221692,65.8,170445,5.0
Washington,1994,3,2727485,68.0,2547422,63.5,180063,6.6
West Virginia,1994,3,787770,55.1,712611,49.8,75159,9.5
Wisconsin,1994,3,2808366,73.0,2682031,69.7,126335,4.5
Wyoming,1994,3,248586,70.8,235615,67.1,12971,5.2
Alabama,1994,4,2017666,62.6,1890547,58.7,127119,6.3
Alaska,1994,4,300229,73.7,276683,67.9,23546,7.8
Arizona,1994,4,2073864,65.1,1943800,61.0,130064,6.3
Arkansas,1994,4,1199791,63.8,1131928,60.2,67863,5.7
California,1994,4,15268995,65.9,13897431,60.0,1371564,9.0
Los Angeles County,1994,4,4299905,63.9,3884049,57.7,415856,9.7
Colorado,1994,4,2008215,72.1,1918000,68.8,90215,4.5
Connecticut,1994,4,1761909,69.1,1662907,65.2,99002,5.6
Delaware,1994,4,382937,70.5,363462,66.9,19475,5.1
District of Columbia,1994,4,311091,66.8,285931,61.4,25160,8.1
Florida,1994,4,6897714,62.4,6427946,58.1,469768,6.8
Georgia,1994,4,3589321,67.7,3398398,64.1,190923,5.3
Hawaii,1994,4,582376,67.9,552260,64.4,30116,5.2
Idaho,1994,4,584374,70.8,552884,67.0,31490,5.4
Illinois,1994,4,6103028,68.0,5733097,63.9,369931,6.1
Indiana,1994,4,3021777,69.0,2878021,65.8,143756,4.8
Iowa,1994,4,1568426,72.8,1510972,70.1,57454,3.7
Kansas,1994,4,1342835,70.9,1278403,67.5,64432,4.8
Kentucky,1994,4,1812660,62.1,1713927,58.7,98733,5.4
Louisiana,1994,4,1943213,61.5,1791625,56.7,151588,7.8
Maine,1994,4,625678,65.8,583838,61.4,41840,6.7
Maryland,1994,4,2678080,70.7,2535027,66.9,143053,5.3
Massachusetts,1994,4,3185942,67.7,2981538,63.3,204404,6.4
Michigan,1994,4,4789169,66.4,4479675,62.1,309494,6.5
Minnesota,1994,4,2564649,74.8,2458856,71.7,105793,4.1
Mississippi,1994,4,1235547,62.7,1155695,58.7,79852,6.5
Missouri,1994,4,2719331,68.0,2576307,64.5,143024,5.3
Montana,1994,4,433193,68.0,409453,64.3,23740,5.5
Nebraska,1994,4,880507,72.7,857094,70.8,23413,2.7
Nevada,1994,4,803602,70.2,752564,65.7,51038,6.4
New Hampshire,1994,4,622981,72.1,593815,68.7,29166,4.7
New Jersey,1994,4,4045921,65.8,3761944,61.2,283977,7.0
New Mexico,1994,4,772926,63.5,722688,59.3,50238,6.5
New York,1994,4,8688145,61.3,8057850,56.9,630295,7.3
New York city,1994,4,3292682,55.8,2988696,50.7,303986,9.2
North Carolina,1994,4,3651945,66.9,3488550,63.9,163395,4.5
North Dakota,1994,4,336717,71.1,324029,68.4,12688,3.8
Ohio,1994,4,5571443,66.1,5228364,62.1,343079,6.2
Oklahoma,1994,4,1549578,63.8,1463324,60.2,86254,5.6
Oregon,1994,4,1636007,68.5,1543488,64.6,92519,5.7
Pennsylvania,1994,4,5896826,63.1,5510594,59.0,386232,6.5
Rhode Island,1994,4,515821,66.0,481092,61.6,34729,6.7
South Carolina,1994,4,1834027,66.3,1713129,61.9,120898,6.6
South Dakota,1994,4,374083,70.9,361743,68.6,12340,3.3
Tennessee,1994,4,2632235,66.0,2503915,62.8,128320,4.9
Texas,1994,4,9360326,69.3,8718051,64.6,642275,6.9
Utah,1994,4,986720,73.3,950415,70.6,36305,3.7
Vermont,1994,4,314827,71.2,300942,68.0,13885,4.4
Virginia,1994,4,3396129,69.2,3226479,65.8,169650,5.0
Washington,1994,4,2727242,67.9,2549921,63.5,177321,6.5
West Virginia,1994,4,787544,55.0,713990,49.9,73554,9.3
Wisconsin,1994,4,2809434,72.9,2685217,69.7,124217,4.4
Wyoming,1994,4,248933,70.9,236145,67.3,12788,5.1
Alabama,1994,5,2020873,62.7,1895841,58.8,125032,6.2
Alaska,1994,5,300393,73.5,276975,67.8,23418,7.8
Arizona,1994,5,2085610,65.2,1953923,61.1,131687,6.3
Arkansas,1994,5,1202710,63.9,1135460,60.3,67250,5.6
California,1994,5,15254424,65.8,13902417,60.0,1352007,8.9
Los Angeles County,1994,5,4294342,63.9,3884390,57.8,409952,9.5
Colorado,1994,5,2017295,72.2,1929764,69.0,87531,4.3
Connecticut,1994,5,1758020,69.0,1660175,65.2,97845,5.6
Delaware,1994,5,383279,70.5,364242,67.0,19037,5.0
District of Columbia,1994,5,310810,66.8,286023,61.5,24787,8.0
Florida,1994,5,6907276,62.4,6445484,58.2,461792,6.7
Georgia,1994,5,3592770,67.6,3406158,64.1,186612,5.2
Hawaii,1994,5,581718,67.8,551423,64.3,30295,5.2
Idaho,1994,5,586003,70.9,554457,67.0,31546,5.4
Illinois,1994,5,6098520,67.9,5739075,63.9,359445,5.9
Indiana,1994,5,3026365,69.1,2883379,65.8,142986,4.7
Iowa,1994,5,1570896,72.8,1514652,70.2,56244,3.6
Kansas,1994,5,1342949,70.8,1279250,67.5,63699,4.7
Kentucky,1994,5,1817154,62.2,1719363,58.9,97791,5.4
Louisiana,1994,5,1944158,61.5,1793586,56.7,150572,7.7
Maine,1994,5,624954,65.7,583118,61.3,41836,6.7
Maryland,1994,5,2679162,70.7,2537915,67.0,141247,5.3
Massachusetts,1994,5,3187386,67.7,2985591,63.4,201795,6.3
Michigan,1994,5,4784569,66.3,4486816,62.2,297753,6.2
Minnesota,1994,5,2568356,74.8,2465141,71.8,103215,4.0
Mississippi,1994,5,1238174,62.8,1159228,58.8,78946,6.4
Missouri,1994,5,2721518,68.0,2581907,64.5,139611,5.1
Montana,1994,5,434390,68.0,410811,64.3,23579,5.4
Nebraska,1994,5,880778,72.7,857862,70.8,22916,2.6
Nevada,1994,5,806507,70.1,755777,65.7,50730,6.3
New Hampshire,1994,5,623452,72.1,594850,68.8,28602,4.6
New Jersey,1994,5,4047090,65.8,3766300,61.2,280790,6.9
New Mexico,1994,5,774483,63.5,724400,59.4,50083,6.5
New York,1994,5,8676273,61.2,8059574,56.9,616699,7.1
New York city,1994,5,3287780,55.7,2991033,50.7,296747,9.0
North Carolina,1994,5,3657705,66.9,3494639,63.9,163066,4.5
North Dakota,1994,5,337554,71.2,325120,68.6,12434,3.7
Ohio,1994,5,5561958,66.0,5226614,62.0,335344,6.0
Oklahoma,1994,5,1548854,63.7,1463813,60.2,85041,5.5
Oregon,1994,5,1638162,68.5,1548480,64.7,89682,5.5
Pennsylvania,1994,5,5893678,63.1,5511867,59.0,381811,6.5
Rhode Island,1994,5,514707,65.8,480563,61.5,34144,6.6
South Carolina,1994,5,1833702,66.2,1716143,62.0,117559,6.4
South Dakota,1994,5,374679,71.0,362404,68.7,12275,3.3
Tennessee,1994,5,2644086,66.2,2517058,63.0,127028,4.8
Texas,1994,5,9370215,69.3,8735679,64.6,634536,6.8
Utah,1994,5,990451,73.3,953867,70.6,36584,3.7
Vermont,1994,5,314922,71.2,301050,68.1,13872,4.4
Virginia,1994,5,3400847,69.3,3232668,65.8,168179,4.9
Washington,1994,5,2728117,67.8,2554115,63.5,174002,6.4
West Virginia,1994,5,787029,55.0,715354,50.0,71675,9.1
Wisconsin,1994,5,2810531,72.9,2688643,69.8,121888,4.3
Wyoming,1994,5,249225,70.8,236667,67.2,12558,5.0
Alabama,1994,6,2025757,62.7,1902131,58.9,123626,6.1
Alaska,1994,6,300585,73.6,277381,67.9,23204,7.7
Arizona,1994,6,2097345,65.4,1964149,61.2,133196,6.4
Arkansas,1994,6,1205912,64.0,1139365,60.5,66547,5.5
California,1994,6,15244302,65.7,13911550,60.0,1332752,8.7
Los Angeles County,1994,6,4289878,63.8,3886762,57.8,403116,9.4
Colorado,1994,6,2027947,72.4,1943129,69.3,84818,4.2
Connecticut,1994,6,1754857,68.9,1657867,65.1,96990,5.5
Delaware,1994,6,383640,70.5,365143,67.1,18497,4.8
District of Columbia,1994,6,310541,66.8,286096,61.6,24445,7.9
Florida,1994,6,6919101,62.4,6465458,58.3,453643,6.6
Georgia,1994,6,3597778,67.5,3415032,64.1,182746,5.1
Hawaii,1994,6,581447,67.7,550924,64.1,30523,5.2
Idaho,1994,6,587324,70.8,555565,67.0,31759,5.4
Illinois,1994,6,6098205,67.9,5746597,63.9,351608,5.8
Indiana,1994,6,3034361,69.2,2891283,66.0,143078,4.7
Iowa,1994,6,1573626,72.9,1518164,70.4,55462,3.5
Kansas,1994,6,1343420,70.8,1280213,67.5,63207,4.7
Kentucky,1994,6,1822688,62.4,1725473,59.1,97215,5.3
Louisiana,1994,6,1946762,61.5,1796948,56.8,149814,7.7
Maine,1994,6,624521,65.6,582670,61.2,41851,6.7
Maryland,1994,6,2681804,70.7,2541919,67.0,139885,5.2
Massachusetts,1994,6,3190207,67.7,2990728,63.5,199479,6.3
Michigan,1994,6,4785633,66.3,4496481,62.3,289152,6.0
Minnesota,1994,6,2573300,74.8,2471717,71.9,101583,3.9
Mississippi,1994,6,1241252,62.9,1163292,58.9,77960,6.3
Missouri,1994,6,2726019,68.1,2588791,64.6,137228,5.0
Montana,1994,6,435758,68.1,412246,64.4,23512,5.4
Nebraska,1994,6,881552,72.7,859036,70.8,22516,2.6
Nevada,1994,6,809572,70.0,759030,65.7,50542,6.2
New Hampshire,1994,6,624156,72.1,596103,68.8,28053,4.5
New Jersey,1994,6,4052579,65.8,3774530,61.3,278049,6.9
New Mexico,1994,6,776397,63.5,726184,59.4,50213,6.5
New York,1994,6,8668851,61.2,8064618,56.9,604233,7.0
New York city,1994,6,3283116,55.6,2992815,50.7,290301,8.8
North Carolina,1994,6,3666300,66.9,3503089,63.9,163211,4.5
North Dakota,1994,6,340274,71.8,328025,69.2,12249,3.6
Ohio,1994,6,5553253,65.9,5227088,62.0,326165,5.9
Oklahoma,1994,6,1548865,63.7,1465362,60.2,83503,5.4
Oregon,1994,6,1641030,68.5,1553914,64.9,87116,5.3
Pennsylvania,1994,6,5890819,63.0,5513969,59.0,376850,6.4
Rhode Island,1994,6,513952,65.8,480109,61.4,33843,6.6
South Carolina,1994,6,1834683,66.2,1720387,62.0,114296,6.2
South Dakota,1994,6,375457,71.0,363193,68.7,12264,3.3
Tennessee,1994,6,2654655,66.4,2528423,63.2,126232,4.8
Texas,1994,6,9381834,69.3,8756361,64.6,625473,6.7
Utah,1994,6,994138,73.4,957166,70.6,36972,3.7
Vermont,1994,6,315102,71.2,301184,68.1,13918,4.4
Virginia,1994,6,3406855,69.3,3240578,65.9,166277,4.9
Washington,1994,6,2731040,67.7,2560228,63.5,170812,6.3
West Virginia,1994,6,786613,54.9,716837,50.0,69776,8.9
Wisconsin,1994,6,2813342,72.9,2693450,69.8,119892,4.3
Wyoming,1994,6,249512,70.7,237208,67.2,12304,4.9
Alabama,1994,7,2032389,62.9,1909474,59.1,122915,6.0
Alaska,1994,7,300806,73.5,277837,67.8,22969,7.6
Arizona,1994,7,2110075,65.5,1975724,61.3,134351,6.4
Arkansas,1994,7,1208976,64.1,1143219,60.6,65757,5.4
California,1994,7,15242769,65.7,13927712,60.1,1315057,8.6
Los Angeles County,1994,7,4288477,63.8,3892591,58.0,395886,9.2
Colorado,1994,7,2039930,72.6,1957488,69.6,82442,4.0
Connecticut,1994,7,1752998,68.8,1656452,65.0,96546,5.5
Delaware,1994,7,384157,70.5,366224,67.2,17933,4.7
District of Columbia,1994,7,310146,66.7,285976,61.5,24170,7.8
Florida,1994,7,6935216,62.4,6488835,58.4,446381,6.4
Georgia,1994,7,3605169,67.5,3425499,64.2,179670,5.0
Hawaii,1994,7,581746,67.6,550956,64.0,30790,5.3
Idaho,1994,7,588724,70.8,556578,67.0,32146,5.5
Illinois,1994,7,6102240,67.9,5755382,64.0,346858,5.7
Indiana,1994,7,3046365,69.5,2902575,66.2,143790,4.7
Iowa,1994,7,1576478,73.0,1521224,70.5,55254,3.5
Kansas,1994,7,1344647,70.8,1281514,67.5,63133,4.7
Kentucky,1994,7,1829309,62.6,1732195,59.2,97114,5.3
Louisiana,1994,7,1951069,61.6,1801656,56.9,149413,7.7
Maine,1994,7,624667,65.6,582893,61.2,41774,6.7
Maryland,1994,7,2686219,70.8,2547302,67.1,138917,5.2
Massachusetts,1994,7,3194544,67.8,2996765,63.6,197779,6.2
Michigan,1994,7,4792497,66.3,4509275,62.4,283222,5.9
Minnesota,1994,7,2579621,75.0,2478728,72.0,100893,3.9
Mississippi,1994,7,1244881,63.0,1167575,59.1,77306,6.2
Missouri,1994,7,2733548,68.2,2597261,64.8,136287,5.0
Montana,1994,7,437288,68.2,413693,64.5,23595,5.4
Nebraska,1994,7,883230,72.7,860833,70.9,22397,2.5
Nevada,1994,7,812977,70.0,762470,65.6,50507,6.2
New Hampshire,1994,7,625310,72.2,597732,69.0,27578,4.4
New Jersey,1994,7,4061950,66.0,3785851,61.5,276099,6.8
New Mexico,1994,7,778774,63.5,728165,59.4,50609,6.5
New York,1994,7,8667957,61.1,8074627,57.0,593330,6.8
New York city,1994,7,3280363,55.6,2995791,50.8,284572,8.7
North Carolina,1994,7,3677747,67.0,3513989,64.0,163758,4.5
North Dakota,1994,7,340443,71.8,328293,69.3,12150,3.6
Ohio,1994,7,5549614,65.8,5233773,62.1,315841,5.7
Oklahoma,1994,7,1550045,63.7,1468036,60.3,82009,5.3
Oregon,1994,7,1644128,68.5,1559156,65.0,84972,5.2
Pennsylvania,1994,7,5888927,63.0,5516746,59.0,372181,6.3
Rhode Island,1994,7,513546,65.7,479826,61.4,33720,6.6
South Carolina,1994,7,1837505,66.2,1725984,62.2,111521,6.1
South Dakota,1994,7,376472,71.0,364155,68.7,12317,3.3
Tennessee,1994,7,2664691,66.5,2538772,63.4,125919,4.7
Texas,1994,7,9396868,69.3,8780774,64.7,616094,6.6
Utah,1994,7,997905,73.4,960460,70.6,37445,3.8
Vermont,1994,7,315453,71.2,301445,68.0,14008,4.4
Virginia,1994,7,3414389,69.4,3249946,66.0,164443,4.8
Washington,1994,7,2736535,67.8,2568007,63.6,168528,6.2
West Virginia,1994,7,786667,54.9,718491,50.2,68176,8.7
Wisconsin,1994,7,2818474,73.0,2700054,69.9,118420,4.2
Wyoming,1994,7,249857,70.7,237802,67.3,12055,4.8
Alabama,1994,8,2039982,63.1,1917265,59.3,122717,6.0
Alaska,1994,8,301153,73.5,278404,68.0,22749,7.6
Arizona,1994,8,2123754,65.7,1989018,61.5,134736,6.3
Arkansas,1994,8,1211493,64.1,1146660,60.7,64833,5.4
California,1994,8,15248084,65.7,13950128,60.1,1297956,8.5
Los Angeles County,1994,8,4289102,63.9,3900883,58.1,388219,9.1
Colorado,1994,8,2052297,72.8,1971771,70.0,80526,3.9
Connecticut,1994,8,1752328,68.8,1655967,65.0,96361,5.5
Delaware,1994,8,384805,70.4,367410,67.3,17395,4.5
District of Columbia,1994,8,309445,66.8,285470,61.6,23975,7.7
Florida,1994,8,6954199,62.5,6514207,58.5,439992,6.3
Georgia,1994,8,3614126,67.6,3437088,64.3,177038,4.9
Hawaii,1994,8,582509,67.7,551501,64.1,31008,5.3
Idaho,1994,8,590267,70.8,557671,66.9,32596,5.5
Illinois,1994,8,6108666,67.9,5765270,64.1,343396,5.6
Indiana,1994,8,3061796,69.7,2917598,66.4,144198,4.7
Iowa,1994,8,1579098,73.1,1523596,70.5,55502,3.5
Kansas,1994,8,1346657,70.8,1283138,67.5,63519,4.7
Kentucky,1994,8,1836571,62.8,1739282,59.4,97289,5.3
Louisiana,1994,8,1956093,61.7,1807022,57.0,149071,7.6
Maine,1994,8,625461,65.7,583928,61.4,41533,6.6
Maryland,1994,8,2691826,70.9,2553748,67.2,138078,5.1
Massachusetts,1994,8,3199936,67.9,3003426,63.7,196510,6.1
Michigan,1994,8,4802118,66.4,4523899,62.6,278219,5.8
Minnesota,1994,8,2586900,75.1,2486198,72.1,100702,3.9
Mississippi,1994,8,1248719,63.1,1171578,59.2,77141,6.2
Missouri,1994,8,2743436,68.4,2606842,65.0,136594,5.0
Montana,1994,8,438797,68.3,414975,64.6,23822,5.4
Nebraska,1994,8,885754,72.9,863146,71.0,22608,2.6
Nevada,1994,8,816613,70.0,766073,65.7,50540,6.2
New Hampshire,1994,8,626836,72.3,599639,69.1,27197,4.3
New Jersey,1994,8,4073314,66.1,3798634,61.7,274680,6.7
New Mexico,1994,8,781435,63.6,730328,59.4,51107,6.5
New York,1994,8,8672077,61.2,8088625,57.1,583452,6.7
New York city,1994,8,3279479,55.5,3000556,50.8,278923,8.5
North Carolina,1994,8,3690920,67.1,3526971,64.1,163949,4.4
North Dakota,1994,8,340739,71.7,328612,69.2,12127,3.6
Ohio,1994,8,5552350,65.8,5247921,62.2,304429,5.5
Oklahoma,1994,8,1552059,63.7,1471318,60.4,80741,5.2
Oregon,1994,8,1646764,68.5,1563637,65.0,83127,5.0
Pennsylvania,1994,8,5887757,62.9,5519986,59.0,367771,6.2
Rhode Island,1994,8,513295,65.6,479717,61.3,33578,6.5
South Carolina,1994,8,1841867,66.3,1732581,62.4,109286,5.9
South Dakota,1994,8,377684,71.3,365275,68.9,12409,3.3
Tennessee,1994,8,2674775,66.7,2548882,63.5,125893,4.7
Texas,1994,8,9414553,69.3,8807408,64.8,607145,6.4
Utah,1994,8,1001623,73.4,963716,70.6,37907,3.8
Vermont,1994,8,315980,71.3,301905,68.1,14075,4.5
Virginia,1994,8,3423049,69.5,3260143,66.2,162906,4.8
Washington,1994,8,2743711,67.8,2576572,63.7,167139,6.1
West Virginia,1994,8,787091,54.9,720195,50.3,66896,8.5
Wisconsin,1994,8,2825261,73.1,2708090,70.1,117171,4.1
Wyoming,1994,8,250258,70.7,238426,67.3,11832,4.7
Alabama,1994,9,2047405,63.3,1924730,59.5,122675,6.0
Alaska,1994,9,301488,73.4,278958,68.0,22530,7.5
Arizona,1994,9,2137542,65.9,2003746,61.8,133796,6.3
Arkansas,1994,9,1213495,64.2,1149686,60.8,63809,5.3
California,1994,9,15255392,65.7,13976634,60.2,1278758,8.4
Los Angeles County,1994,9,4290240,63.9,3910619,58.3,379621,8.8
Colorado,1994,9,2063961,73.1,1984998,70.3,78963,3.8
Connecticut,1994,9,1752316,68.8,1656200,65.0,96116,5.5
Delaware,1994,9,385463,70.6,368568,67.5,16895,4.4
District of Columbia,1994,9,308523,66.7,284666,61.5,23857,7.7
Florida,1994,9,6972615,62.5,6539152,58.6,433463,6.2
Georgia,1994,9,3622879,67.6,3448677,64.3,174202,4.8
Hawaii,1994,9,583376,67.7,552343,64.1,31033,5.3
Idaho,1994,9,591737,70.8,558767,66.8,32970,5.6
Illinois,1994,9,6116050,67.9,5777206,64.2,338844,5.5
Indiana,1994,9,3078788,70.1,2935537,66.8,143251,4.7
Iowa,1994,9,1581340,73.1,1525512,70.5,55828,3.5
Kansas,1994,9,1349097,70.9,1284970,67.5,64127,4.8
Kentucky,1994,9,1843686,62.9,1746384,59.6,97302,5.3
Louisiana,1994,9,1960407,61.8,1812195,57.1,148212,7.6
Maine,1994,9,626751,65.8,585688,61.5,41063,6.6
Maryland,1994,9,2697693,71.0,2560643,67.4,137050,5.1
Massachusetts,1994,9,3205457,67.9,3010378,63.8,195079,6.1
Michigan,1994,9,4810769,66.5,4538546,62.7,272223,5.7
Minnesota,1994,9,2594705,75.2,2494182,72.3,100523,3.9
Mississippi,1994,9,1252275,63.2,1175046,59.3,77229,6.2
Missouri,1994,9,2753967,68.6,2616476,65.1,137491,5.0
Montana,1994,9,440035,68.3,415963,64.6,24072,5.5
Nebraska,1994,9,888581,73.0,865603,71.1,22978,2.6
Nevada,1994,9,820201,69.9,769706,65.6,50495,6.2
New Hampshire,1994,9,628437,72.4,601587,69.3,26850,4.3
New Jersey,1994,9,4083992,66.2,3810916,61.8,273076,6.7
New Mexico,1994,9,784099,63.7,732638,59.5,51461,6.6
New York,1994,9,8677501,61.2,8103949,57.1,573552,6.6
New York city,1994,9,3279295,55.5,3006380,50.9,272915,8.3
North Carolina,1994,9,3704077,67.2,3541006,64.3,163071,4.4
North Dakota,1994,9,341002,71.8,328848,69.2,12154,3.6
Ohio,1994,9,5559306,65.8,5267266,62.4,292040,5.3
Oklahoma,1994,9,1554122,63.7,1474719,60.5,79403,5.1
Oregon,1994,9,1648539,68.4,1567115,65.1,81424,4.9
Pennsylvania,1994,9,5886613,62.9,5523638,59.0,362975,6.2
Rhode Island,1994,9,513033,65.6,479729,61.4,33304,6.5
South Carolina,1994,9,1846739,66.4,1739491,62.5,107248,5.8
South Dakota,1994,9,378940,71.4,366457,69.0,12483,3.3
Tennessee,1994,9,2685141,66.8,2559370,63.7,125771,4.7
Texas,1994,9,9432364,69.3,8834474,64.9,597890,6.3
Utah,1994,9,1005029,73.4,966792,70.6,38237,3.8
Vermont,1994,9,316607,71.2,302546,68.1,14061,4.4
Virginia,1994,9,3432037,69.6,3270738,66.3,161299,4.7
Washington,1994,9,2751286,67.9,2584868,63.8,166418,6.0
West Virginia,1994,9,787493,55.0,721790,50.4,65703,8.3
Wisconsin,1994,9,2832402,73.2,2717023,70.2,115379,4.1
Wyoming,1994,9,250692,70.8,239030,67.5,11662,4.7
Alabama,1994,10,2053700,63.4,1931317,59.7,122383,6.0
Alaska,1994,10,301612,73.5,279330,68.0,22282,7.4
Arizona,1994,10,2150608,66.0,2019422,62.0,131186,6.1
Arkansas,1994,10,1215302,64.2,1152653,60.9,62649,5.2
California,1994,10,15260112,65.7,14005371,60.3,1254741,8.2
Los Angeles County,1994,10,4290382,63.9,3920704,58.4,369678,8.6
Colorado,1994,10,2073978,73.2,1996588,70.5,77390,3.7
Connecticut,1994,10,1752338,68.7,1656894,65.0,95444,5.4
Delaware,1994,10,386069,70.5,369671,67.5,16398,4.2
District of Columbia,1994,10,307563,66.5,283799,61.4,23764,7.7
Florida,1994,10,6987689,62.5,6562399,58.7,425290,6.1
Georgia,1994,10,3630207,67.6,3459607,64.4,170600,4.7
Hawaii,1994,10,584049,67.8,553312,64.2,30737,5.3
Idaho,1994,10,592994,70.7,559853,66.7,33141,5.6
Illinois,1994,10,6123316,68.0,5791890,64.3,331426,5.4
Indiana,1994,10,3094843,70.4,2954449,67.2,140394,4.5
Iowa,1994,10,1583464,73.1,1527672,70.6,55792,3.5
Kansas,1994,10,1351398,70.9,1286966,67.5,64432,4.8
Kentucky,1994,10,1849757,63.0,1753002,59.8,96755,5.2
Louisiana,1994,10,1963056,61.8,1816616,57.2,146440,7.5
Maine,1994,10,628237,65.9,587955,61.7,40282,6.4
Maryland,1994,10,2702722,71.1,2567462,67.5,135260,5.0
Massachusetts,1994,10,3210165,68.0,3017414,63.9,192751,6.0
Michigan,1994,10,4816151,66.5,4551593,62.8,264558,5.5
Minnesota,1994,10,2602529,75.3,2502649,72.4,99880,3.8
Mississippi,1994,10,1255075,63.3,1177960,59.4,77115,6.1
Missouri,1994,10,2763456,68.7,2625227,65.3,138229,5.0
Montana,1994,10,440939,68.4,416727,64.6,24212,5.5
Nebraska,1994,10,891131,73.1,867986,71.2,23145,2.6
Nevada,1994,10,823534,69.9,773310,65.7,50224,6.1
New Hampshire,1994,10,629857,72.4,603385,69.3,26472,4.2
New Jersey,1994,10,4091944,66.3,3821833,61.9,270111,6.6
New Mexico,1994,10,786576,63.7,735108,59.6,51468,6.5
New York,1994,10,8681113,61.2,8119010,57.2,562103,6.5
New York city,1994,10,3278425,55.5,3012254,51.0,266171,8.1
North Carolina,1994,10,3715703,67.3,3554943,64.4,160760,4.3
North Dakota,1994,10,341085,71.8,328926,69.2,12159,3.6
Ohio,1994,10,5566940,65.9,5288275,62.6,278665,5.0
Oklahoma,1994,10,1555751,63.8,1478072,60.6,77679,5.0
Oregon,1994,10,1649377,68.3,1569853,65.0,79524,4.8
Pennsylvania,1994,10,5885030,62.9,5528398,59.1,356632,6.1
Rhode Island,1994,10,512685,65.5,479818,61.3,32867,6.4
South Carolina,1994,10,1850974,66.4,1746175,62.7,104799,5.7
South Dakota,1994,10,380050,71.4,367626,69.1,12424,3.3
Tennessee,1994,10,2695581,67.0,2570483,63.9,125098,4.6
Texas,1994,10,9448214,69.3,8861738,65.0,586476,6.2
Utah,1994,10,1007913,73.4,969641,70.6,38272,3.8
Vermont,1994,10,317238,71.4,303303,68.2,13935,4.4
Virginia,1994,10,3440577,69.7,3281535,66.4,159042,4.6
Washington,1994,10,2758407,67.9,2592625,63.8,165782,6.0
West Virginia,1994,10,787471,54.9,723166,50.4,64305,8.2
Wisconsin,1994,10,2838660,73.3,2726150,70.4,112510,4.0
Wyoming,1994,10,251129,70.7,239600,67.4,11529,4.6
Alabama,1994,11,2058507,63.5,1936715,59.8,121792,5.9
Alaska,1994,11,301561,73.3,279562,67.9,21999,7.3
Arizona,1994,11,2163001,66.2,2035522,62.3,127479,5.9
Arkansas,1994,11,1217210,64.2,1155795,61.0,61415,5.0
California,1994,11,15262583,65.7,14034864,60.4,1227719,8.0
Los Angeles County,1994,11,4288893,63.9,3929933,58.6,358960,8.4
Colorado,1994,11,2082266,73.3,2006415,70.7,75851,3.6
Connecticut,1994,11,1752258,68.7,1657911,65.0,94347,5.4
Delaware,1994,11,386673,70.5,370751,67.6,15922,4.1
District of Columbia,1994,11,306592,66.4,282869,61.3,23723,7.7
Florida,1994,11,6999058,62.5,6583667,58.8,415391,5.9
Georgia,1994,11,3636572,67.6,3469931,64.5,166641,4.6
Hawaii,1994,11,584434,67.7,554245,64.2,30189,5.2
Idaho,1994,11,594131,70.6,561062,66.7,33069,5.6
Illinois,1994,11,6131155,68.0,5809100,64.5,322055,5.3
Indiana,1994,11,3108742,70.6,2972175,67.5,136567,4.4
Iowa,1994,11,1585745,73.2,1530435,70.6,55310,3.5
Kansas,1994,11,1353242,70.9,1289117,67.6,64125,4.7
Kentucky,1994,11,1854364,63.1,1758597,59.9,95767,5.2
Louisiana,1994,11,1964223,61.8,1820193,57.3,144030,7.3
Maine,1994,11,629756,66.0,590434,61.9,39322,6.2
Maryland,1994,11,2706817,71.1,2573937,67.6,132880,4.9
Massachusetts,1994,11,3213860,68.0,3024367,64.0,189493,5.9
Michigan,1994,11,4818398,66.5,4561506,62.9,256892,5.3
Minnesota,1994,11,2609937,75.4,2511271,72.6,98666,3.8
Mississippi,1994,11,1256874,63.3,1180265,59.4,76609,6.1
Missouri,1994,11,2778771,69.0,2640294,65.6,138477,5.0
Montana,1994,11,441535,68.2,417317,64.5,24218,5.5
Nebraska,1994,11,893274,73.2,870301,71.3,22973,2.6
Nevada,1994,11,826626,69.8,776908,65.6,49718,6.0
New Hampshire,1994,11,631033,72.4,604962,69.4,26071,4.1
New Jersey,1994,11,4096954,66.4,3831247,62.1,265707,6.5
New Mexico,1994,11,788793,63.8,737665,59.7,51128,6.5
New York,1994,11,8682369,61.2,8132577,57.3,549792,6.3
New York city,1994,11,3276696,55.4,3017335,51.0,259361,7.9
North Carolina,1994,11,3724930,67.4,3567624,64.5,157306,4.2
North Dakota,1994,11,340962,71.6,328879,69.1,12083,3.5
Ohio,1994,11,5573426,65.9,5308028,62.8,265398,4.8
Oklahoma,1994,11,1556813,63.7,1481291,60.7,75522,4.9
Oregon,1994,11,1649714,68.3,1572331,65.1,77383,4.7
Pennsylvania,1994,11,5884412,62.8,5535486,59.1,348926,5.9
Rhode Island,1994,11,512347,65.4,479982,61.3,32365,6.3
South Carolina,1994,11,1854234,66.5,1752522,62.8,101712,5.5
South Dakota,1994,11,380965,71.6,368745,69.3,12220,3.2
Tennessee,1994,11,2705327,67.1,2581089,64.0,124238,4.6
Texas,1994,11,9462754,69.3,8888815,65.1,573939,6.1
Utah,1994,11,1010278,73.4,972311,70.6,37967,3.8
Vermont,1994,11,317833,71.4,304116,68.3,13717,4.3
Virginia,1994,11,3448168,69.8,3291961,66.6,156207,4.5
Washington,1994,11,2765092,68.0,2599946,63.9,165146,6.0
West Virginia,1994,11,786998,54.9,724333,50.5,62665,8.0
Wisconsin,1994,11,2843966,73.3,2734889,70.5,109077,3.8
Wyoming,1994,11,251567,70.8,240148,67.6,11419,4.5
Alabama,1994,12,2061653,63.6,1940381,59.9,121272,5.9
Alaska,1994,12,301411,73.1,279703,67.8,21708,7.2
Arizona,1994,12,2174713,66.3,2050905,62.5,123808,5.7
Arkansas,1994,12,1218853,64.2,1158541,61.0,60312,4.9
California,1994,12,15264437,65.7,14060146,60.5,1204291,7.9
Los Angeles County,1994,12,4285686,63.9,3936467,58.7,349219,8.1
Colorado,1994,12,2088971,73.4,2014040,70.8,74931,3.6
Connecticut,1994,12,1751765,68.7,1658540,65.1,93225,5.3
Delaware,1994,12,387187,70.5,371644,67.6,15543,4.0
District of Columbia,1994,12,305620,66.3,281768,61.1,23852,7.8
Florida,1994,12,7006448,62.5,6600810,58.9,405638,5.8
Georgia,1994,12,3642521,67.6,3478872,64.5,163649,4.5
Hawaii,1994,12,584546,67.7,554879,64.3,29667,5.1
Idaho,1994,12,595138,70.6,562288,66.7,32850,5.5
Illinois,1994,12,6139506,68.1,5825190,64.6,314316,5.1
Indiana,1994,12,3119422,70.8,2985811,67.8,133611,4.3
Iowa,1994,12,1587657,73.2,1532951,70.7,54706,3.4
Kansas,1994,12,1354327,70.9,1290926,67.6,63401,4.7
Kentucky,1994,12,1857155,63.2,1762263,60.0,94892,5.1
Louisiana,1994,12,1964360,61.8,1822655,57.3,141705,7.2
Maine,1994,12,631181,66.2,592748,62.2,38433,6.1
Maryland,1994,12,2709780,71.2,2579053,67.7,130727,4.8
Massachusetts,1994,12,3215995,68.0,3029918,64.1,186077,5.8
Michigan,1994,12,4818749,66.4,4566816,63.0,251933,5.2
Minnesota,1994,12,2615909,75.5,2518455,72.7,97454,3.7
Mississippi,1994,12,1257407,63.2,1181553,59.4,75854,6.0
Missouri,1994,12,2791998,69.3,2653429,65.9,138569,5.0
Montana,1994,12,441716,68.2,417548,64.4,24168,5.5
Nebraska,1994,12,894911,73.3,872251,71.4,22660,2.5
Nevada,1994,12,829418,69.8,780310,65.7,49108,5.9
New Hampshire,1994,12,631921,72.5,606215,69.5,25706,4.1
New Jersey,1994,12,4099944,66.4,3838669,62.2,261275,6.4
New Mexico,1994,12,790561,63.8,739934,59.7,50627,6.4
New York,1994,12,8681361,61.2,8141526,57.4,539835,6.2
New York city,1994,12,3274963,55.4,3020536,51.1,254427,7.8
North Carolina,1994,12,3730496,67.3,3576758,64.6,153738,4.1
North Dakota,1994,12,340656,71.5,328709,69.0,11947,3.5
Ohio,1994,12,5577312,66.0,5322558,62.9,254754,4.6
Oklahoma,1994,12,1557156,63.7,1483907,60.7,73249,4.7
Oregon,1994,12,1649875,68.1,1574318,65.0,75557,4.6
Pennsylvania,1994,12,5885202,62.8,5543137,59.2,342065,5.8
Rhode Island,1994,12,512099,65.5,480049,61.4,32050,6.3
South Carolina,1994,12,1856522,66.5,1758120,63.0,98402,5.3
South Dakota,1994,12,381659,71.6,369680,69.3,11979,3.1
Tennessee,1994,12,2712862,67.2,2588622,64.1,124240,4.6
Texas,1994,12,9476149,69.3,8912404,65.2,563745,5.9
Utah,1994,12,1012013,73.3,974566,70.6,37447,3.7
Vermont,1994,12,318326,71.5,304849,68.4,13477,4.2
Virginia,1994,12,3453739,69.8,3300180,66.7,153559,4.4
Washington,1994,12,2771101,68.0,2606099,64.0,165002,6.0
West Virginia,1994,12,786182,54.8,724998,50.6,61184,7.8
Wisconsin,1994,12,2848293,73.4,2742045,70.6,106248,3.7
Wyoming,1994,12,251961,70.9,240575,67.7,11386,4.5
Alabama,1995,1,2063222,63.6,1942035,59.9,121187,5.9
Alaska,1995,1,301220,73.0,279733,67.8,21487,7.1
Arizona,1995,1,2186008,66.4,2064921,62.8,121087,5.5
Arkansas,1995,1,1219834,64.2,1160377,61.1,59457,4.9
California,1995,1,15267263,65.7,14077198,60.6,1190065,7.8
Los Angeles County,1995,1,4281547,63.9,3939441,58.8,342106,8.0
Colorado,1995,1,2094469,73.4,2019305,70.8,75164,3.6
Connecticut,1995,1,1750300,68.7,1657849,65.0,92451,5.3
Delaware,1995,1,387406,70.4,372045,67.6,15361,4.0
District of Columbia,1995,1,304690,66.2,280492,60.9,24198,7.9
Florida,1995,1,7010015,62.4,6611902,58.9,398113,5.7
Georgia,1995,1,3648326,67.5,3485548,64.5,162778,4.5
Hawaii,1995,1,584528,67.7,555074,64.2,29454,5.0
Idaho,1995,1,596021,70.5,563425,66.7,32596,5.5
Illinois,1995,1,6147100,68.2,5836629,64.7,310471,5.1
Indiana,1995,1,3125950,70.9,2993098,67.9,132852,4.2
Iowa,1995,1,1588463,73.2,1534077,70.7,54386,3.4
Kansas,1995,1,1354463,70.9,1291879,67.6,62584,4.6
Kentucky,1995,1,1858327,63.2,1763672,59.9,94655,5.1
Louisiana,1995,1,1963940,61.8,1823927,57.4,140013,7.1
Maine,1995,1,632517,66.3,594706,62.4,37811,6.0
Maryland,1995,1,2711503,71.2,2581842,67.8,129661,4.8
Massachusetts,1995,1,3215683,68.0,3032395,64.1,183288,5.7
Michigan,1995,1,4819313,66.4,4567643,62.9,251670,5.2
Minnesota,1995,1,2619600,75.6,2522901,72.8,96699,3.7
Mississippi,1995,1,1256702,63.1,1181493,59.4,75209,6.0
Missouri,1995,1,2803137,69.5,2664236,66.1,138901,5.0
Montana,1995,1,441512,68.0,417336,64.3,24176,5.5
Nebraska,1995,1,895958,73.3,873532,71.4,22426,2.5
Nevada,1995,1,831889,69.7,783342,65.6,48547,5.8
New Hampshire,1995,1,632445,72.5,607035,69.5,25410,4.0
New Jersey,1995,1,4102255,66.4,3843923,62.2,258332,6.3
New Mexico,1995,1,791726,63.8,741565,59.8,50161,6.3
New York,1995,1,8677366,61.2,8142602,57.4,534764,6.2
New York city,1995,1,3273586,55.3,3020728,51.1,252858,7.7
North Carolina,1995,1,3731914,67.3,3580799,64.5,151115,4.0
North Dakota,1995,1,340258,71.4,328480,69.0,11778,3.5
Ohio,1995,1,5578262,65.9,5329334,63.0,248928,4.5
Oklahoma,1995,1,1556914,63.7,1485595,60.8,71319,4.6
Oregon,1995,1,1649984,68.0,1575384,65.0,74600,4.5
Pennsylvania,1995,1,5886323,62.8,5548131,59.2,338192,5.7
Rhode Island,1995,1,511858,65.4,479794,61.3,32064,6.3
South Carolina,1995,1,1857963,66.4,1762492,63.0,95471,5.1
South Dakota,1995,1,382112,71.6,370326,69.4,11786,3.1
Tennessee,1995,1,2717222,67.2,2591385,64.1,125837,4.6
Texas,1995,1,9488698,69.3,8930104,65.2,558594,5.9
Utah,1995,1,1013045,73.2,976163,70.5,36882,3.6
Vermont,1995,1,318615,71.5,305333,68.5,13282,4.2
Virginia,1995,1,3456801,69.8,3304962,66.7,151839,4.4
Washington,1995,1,2776462,68.0,2610684,64.0,165778,6.0
West Virginia,1995,1,785180,54.8,724935,50.6,60245,7.7
Wisconsin,1995,1,2851664,73.4,2746854,70.7,104810,3.7
Wyoming,1995,1,252268,70.8,240810,67.6,11458,4.5
Alabama,1995,2,2064034,63.6,1942492,59.9,121542,5.9
Alaska,1995,2,301074,72.8,279679,67.6,21395,7.1
Arizona,1995,2,2197797,66.6,2078076,63.0,119721,5.4
Arkansas,1995,2,1220213,64.1,1161372,61.0,58841,4.8
California,1995,2,15275279,65.7,14088868,60.6,1186411,7.8
Los Angeles County,1995,2,4278282,63.9,3940050,58.8,338232,7.9
Colorado,1995,2,2099615,73.4,2022952,70.7,76663,3.7
Connecticut,1995,2,1747820,68.6,1655666,65.0,92154,5.3
Delaware,1995,2,387249,70.2,371845,67.4,15404,4.0
District of Columbia,1995,2,303798,66.1,279105,60.7,24693,8.1
Florida,1995,2,7011842,62.3,6618176,58.8,393666,5.6
Georgia,1995,2,3654631,67.5,3490308,64.5,164323,4.5
Hawaii,1995,2,584606,67.7,554944,64.2,29662,5.1
Idaho,1995,2,596946,70.5,564533,66.7,32413,5.4
Illinois,1995,2,6153923,68.2,5843543,64.8,310380,5.0
Indiana,1995,2,3128824,70.9,2994450,67.9,134374,4.3
Iowa,1995,2,1587952,73.2,1533419,70.7,54533,3.4
Kansas,1995,2,1354037,70.8,1292156,67.6,61881,4.6
Kentucky,1995,2,1858705,63.1,1763496,59.9,95209,5.1
Louisiana,1995,2,1963633,61.7,1824568,57.3,139065,7.1
Maine,1995,2,633823,66.5,596293,62.5,37530,5.9
Maryland,1995,2,2712383,71.2,2582424,67.8,129959,4.8
Massachusetts,1995,2,3213020,67.9,3031620,64.0,181400,5.6
Michigan,1995,2,4822057,66.4,4566118,62.9,255939,5.3
Minnesota,1995,2,2621400,75.5,2524871,72.8,96529,3.7
Mississippi,1995,2,1255277,63.0,1180408,59.2,74869,6.0
Missouri,1995,2,2813030,69.7,2673463,66.3,139567,5.0
Montana,1995,2,441206,67.8,416918,64.1,24288,5.5
Nebraska,1995,2,896670,73.3,874257,71.4,22413,2.5
Nevada,1995,2,834278,69.6,786152,65.5,48126,5.8
New Hampshire,1995,2,632668,72.4,607508,69.5,25160,4.0
New Jersey,1995,2,4105197,66.4,3847573,62.2,257624,6.3
New Mexico,1995,2,792396,63.7,742473,59.7,49923,6.3
New York,1995,2,8671425,61.1,8137136,57.4,534289,6.2
New York city,1995,2,3273056,55.3,3018592,51.0,254464,7.8
North Carolina,1995,2,3731456,67.1,3580852,64.4,150604,4.0
North Dakota,1995,2,339927,71.3,328331,68.9,11596,3.4
Ohio,1995,2,5578483,65.9,5329961,63.0,248522,4.5
Oklahoma,1995,2,1556674,63.6,1486667,60.8,70007,4.5
Oregon,1995,2,1650300,67.9,1575658,64.9,74642,4.5
Pennsylvania,1995,2,5887682,62.9,5549716,59.2,337966,5.7
Rhode Island,1995,2,511622,65.3,479204,61.2,32418,6.3
South Carolina,1995,2,1858886,66.4,1765570,63.1,93316,5.0
South Dakota,1995,2,382428,71.5,370724,69.4,11704,3.1
Tennessee,1995,2,2718826,67.2,2589680,64.0,129146,4.8
Texas,1995,2,9502085,69.3,8943026,65.2,559059,5.9
Utah,1995,2,1013647,73.0,977283,70.4,36364,3.6
Vermont,1995,2,318746,71.4,305566,68.4,13180,4.1
Virginia,1995,2,3457860,69.7,3306671,66.7,151189,4.4
Washington,1995,2,2781442,68.0,2614019,63.9,167423,6.0
West Virginia,1995,2,784403,54.7,724381,50.5,60022,7.7
Wisconsin,1995,2,2854729,73.4,2750004,70.7,104725,3.7
Wyoming,1995,2,252495,70.9,240895,67.6,11600,4.6
Alabama,1995,3,2064578,63.6,1942434,59.8,122144,5.9
Alaska,1995,3,301035,72.8,279632,67.6,21403,7.1
Arizona,1995,3,2210140,66.8,2090506,63.2,119634,5.4
Arkansas,1995,3,1220045,64.0,1161594,61.0,58451,4.8
California,1995,3,15290438,65.8,14099170,60.7,1191268,7.8
Los Angeles County,1995,3,4276826,63.9,3939373,58.9,337453,7.9
Colorado,1995,3,2104831,73.4,2025686,70.7,79145,3.8
Connecticut,1995,3,1744577,68.4,1652289,64.8,92288,5.3
Delaware,1995,3,386803,70.0,371200,67.2,15603,4.0
District of Columbia,1995,3,302936,66.0,277706,60.5,25230,8.3
Florida,1995,3,7013726,62.3,6621657,58.8,392069,5.6
Georgia,1995,3,3661829,67.5,3493959,64.4,167870,4.6
Hawaii,1995,3,584879,67.6,554632,64.1,30247,5.2
Idaho,1995,3,598031,70.4,565630,66.5,32401,5.4
Illinois,1995,3,6159903,68.3,5846772,64.8,313131,5.1
Indiana,1995,3,3128894,70.8,2991631,67.7,137263,4.4
Iowa,1995,3,1586353,73.0,1531286,70.5,55067,3.5
Kansas,1995,3,1353340,70.7,1292029,67.5,61311,4.5
Kentucky,1995,3,1858766,63.1,1762219,59.8,96547,5.2
Louisiana,1995,3,1963488,61.7,1824967,57.3,138521,7.1
Maine,1995,3,635074,66.5,597520,62.6,37554,5.9
Maryland,1995,3,2712645,71.1,2581342,67.7,131303,4.8
Massachusetts,1995,3,3208581,67.7,3028254,63.9,180327,5.6
Michigan,1995,3,4826864,66.4,4564445,62.8,262419,5.4
Minnesota,1995,3,2621916,75.5,2525206,72.7,96710,3.7
Mississippi,1995,3,1253731,62.9,1178746,59.1,74985,6.0
Missouri,1995,3,2822235,69.9,2681842,66.5,140393,5.0
Montana,1995,3,440998,67.7,416485,63.9,24513,5.6
Nebraska,1995,3,897328,73.2,874653,71.4,22675,2.5
Nevada,1995,3,836783,69.5,788916,65.5,47867,5.7
New Hampshire,1995,3,632658,72.3,607713,69.5,24945,3.9
New Jersey,1995,3,4108779,66.5,3849533,62.3,259246,6.3
New Mexico,1995,3,792707,63.7,742722,59.6,49985,6.3
New York,1995,3,8665281,61.1,8127898,57.3,537383,6.2
New York city,1995,3,3274084,55.3,3015754,51.0,258330,7.9
North Carolina,1995,3,3731550,67.0,3578804,64.3,152746,4.1
North Dakota,1995,3,339771,71.2,328360,68.8,11411,3.4
Ohio,1995,3,5580429,65.9,5327598,62.9,252831,4.5
Oklahoma,1995,3,1556751,63.6,1487421,60.8,69330,4.5
Oregon,1995,3,1650990,67.9,1575449,64.8,75541,4.6
Pennsylvania,1995,3,5889125,62.9,5548469,59.2,340656,5.8
Rhode Island,1995,3,511403,65.3,478427,61.1,32976,6.4
South Carolina,1995,3,1859541,66.4,1767457,63.1,92084,5.0
South Dakota,1995,3,382701,71.5,370941,69.3,11760,3.1
Tennessee,1995,3,2718243,67.1,2584576,63.8,133667,4.9
Texas,1995,3,9516748,69.3,8952476,65.2,564272,5.9
Utah,1995,3,1014095,72.8,978169,70.3,35926,3.5
Vermont,1995,3,318800,71.4,305625,68.4,13175,4.1
Virginia,1995,3,3457295,69.7,3305862,66.6,151433,4.4
Washington,1995,3,2786094,68.0,2616240,63.9,169854,6.1
West Virginia,1995,3,784183,54.7,723688,50.5,60495,7.7
Wisconsin,1995,3,2858204,73.4,2752753,70.7,105451,3.7
Wyoming,1995,3,252607,70.7,240854,67.4,11753,4.7
Alabama,1995,4,2064899,63.6,1942123,59.8,122776,5.9
Alaska,1995,4,301122,72.7,279607,67.5,21515,7.1
Arizona,1995,4,2222219,66.9,2101933,63.3,120286,5.4
Arkansas,1995,4,1219477,64.0,1161177,60.9,58300,4.8
California,1995,4,15312439,65.9,14111632,60.7,1200807,7.8
Los Angeles County,1995,4,4277186,63.9,3937998,58.9,339188,7.9
Colorado,1995,4,2110306,73.4,2028175,70.6,82131,3.9
Connecticut,1995,4,1741064,68.3,1648395,64.7,92669,5.3
Delaware,1995,4,386285,69.9,370401,67.0,15884,4.1
District of Columbia,1995,4,302085,65.9,276355,60.3,25730,8.5
Florida,1995,4,7016921,62.2,6624364,58.7,392557,5.6
Georgia,1995,4,3669882,67.6,3497268,64.4,172614,4.7
Hawaii,1995,4,585273,67.6,554182,64.0,31091,5.3
Idaho,1995,4,599207,70.3,566620,66.5,32587,5.4
Illinois,1995,4,6164015,68.3,5846521,64.8,317494,5.2
Indiana,1995,4,3126974,70.7,2986782,67.6,140192,4.5
Iowa,1995,4,1584228,72.9,1528502,70.3,55726,3.5
Kansas,1995,4,1352688,70.6,1291849,67.4,60839,4.5
Kentucky,1995,4,1858655,63.0,1760169,59.7,98486,5.3
Louisiana,1995,4,1963401,61.6,1825437,57.3,137964,7.0
Maine,1995,4,636310,66.7,598506,62.7,37804,5.9
Maryland,1995,4,2712564,71.1,2579388,67.6,133176,4.9
Massachusetts,1995,4,3203190,67.6,3023460,63.8,179730,5.6
Michigan,1995,4,4831766,66.4,4563594,62.8,268172,5.6
Minnesota,1995,4,2621440,75.4,2524627,72.6,96813,3.7
Mississippi,1995,4,1252721,62.7,1176880,58.9,75841,6.1
Missouri,1995,4,2831279,70.1,2690132,66.6,141147,5.0
Montana,1995,4,440987,67.5,416162,63.7,24825,5.6
Nebraska,1995,4,898099,73.2,874999,71.3,23100,2.6
Nevada,1995,4,839481,69.4,791768,65.5,47713,5.7
New Hampshire,1995,4,632488,72.2,607693,69.4,24795,3.9
New Jersey,1995,4,4112140,66.5,3849694,62.2,262446,6.4
New Mexico,1995,4,792917,63.5,742589,59.5,50328,6.3
New York,1995,4,8660916,61.0,8117854,57.2,543062,6.3
New York city,1995,4,3277764,55.4,3014236,50.9,263528,8.0
North Carolina,1995,4,3732902,66.9,3576029,64.1,156873,4.2
North Dakota,1995,4,339866,71.2,328618,68.8,11248,3.3
Ohio,1995,4,5585108,65.9,5324788,62.9,260320,4.7
Oklahoma,1995,4,1557129,63.6,1487917,60.8,69212,4.4
Oregon,1995,4,1652232,67.8,1575393,64.6,76839,4.7
Pennsylvania,1995,4,5890189,62.9,5545255,59.2,344934,5.9
Rhode Island,1995,4,511228,65.3,477673,61.0,33555,6.6
South Carolina,1995,4,1860221,66.3,1768503,63.0,91718,4.9
South Dakota,1995,4,383028,71.5,371098,69.3,11930,3.1
Tennessee,1995,4,2716686,66.9,2578237,63.5,138449,5.1
Texas,1995,4,9532806,69.3,8960132,65.1,572674,6.0
Utah,1995,4,1014620,72.6,979028,70.1,35592,3.5
Vermont,1995,4,318844,71.4,305611,68.4,13233,4.2
Virginia,1995,4,3455376,69.6,3303054,66.5,152322,4.4
Washington,1995,4,2790299,68.0,2617554,63.8,172745,6.2
West Virginia,1995,4,784634,54.7,723154,50.4,61480,7.8
Wisconsin,1995,4,2862084,73.4,2755755,70.7,106329,3.7
Wyoming,1995,4,252631,70.7,240734,67.4,11897,4.7
Alabama,1995,5,2065176,63.6,1941947,59.8,123229,6.0
Alaska,1995,5,301371,72.7,279653,67.5,21718,7.2
Arizona,1995,5,2233491,67.0,2112520,63.4,120971,5.4
Arkansas,1995,5,1219013,63.9,1160638,60.8,58375,4.8
California,1995,5,15299050,65.8,14088435,60.6,1210615,7.9
Los Angeles County,1995,5,4279230,64.0,3936697,58.9,342533,8.0
Colorado,1995,5,2116253,73.5,2031179,70.5,85074,4.0
Connecticut,1995,5,1738069,68.2,1645017,64.5,93052,5.4
Delaware,1995,5,385914,69.7,369747,66.7,16167,4.2
District of Columbia,1995,5,301327,65.8,275191,60.1,26136,8.7
Florida,1995,5,7022498,62.1,6628398,58.6,394100,5.6
Georgia,1995,5,3678683,67.6,3501293,64.3,177390,4.8
Hawaii,1995,5,585694,67.6,553663,63.9,32031,5.5
Idaho,1995,5,600360,70.3,567507,66.5,32853,5.5
Illinois,1995,5,6166872,68.3,5845323,64.7,321549,5.2
Indiana,1995,5,3124733,70.6,2982822,67.4,141911,4.5
Iowa,1995,5,1582669,72.8,1526390,70.2,56279,3.6
Kansas,1995,5,1352548,70.5,1292124,67.4,60424,4.5
Kentucky,1995,5,1858420,62.9,1757894,59.5,100526,5.4
Louisiana,1995,5,1963422,61.6,1826399,57.3,137023,7.0
Maine,1995,5,637587,66.8,599498,62.8,38089,6.0
Maryland,1995,5,2712479,71.1,2577486,67.5,134993,5.0
Massachusetts,1995,5,3198417,67.4,3019295,63.7,179122,5.6
Michigan,1995,5,4835270,66.5,4564640,62.7,270630,5.6
Minnesota,1995,5,2620899,75.3,2524318,72.5,96581,3.7
Mississippi,1995,5,1252596,62.7,1175325,58.8,77271,6.2
Missouri,1995,5,2837113,70.2,2695564,66.7,141549,5.0
Montana,1995,5,441302,67.5,416148,63.6,25154,5.7
Nebraska,1995,5,899210,73.2,875645,71.3,23565,2.6
Nevada,1995,5,842471,69.4,794904,65.5,47567,5.6
New Hampshire,1995,5,632352,72.1,607641,69.3,24711,3.9
New Jersey,1995,5,4115137,66.5,3849325,62.2,265812,6.5
New Mexico,1995,5,793427,63.4,742517,59.4,50910,6.4
New York,1995,5,8659978,61.0,8110330,57.2,549648,6.3
New York city,1995,5,3284607,55.5,3015682,50.9,268925,8.2
North Carolina,1995,5,3736361,66.9,3574716,64.0,161645,4.3
North Dakota,1995,5,340227,71.2,329082,68.9,11145,3.3
Ohio,1995,5,5592152,66.0,5323518,62.8,268634,4.8
Oklahoma,1995,5,1557890,63.6,1488338,60.7,69552,4.5
Oregon,1995,5,1654584,67.8,1576509,64.6,78075,4.7
Pennsylvania,1995,5,5891569,62.9,5542644,59.1,348925,5.9
Rhode Island,1995,5,511159,65.2,477203,60.9,33956,6.6
South Carolina,1995,5,1861278,66.3,1769262,63.0,92016,4.9
South Dakota,1995,5,383485,71.4,371344,69.2,12141,3.2
Tennessee,1995,5,2715985,66.8,2573343,63.3,142642,5.3
Texas,1995,5,9551015,69.3,8968732,65.1,582283,6.1
Utah,1995,5,1015495,72.5,980162,70.0,35333,3.5
Vermont,1995,5,318966,71.3,305664,68.3,13302,4.2
Virginia,1995,5,3452865,69.4,3299325,66.4,153540,4.4
Washington,1995,5,2794285,68.0,2618975,63.7,175310,6.3
West Virginia,1995,5,785641,54.8,723029,50.4,62612,8.0
Wisconsin,1995,5,2866228,73.5,2759412,70.7,106816,3.7
Wyoming,1995,5,252692,70.5,240671,67.2,12021,4.8
Alabama,1995,6,2065524,63.5,1942300,59.7,123224,6.0
Alaska,1995,6,301858,72.7,279893,67.4,21965,7.3
Arizona,1995,6,2243372,67.1,2122366,63.5,121006,5.4
Arkansas,1995,6,1219196,63.8,1160591,60.7,58605,4.8
California,1995,6,15290438,65.8,14073315,60.5,1217123,8.0
Los Angeles County,1995,6,4282315,64.1,3935852,58.9,346463,8.1
Colorado,1995,6,2122651,73.5,2035200,70.5,87451,4.1
Connecticut,1995,6,1736197,68.1,1643013,64.4,93184,5.4
Delaware,1995,6,385792,69.5,369408,66.6,16384,4.2
District of Columbia,1995,6,300635,65.8,274232,60.0,26403,8.8
Florida,1995,6,7030182,62.1,6634627,58.6,395555,5.6
Georgia,1995,6,3687851,67.6,3506801,64.3,181050,4.9
Hawaii,1995,6,586007,67.6,553138,63.8,32869,5.6
Idaho,1995,6,601495,70.3,568378,66.4,33117,5.5
Illinois,1995,6,6169873,68.3,5846262,64.7,323611,5.2
Indiana,1995,6,3123638,70.5,2981636,67.3,142002,4.5
Iowa,1995,6,1582538,72.7,1525978,70.1,56560,3.6
Kansas,1995,6,1352936,70.5,1293034,67.4,59902,4.4
Kentucky,1995,6,1858219,62.9,1755989,59.4,102230,5.5
Louisiana,1995,6,1963451,61.5,1828013,57.3,135438,6.9
Maine,1995,6,638912,66.9,600680,62.9,38232,6.0
Maryland,1995,6,2712575,71.0,2576204,67.4,136371,5.0
Massachusetts,1995,6,3195768,67.3,3017785,63.6,177983,5.6
Michigan,1995,6,4836626,66.4,4567815,62.7,268811,5.6
Minnesota,1995,6,2621329,75.2,2525319,72.4,96010,3.7
Mississippi,1995,6,1253218,62.6,1174595,58.7,78623,6.3
Missouri,1995,6,2850385,70.4,2709370,67.0,141015,4.9
Montana,1995,6,441958,67.4,416516,63.5,25442,5.8
Nebraska,1995,6,900646,73.2,876716,71.3,23930,2.7
Nevada,1995,6,845768,69.3,798416,65.4,47352,5.6
New Hampshire,1995,6,632295,72.0,607703,69.2,24592,3.9
New Jersey,1995,6,4117712,66.5,3849751,62.2,267961,6.5
New Mexico,1995,6,794488,63.4,742803,59.3,51685,6.5
New York,1995,6,8661964,61.0,8107121,57.1,554843,6.4
New York city,1995,6,3293272,55.6,3020064,51.0,273208,8.3
North Carolina,1995,6,3742324,66.9,3576548,63.9,165776,4.4
North Dakota,1995,6,340781,71.3,329660,69.0,11121,3.3
Ohio,1995,6,5600402,66.1,5324508,62.8,275894,4.9
Oklahoma,1995,6,1559093,63.6,1489032,60.7,70061,4.5
Oregon,1995,6,1658166,67.8,1579198,64.6,78968,4.8
Pennsylvania,1995,6,5894334,62.9,5542968,59.1,351366,6.0
Rhode Island,1995,6,511185,65.3,477198,60.9,33987,6.6
South Carolina,1995,6,1862830,66.2,1770081,62.9,92749,5.0
South Dakota,1995,6,384073,71.5,371761,69.2,12312,3.2
Tennessee,1995,6,2717335,66.7,2571749,63.2,145586,5.4
Texas,1995,6,9570506,69.3,8979583,65.1,590923,6.2
Utah,1995,6,1016803,72.4,981729,69.9,35074,3.4
Vermont,1995,6,319243,71.3,305885,68.3,13358,4.2
Virginia,1995,6,3450346,69.3,3295655,66.2,154691,4.5
Washington,1995,6,2798428,68.0,2621364,63.7,177064,6.3
West Virginia,1995,6,786845,54.9,723290,50.4,63555,8.1
Wisconsin,1995,6,2870534,73.5,2763740,70.8,106794,3.7
Wyoming,1995,6,252867,70.6,240731,67.2,12136,4.8
Alabama,1995,7,2066181,63.5,1943377,59.7,122804,5.9
Alaska,1995,7,302566,72.7,280347,67.3,22219,7.3
Arizona,1995,7,2251221,67.1,2131148,63.5,120073,5.3
Arkansas,1995,7,1220350,63.8,1161392,60.7,58958,4.8
California,1995,7,15284519,65.7,14065570,60.5,1218949,8.0
Los Angeles County,1995,7,4286521,64.2,3936310,58.9,350211,8.2
Colorado,1995,7,2129472,73.5,2040464,70.5,89008,4.2
Connecticut,1995,7,1735715,68.1,1642762,64.4,92953,5.4
Delaware,1995,7,385860,69.4,369349,66.4,16511,4.3
District of Columbia,1995,7,299993,65.7,273437,59.9,26556,8.9
Florida,1995,7,7039940,62.1,6643205,58.6,396735,5.6
Georgia,1995,7,3696842,67.7,3513868,64.3,182974,4.9
Hawaii,1995,7,586051,67.5,552636,63.7,33415,5.7
Idaho,1995,7,602654,70.2,569303,66.3,33351,5.5
Illinois,1995,7,6174220,68.3,5850181,64.7,324039,5.2
Indiana,1995,7,3123700,70.5,2982877,67.3,140823,4.5
Iowa,1995,7,1584065,72.7,1527537,70.1,56528,3.6
Kansas,1995,7,1353720,70.4,1294623,67.4,59097,4.4
Kentucky,1995,7,1857965,62.8,1754754,59.3,103211,5.6
Louisiana,1995,7,1963415,61.5,1829955,57.3,133460,6.8
Maine,1995,7,640146,67.0,601950,63.0,38196,6.0
Maryland,1995,7,2712672,71.0,2575694,67.4,136978,5.0
Massachusetts,1995,7,3195880,67.3,3019782,63.6,176098,5.5
Michigan,1995,7,4836144,66.4,4572330,62.7,263814,5.5
Minnesota,1995,7,2623257,75.2,2527850,72.4,95407,3.6
Mississippi,1995,7,1254321,62.6,1174823,58.6,79498,6.3
Missouri,1995,7,2852213,70.4,2713029,67.0,139184,4.9
Montana,1995,7,442784,67.4,417132,63.5,25652,5.8
Nebraska,1995,7,902178,73.3,878091,71.3,24087,2.7
Nevada,1995,7,849365,69.3,802266,65.5,47099,5.5
New Hampshire,1995,7,632310,71.9,607964,69.1,24346,3.9
New Jersey,1995,7,4119696,66.5,3851099,62.2,268597,6.5
New Mexico,1995,7,796082,63.4,743481,59.2,52601,6.6
New York,1995,7,8666019,61.1,8107846,57.1,558173,6.4
New York city,1995,7,3302500,55.7,3026242,51.1,276258,8.4
North Carolina,1995,7,3749970,66.9,3581696,63.9,168274,4.5
North Dakota,1995,7,341416,71.3,330262,69.0,11154,3.3
Ohio,1995,7,5608827,66.1,5327598,62.8,281229,5.0
Oklahoma,1995,7,1560508,63.6,1490220,60.7,70288,4.5
Oregon,1995,7,1662538,67.9,1582992,64.6,79546,4.8
Pennsylvania,1995,7,5898588,62.9,5546846,59.2,351742,6.0
Rhode Island,1995,7,511358,65.2,477728,61.0,33630,6.6
South Carolina,1995,7,1865000,66.2,1771009,62.9,93991,5.0
South Dakota,1995,7,384780,71.5,372365,69.2,12415,3.2
Tennessee,1995,7,2720392,66.7,2573551,63.1,146841,5.4
Texas,1995,7,9590083,69.4,8992894,65.1,597189,6.2
Utah,1995,7,1018517,72.3,983730,69.9,34787,3.4
Vermont,1995,7,319663,71.3,306274,68.3,13389,4.2
Virginia,1995,7,3447933,69.2,3292552,66.1,155381,4.5
Washington,1995,7,2803004,68.0,2625039,63.7,177965,6.3
West Virginia,1995,7,787831,54.9,723739,50.4,64092,8.1
Wisconsin,1995,7,2874650,73.5,2768114,70.8,106536,3.7
Wyoming,1995,7,253165,70.6,240908,67.2,12257,4.8
Alabama,1995,8,2066920,63.5,1945059,59.7,121861,5.9
Alaska,1995,8,303307,72.8,280830,67.4,22477,7.4
Arizona,1995,8,2256571,67.1,2138063,63.6,118508,5.3
Arkansas,1995,8,1222419,63.8,1162994,60.7,59425,4.9
California,1995,8,15277686,65.6,14061236,60.4,1216450,8.0
Los Angeles County,1995,8,4291722,64.2,3938297,58.9,353425,8.2
Colorado,1995,8,2136204,73.6,2046462,70.5,89742,4.2
Connecticut,1995,8,1736384,68.1,1643918,64.5,92466,5.3
Delaware,1995,8,385938,69.3,369319,66.3,16619,4.3
District of Columbia,1995,8,299312,65.7,272716,59.8,26596,8.9
Florida,1995,8,7050756,62.1,6653607,58.6,397149,5.6
Georgia,1995,8,3704787,67.7,3521759,64.3,183028,4.9
Hawaii,1995,8,585815,67.4,552177,63.5,33638,5.7
Idaho,1995,8,603755,70.2,570266,66.3,33489,5.5
Illinois,1995,8,6179675,68.3,5855510,64.7,324165,5.2
Indiana,1995,8,3123578,70.4,2984287,67.3,139291,4.5
Iowa,1995,8,1587065,72.8,1530812,70.2,56253,3.5
Kansas,1995,8,1354517,70.4,1296533,67.4,57984,4.3
Kentucky,1995,8,1857301,62.7,1753946,59.2,103355,5.6
Louisiana,1995,8,1963395,61.4,1831696,57.3,131699,6.7
Maine,1995,8,641199,67.0,603261,63.1,37938,5.9
Maryland,1995,8,2712806,70.9,2575764,67.3,137042,5.1
Massachusetts,1995,8,3198030,67.3,3024418,63.7,173612,5.4
Michigan,1995,8,4834411,66.3,4576991,62.7,257420,5.3
Minnesota,1995,8,2626447,75.2,2531380,72.4,95067,3.6
Mississippi,1995,8,1255357,62.6,1175603,58.6,79754,6.4
Missouri,1995,8,2853428,70.4,2717090,67.0,136338,4.8
Montana,1995,8,443555,67.4,417781,63.5,25774,5.8
Nebraska,1995,8,903593,73.3,879535,71.4,24058,2.7
Nevada,1995,8,853133,69.3,806246,65.5,46887,5.5
New Hampshire,1995,8,632399,71.8,608416,69.1,23983,3.8
New Jersey,1995,8,4120816,66.5,3852944,62.1,267872,6.5
New Mexico,1995,8,797984,63.4,744317,59.1,53667,6.7
New York,1995,8,8670255,61.1,8110637,57.1,559618,6.5
New York city,1995,8,3311003,55.8,3032696,51.1,278307,8.4
North Carolina,1995,8,3758895,66.9,3589186,63.9,169709,4.5
North Dakota,1995,8,342001,71.4,330806,69.1,11195,3.3
Ohio,1995,8,5616055,66.2,5331244,62.8,284811,5.1
Oklahoma,1995,8,1561918,63.6,1491902,60.7,70016,4.5
Oregon,1995,8,1667174,67.9,1587230,64.7,79944,4.8
Pennsylvania,1995,8,5904014,62.9,5553027,59.2,350987,5.9
Rhode Island,1995,8,511622,65.2,478680,61.0,32942,6.4
South Carolina,1995,8,1867279,66.3,1771640,62.9,95639,5.1
South Dakota,1995,8,385495,71.5,373046,69.2,12449,3.2
Tennessee,1995,8,2724332,66.7,2577764,63.1,146568,5.4
Texas,1995,8,9608253,69.4,9007450,65.1,600803,6.3
Utah,1995,8,1020442,72.2,985927,69.8,34515,3.4
Vermont,1995,8,320172,71.4,306781,68.4,13391,4.2
Virginia,1995,8,3445300,69.0,3289835,65.9,155465,4.5
Washington,1995,8,2808599,68.0,2630206,63.7,178393,6.4
West Virginia,1995,8,788405,55.0,724179,50.5,64226,8.1
Wisconsin,1995,8,2878170,73.5,2771807,70.8,106363,3.7
Wyoming,1995,8,253524,70.5,241146,67.1,12378,4.9
Alabama,1995,9,2067404,63.4,1947133,59.7,120271,5.8
Alaska,1995,9,303971,72.8,281238,67.4,22733,7.5
Arizona,1995,9,2259814,67.0,2142754,63.5,117060,5.2
Arkansas,1995,9,1224844,63.8,1164903,60.7,59941,4.9
California,1995,9,15266835,65.5,14055290,60.3,1211545,7.9
Los Angeles County,1995,9,4296836,64.3,3940553,59.0,356283,8.3
Colorado,1995,9,2142263,73.7,2052411,70.6,89852,4.2
Connecticut,1995,9,1737609,68.1,1645704,64.5,91905,5.3
Delaware,1995,9,385851,69.1,369052,66.1,16799,4.4
District of Columbia,1995,9,298468,65.4,271978,59.6,26490,8.9
Florida,1995,9,7061002,62.0,6664472,58.5,396530,5.6
Georgia,1995,9,3711196,67.6,3529764,64.3,181432,4.9
Hawaii,1995,9,585529,67.4,551851,63.5,33678,5.8
Idaho,1995,9,604890,70.2,571323,66.3,33567,5.5
Illinois,1995,9,6184870,68.3,5859994,64.7,324876,5.3
Indiana,1995,9,3122151,70.3,2983701,67.2,138450,4.4
Iowa,1995,9,1590698,72.9,1534723,70.3,55975,3.5
Kansas,1995,9,1354984,70.4,1298248,67.4,56736,4.2
Kentucky,1995,9,1856162,62.6,1753258,59.2,102904,5.5
Louisiana,1995,9,1963539,61.4,1832863,57.3,130676,6.7
Maine,1995,9,642135,67.1,604649,63.2,37486,5.8
Maryland,1995,9,2713320,70.9,2576189,67.3,137131,5.1
Massachusetts,1995,9,3200688,67.3,3029856,63.7,170832,5.3
Michigan,1995,9,4832102,66.2,4580994,62.7,251108,5.2
Minnesota,1995,9,2630164,75.2,2535022,72.4,95142,3.6
Mississippi,1995,9,1255900,62.5,1176382,58.6,79518,6.3
Missouri,1995,9,2854032,70.3,2720907,67.0,133125,4.7
Montana,1995,9,444114,67.4,418266,63.5,25848,5.8
Nebraska,1995,9,904841,73.3,880842,71.4,23999,2.7
Nevada,1995,9,856892,69.3,810170,65.6,46722,5.5
New Hampshire,1995,9,632507,71.7,608911,69.0,23596,3.7
New Jersey,1995,9,4121197,66.4,3854935,62.1,266262,6.5
New Mexico,1995,9,799993,63.5,745053,59.1,54940,6.9
New York,1995,9,8672475,61.1,8113828,57.1,558647,6.4
New York city,1995,9,3317480,55.9,3038297,51.2,279183,8.4
North Carolina,1995,9,3768835,67.0,3597860,63.9,170975,4.5
North Dakota,1995,9,342516,71.4,331314,69.0,11202,3.3
Ohio,1995,9,5621384,66.2,5334305,62.8,287079,5.1
Oklahoma,1995,9,1563311,63.6,1493782,60.7,69529,4.4
Oregon,1995,9,1671800,68.0,1591270,64.7,80530,4.8
Pennsylvania,1995,9,5910145,63.0,5559646,59.2,350499,5.9
Rhode Island,1995,9,511850,65.2,479828,61.1,32022,6.3
South Carolina,1995,9,1868835,66.2,1771540,62.8,97295,5.2
South Dakota,1995,9,386133,71.6,373684,69.3,12449,3.2
Tennessee,1995,9,2728651,66.7,2583121,63.1,145530,5.3
Texas,1995,9,9623573,69.4,9021392,65.0,602181,6.3
Utah,1995,9,1022371,72.2,988072,69.7,34299,3.4
Vermont,1995,9,320722,71.3,307349,68.3,13373,4.2
Virginia,1995,9,3441974,68.9,3286899,65.8,155075,4.5
Washington,1995,9,2815292,68.1,2636773,63.8,178519,6.3
West Virginia,1995,9,788603,54.9,724426,50.5,64177,8.1
Wisconsin,1995,9,2881043,73.5,2774311,70.8,106732,3.7
Wyoming,1995,9,253834,70.6,241388,67.1,12446,4.9
Alabama,1995,10,2067660,63.4,1949307,59.7,118353,5.7
Alaska,1995,10,304582,73.0,281596,67.5,22986,7.5
Arizona,1995,10,2261597,66.8,2145298,63.4,116299,5.1
Arkansas,1995,10,1227070,63.9,1166624,60.7,60446,4.9
California,1995,10,15251422,65.4,14044544,60.2,1206878,7.9
Los Angeles County,1995,10,4301077,64.3,3941919,59.0,359158,8.4
Colorado,1995,10,2147331,73.7,2057505,70.6,89826,4.2
Connecticut,1995,10,1738773,68.1,1647318,64.5,91455,5.3
Delaware,1995,10,385504,69.0,368359,66.0,17145,4.4
District of Columbia,1995,10,297508,65.3,271215,59.5,26293,8.8
Florida,1995,10,7070465,62.0,6674885,58.5,395580,5.6
Georgia,1995,10,3716280,67.6,3537389,64.3,178891,4.8
Hawaii,1995,10,585507,67.3,551786,63.4,33721,5.8
Idaho,1995,10,606112,70.2,572465,66.3,33647,5.6
Illinois,1995,10,6188928,68.3,5862525,64.7,326403,5.3
Indiana,1995,10,3119048,70.1,2980482,67.0,138566,4.4
Iowa,1995,10,1594064,73.0,1538084,70.5,55980,3.5
Kansas,1995,10,1355188,70.3,1299466,67.4,55722,4.1
Kentucky,1995,10,1854754,62.5,1752555,59.1,102199,5.5
Louisiana,1995,10,1964103,61.3,1833561,57.3,130542,6.6
Maine,1995,10,643116,67.2,606128,63.3,36988,5.8
Maryland,1995,10,2714414,70.8,2576699,67.2,137715,5.1
Massachusetts,1995,10,3202494,67.3,3034360,63.8,168134,5.3
Michigan,1995,10,4830751,66.1,4584776,62.7,245975,5.1
Minnesota,1995,10,2634007,75.2,2538238,72.4,95769,3.6
Mississippi,1995,10,1255846,62.5,1176750,58.5,79096,6.3
Missouri,1995,10,2854458,70.3,2724167,67.1,130291,4.6
Montana,1995,10,444376,67.4,418486,63.4,25890,5.8
Nebraska,1995,10,905923,73.3,881864,71.3,24059,2.7
Nevada,1995,10,860499,69.3,813907,65.5,46592,5.4
New Hampshire,1995,10,632549,71.6,609284,68.9,23265,3.7
New Jersey,1995,10,4121598,66.4,3856744,62.1,264854,6.4
New Mexico,1995,10,801852,63.5,745533,59.0,56319,7.0
New York,1995,10,8672136,61.0,8116152,57.1,555984,6.4
New York city,1995,10,3321771,55.9,3042464,51.2,279307,8.4
North Carolina,1995,10,3778858,67.0,3606674,64.0,172184,4.6
North Dakota,1995,10,342989,71.5,331816,69.1,11173,3.3
Ohio,1995,10,5624550,66.2,5336125,62.8,288425,5.1
Oklahoma,1995,10,1564697,63.5,1495700,60.7,68997,4.4
Oregon,1995,10,1676415,68.0,1594669,64.7,81746,4.9
Pennsylvania,1995,10,5915814,63.0,5564891,59.3,350923,5.9
Rhode Island,1995,10,512074,65.2,481012,61.3,31062,6.1
South Carolina,1995,10,1869273,66.2,1770482,62.7,98791,5.3
South Dakota,1995,10,386689,71.6,374187,69.3,12502,3.2
Tennessee,1995,10,2732933,66.7,2588521,63.2,144412,5.3
Texas,1995,10,9635581,69.4,9033523,65.0,602058,6.2
Utah,1995,10,1024168,72.1,989968,69.7,34200,3.3
Vermont,1995,10,321252,71.4,307913,68.5,13339,4.2
Virginia,1995,10,3437702,68.7,3283393,65.6,154309,4.5
Washington,1995,10,2822821,68.2,2644420,63.8,178401,6.3
West Virginia,1995,10,788583,54.9,724399,50.5,64184,8.1
Wisconsin,1995,10,2883900,73.5,2776286,70.8,107614,3.7
Wyoming,1995,10,254011,70.5,241567,67.0,12444,4.9
Alabama,1995,11,2067700,63.3,1951431,59.8,116269,5.6
Alaska,1995,11,305124,73.1,281904,67.5,23220,7.6
Arizona,1995,11,2262380,66.7,2146292,63.2,116088,5.1
Arkansas,1995,11,1228681,63.9,1167791,60.7,60890,5.0
California,1995,11,15250575,65.4,14048728,60.2,1201847,7.9
Los Angeles County,1995,11,4303506,64.4,3941805,59.0,361701,8.4
Colorado,1995,11,2150923,73.6,2061108,70.5,89815,4.2
Connecticut,1995,11,1739419,68.1,1648338,64.5,91081,5.2
Delaware,1995,11,384991,68.8,367338,65.7,17653,4.6
District of Columbia,1995,11,296412,65.2,270401,59.4,26011,8.8
Florida,1995,11,7078749,62.0,6685037,58.5,393712,5.6
Georgia,1995,11,3720453,67.5,3544584,64.3,175869,4.7
Hawaii,1995,11,585914,67.2,552050,63.4,33864,5.8
Idaho,1995,11,607301,70.1,573561,66.2,33740,5.6
Illinois,1995,11,6191365,68.3,5863729,64.7,327636,5.3
Indiana,1995,11,3114051,70.0,2975200,66.9,138851,4.5
Iowa,1995,11,1596772,73.1,1540509,70.5,56263,3.5
Kansas,1995,11,1355245,70.3,1300151,67.4,55094,4.1
Kentucky,1995,11,1853311,62.4,1751796,59.0,101515,5.5
Louisiana,1995,11,1965059,61.3,1834191,57.3,130868,6.7
Maine,1995,11,644282,67.2,607771,63.4,36511,5.7
Maryland,1995,11,2715758,70.8,2577109,67.2,138649,5.1
Massachusetts,1995,11,3202538,67.3,3037115,63.8,165423,5.2
Michigan,1995,11,4831096,66.0,4589080,62.7,242016,5.0
Minnesota,1995,11,2637814,75.2,2540805,72.4,97009,3.7
Mississippi,1995,11,1255299,62.4,1176732,58.5,78567,6.3
Missouri,1995,11,2855103,70.2,2726746,67.1,128357,4.5
Montana,1995,11,444415,67.3,418540,63.4,25875,5.8
Nebraska,1995,11,906747,73.3,882528,71.3,24219,2.7
Nevada,1995,11,863855,69.3,817417,65.6,46438,5.4
New Hampshire,1995,11,632442,71.5,609436,68.9,23006,3.6
New Jersey,1995,11,4122173,66.3,3858207,62.1,263966,6.4
New Mexico,1995,11,803390,63.5,745760,59.0,57630,7.2
New York,1995,11,8670536,61.0,8118468,57.1,552068,6.4
New York city,1995,11,3324658,55.9,3045637,51.2,279021,8.4
North Carolina,1995,11,3788544,67.1,3615032,64.0,173512,4.6
North Dakota,1995,11,343416,71.5,332281,69.2,11135,3.2
Ohio,1995,11,5625241,66.2,5336911,62.8,288330,5.1
Oklahoma,1995,11,1566001,63.5,1497636,60.8,68365,4.4
Oregon,1995,11,1681013,68.1,1597340,64.7,83673,5.0
Pennsylvania,1995,11,5920040,63.0,5568367,59.3,351673,5.9
Rhode Island,1995,11,512339,65.2,482156,61.4,30183,5.9
South Carolina,1995,11,1868421,66.1,1768537,62.5,99884,5.3
South Dakota,1995,11,387128,71.5,374511,69.2,12617,3.3
Tennessee,1995,11,2736422,66.7,2593104,63.2,143318,5.2
Texas,1995,11,9643830,69.3,9043826,65.0,600004,6.2
Utah,1995,11,1025730,72.0,991525,69.6,34205,3.3
Vermont,1995,11,321727,71.5,308423,68.6,13304,4.1
Virginia,1995,11,3432471,68.5,3279584,65.5,152887,4.5
Washington,1995,11,2830709,68.2,2652805,63.9,177904,6.3
West Virginia,1995,11,788373,54.9,724132,50.4,64241,8.1
Wisconsin,1995,11,2887368,73.5,2778877,70.8,108491,3.8
Wyoming,1995,11,254061,70.5,241636,67.0,12425,4.9
Alabama,1995,12,2067617,63.3,1953285,59.8,114332,5.5
Alaska,1995,12,305568,73.0,282155,67.4,23413,7.7
Arizona,1995,12,2263010,66.5,2146501,63.1,116509,5.1
Arkansas,1995,12,1229735,63.9,1168393,60.7,61342,5.0
California,1995,12,15205811,65.2,14009652,60.0,1196159,7.9
Los Angeles County,1995,12,4303769,64.4,3939841,58.9,363928,8.5
Colorado,1995,12,2152989,73.5,2063202,70.5,89787,4.2
Connecticut,1995,12,1739721,68.1,1648899,64.6,90822,5.2
Delaware,1995,12,384586,68.6,366376,65.4,18210,4.7
District of Columbia,1995,12,295185,64.8,269493,59.2,25692,8.7
Florida,1995,12,7086591,61.9,6695625,58.5,390966,5.5
Georgia,1995,12,3724916,67.5,3551848,64.3,173068,4.6
Hawaii,1995,12,586795,67.3,552661,63.4,34134,5.8
Idaho,1995,12,608417,70.1,574554,66.2,33863,5.6
Illinois,1995,12,6193319,68.3,5865215,64.7,328104,5.3
Indiana,1995,12,3108249,69.8,2969546,66.7,138703,4.5
Iowa,1995,12,1599219,73.2,1542460,70.6,56759,3.5
Kansas,1995,12,1355452,70.2,1300474,67.4,54978,4.1
Kentucky,1995,12,1852066,62.3,1751011,58.9,101055,5.5
Louisiana,1995,12,1966651,61.4,1835342,57.3,131309,6.7
Maine,1995,12,645603,67.4,609476,63.6,36127,5.6
Maryland,1995,12,2717267,70.8,2577694,67.1,139573,5.1
Massachusetts,1995,12,3201708,67.2,3038984,63.8,162724,5.1
Michigan,1995,12,4833708,66.0,4594108,62.7,239600,5.0
Minnesota,1995,12,2641562,75.2,2542935,72.4,98627,3.7
Mississippi,1995,12,1254686,62.3,1176504,58.4,78182,6.2
Missouri,1995,12,2856767,70.2,2728901,67.1,127866,4.5
Montana,1995,12,444523,67.2,418695,63.3,25828,5.8
Nebraska,1995,12,907374,73.3,882973,71.3,24401,2.7
Nevada,1995,12,867094,69.3,820788,65.6,46306,5.3
New Hampshire,1995,12,632230,71.3,609348,68.7,22882,3.6
New Jersey,1995,12,4123594,66.3,3859844,62.1,263750,6.4
New Mexico,1995,12,804742,63.5,745872,58.9,58870,7.3
New York,1995,12,8671789,61.0,8123272,57.2,548517,6.3
New York city,1995,12,3328183,56.0,3049030,51.3,279153,8.4
North Carolina,1995,12,3798947,67.2,3623778,64.1,175169,4.6
North Dakota,1995,12,343808,71.5,332698,69.1,11110,3.2
Ohio,1995,12,5624783,66.2,5337938,62.8,286845,5.1
Oklahoma,1995,12,1567399,63.5,1499676,60.8,67723,4.3
Oregon,1995,12,1685873,68.2,1599800,64.7,86073,5.1
Pennsylvania,1995,12,5923534,63.1,5571539,59.3,351995,5.9
Rhode Island,1995,12,512723,65.2,483298,61.5,29425,5.7
South Carolina,1995,12,1866785,65.9,1766155,62.4,100630,5.4
South Dakota,1995,12,387472,71.6,374714,69.2,12758,3.3
Tennessee,1995,12,2738737,66.6,2596450,63.2,142287,5.2
Texas,1995,12,9649799,69.3,9053425,65.0,596374,6.2
Utah,1995,12,1027133,71.9,992810,69.5,34323,3.3
Vermont,1995,12,322189,71.5,308893,68.5,13296,4.1
Virginia,1995,12,3427310,68.3,3276346,65.3,150964,4.4
Washington,1995,12,2839175,68.4,2661879,64.1,177296,6.2
West Virginia,1995,12,788210,54.9,723981,50.4,64229,8.1
Wisconsin,1995,12,2891898,73.6,2782820,70.8,109078,3.8
Wyoming,1995,12,254047,70.5,241631,67.0,12416,4.9
Alabama,1996,1,2068045,63.2,1955199,59.8,112846,5.5
Alaska,1996,1,305998,73.1,282473,67.5,23525,7.7
Arizona,1996,1,2264527,66.4,2146892,62.9,117635,5.2
Arkansas,1996,1,1230594,63.9,1168670,60.6,61924,5.0
California,1996,1,15224699,65.2,14034613,60.1,1190086,7.8
Los Angeles County,1996,1,4302726,64.4,3936868,58.9,365858,8.5
Colorado,1996,1,2154763,73.4,2064658,70.4,90105,4.2
Connecticut,1996,1,1740403,68.1,1649646,64.6,90757,5.2
Delaware,1996,1,384619,68.6,365960,65.3,18659,4.9
District of Columbia,1996,1,293889,64.6,268464,59.0,25425,8.7
Florida,1996,1,7095622,61.9,6707566,58.5,388056,5.5
Georgia,1996,1,3731284,67.5,3560059,64.4,171225,4.6
Hawaii,1996,1,588116,67.4,553597,63.4,34519,5.9
Idaho,1996,1,609466,70.1,575487,66.2,33979,5.6
Illinois,1996,1,6197743,68.3,5868805,64.7,328938,5.3
Indiana,1996,1,3103713,69.6,2965753,66.5,137960,4.4
Iowa,1996,1,1601659,73.3,1544314,70.6,57345,3.6
Kansas,1996,1,1356325,70.2,1300891,67.3,55434,4.1
Kentucky,1996,1,1851380,62.3,1750537,58.9,100843,5.4
Louisiana,1996,1,1969263,61.4,1837564,57.3,131699,6.7
Maine,1996,1,646950,67.4,611067,63.7,35883,5.5
Maryland,1996,1,2719465,70.8,2579363,67.1,140102,5.2
Massachusetts,1996,1,3202006,67.2,3041756,63.8,160250,5.0
Michigan,1996,1,4839375,66.0,4600523,62.8,238852,4.9
Minnesota,1996,1,2645509,75.2,2545212,72.4,100297,3.8
Mississippi,1996,1,1254589,62.2,1176537,58.4,78052,6.2
Missouri,1996,1,2860444,70.3,2731515,67.1,128929,4.5
Montana,1996,1,444910,67.2,419160,63.3,25750,5.8
Nebraska,1996,1,908131,73.2,883567,71.3,24564,2.7
Nevada,1996,1,870461,69.3,824275,65.6,46186,5.3
New Hampshire,1996,1,632093,71.2,609121,68.6,22972,3.6
New Jersey,1996,1,4127107,66.3,3863065,62.1,264042,6.4
New Mexico,1996,1,806062,63.5,746110,58.8,59952,7.4
New York,1996,1,8680061,61.1,8132910,57.2,547151,6.3
New York city,1996,1,3334766,56.1,3054184,51.3,280582,8.4
North Carolina,1996,1,3811217,67.3,3634489,64.1,176728,4.6
North Dakota,1996,1,344257,71.5,333157,69.2,11100,3.2
Ohio,1996,1,5625737,66.1,5340645,62.8,285092,5.1
Oklahoma,1996,1,1569313,63.6,1502219,60.8,67094,4.3
Oregon,1996,1,1691188,68.3,1602661,64.7,88527,5.2
Pennsylvania,1996,1,5928327,63.1,5577071,59.4,351256,5.9
Rhode Island,1996,1,513365,65.3,484596,61.6,28769,5.6
South Carolina,1996,1,1865521,65.8,1764129,62.3,101392,5.4
South Dakota,1996,1,387845,71.5,374932,69.1,12913,3.3
Tennessee,1996,1,2740357,66.6,2598882,63.1,141475,5.2
Texas,1996,1,9655855,69.2,9063885,65.0,591970,6.1
Utah,1996,1,1028674,71.8,994135,69.4,34539,3.4
Vermont,1996,1,322722,71.6,309382,68.6,13340,4.1
Virginia,1996,1,3423449,68.2,3274301,65.2,149148,4.4
Washington,1996,1,2848378,68.5,2671375,64.2,177003,6.2
West Virginia,1996,1,788395,54.9,724344,50.4,64051,8.1
Wisconsin,1996,1,2897709,73.7,2788465,70.9,109244,3.8
Wyoming,1996,1,254043,70.3,241635,66.8,12408,4.9
Alabama,1996,2,2069647,63.2,1957709,59.8,111938,5.4
Alaska,1996,2,306486,73.1,282954,67.5,23532,7.7
Arizona,1996,2,2267245,66.3,2147831,62.8,119414,5.3
Arkansas,1996,2,1231494,63.9,1168844,60.6,62650,5.1
California,1996,2,15248554,65.3,14064840,60.2,1183714,7.8
Los Angeles County,1996,2,4301661,64.4,3934326,58.9,367335,8.5
Colorado,1996,2,2156813,73.4,2065845,70.3,90968,4.2
Connecticut,1996,2,1741692,68.2,1650805,64.6,90887,5.2
Delaware,1996,2,385245,68.6,366359,65.2,18886,4.9
District of Columbia,1996,2,292708,64.5,267447,58.9,25261,8.6
Florida,1996,2,7106650,61.9,6720888,58.5,385762,5.4
Georgia,1996,2,3740587,67.5,3569998,64.4,170589,4.6
Hawaii,1996,2,589736,67.6,554781,63.6,34955,5.9
Idaho,1996,2,610369,70.1,576349,66.2,34020,5.6
Illinois,1996,2,6206521,68.4,5875263,64.7,331258,5.3
Indiana,1996,2,3101578,69.5,2965005,66.5,136573,4.4
Iowa,1996,2,1604016,73.4,1546037,70.7,57979,3.6
Kansas,1996,2,1358058,70.3,1301731,67.3,56327,4.1
Kentucky,1996,2,1851715,62.2,1750886,58.8,100829,5.4
Louisiana,1996,2,1972805,61.5,1840965,57.4,131840,6.7
Maine,1996,2,648341,67.6,612579,63.9,35762,5.5
Maryland,1996,2,2722839,70.8,2582803,67.2,140036,5.1
Massachusetts,1996,2,3204519,67.2,3046453,63.9,158066,4.9
Michigan,1996,2,4848399,66.1,4608941,62.9,239458,4.9
Minnesota,1996,2,2649706,75.3,2547901,72.4,101805,3.8
Mississippi,1996,2,1255374,62.3,1177239,58.4,78135,6.2
Missouri,1996,2,2866453,70.3,2735238,67.1,131215,4.6
Montana,1996,2,445552,67.2,419909,63.3,25643,5.8
Nebraska,1996,2,909282,73.3,884543,71.3,24739,2.7
Nevada,1996,2,874105,69.3,828056,65.6,46049,5.3
New Hampshire,1996,2,632129,71.1,608865,68.5,23264,3.7
New Jersey,1996,2,4133351,66.4,3869026,62.1,264325,6.4
New Mexico,1996,2,807463,63.5,746653,58.7,60810,7.5
New York,1996,2,8695968,61.2,8147151,57.3,548817,6.3
New York city,1996,2,3345389,56.2,3061646,51.5,283743,8.5
North Carolina,1996,2,3825159,67.4,3647616,64.3,177543,4.6
North Dakota,1996,2,344828,71.6,333733,69.3,11095,3.2
Ohio,1996,2,5630352,66.2,5346322,62.8,284030,5.0
Oklahoma,1996,2,1571862,63.6,1505456,60.9,66406,4.2
Oregon,1996,2,1696927,68.4,1606070,64.7,90857,5.4
Pennsylvania,1996,2,5935857,63.2,5586843,59.5,349014,5.9
Rhode Island,1996,2,514229,65.3,486081,61.8,28148,5.5
South Carolina,1996,2,1865833,65.8,1763252,62.2,102581,5.5
South Dakota,1996,2,388322,71.6,375258,69.2,13064,3.4
Tennessee,1996,2,2742163,66.5,2601221,63.1,140942,5.1
Texas,1996,2,9663419,69.2,9076408,65.0,587011,6.1
Utah,1996,2,1030507,71.8,995716,69.3,34791,3.4
Vermont,1996,2,323315,71.6,309872,68.6,13443,4.2
Virginia,1996,2,3421972,68.1,3273724,65.1,148248,4.3
Washington,1996,2,2858056,68.6,2681013,64.4,177043,6.2
West Virginia,1996,2,788918,54.9,725300,50.5,63618,8.1
Wisconsin,1996,2,2904562,73.8,2795457,71.0,109105,3.8
Wyoming,1996,2,254104,70.3,241669,66.8,12435,4.9
Alabama,1996,3,2072789,63.3,1961434,59.9,111355,5.4
Alaska,1996,3,307068,73.2,283629,67.6,23439,7.6
Arizona,1996,3,2271263,66.2,2149672,62.7,121591,5.4
Arkansas,1996,3,1232703,63.8,1169317,60.6,63386,5.1
California,1996,3,15277868,65.4,14102011,60.3,1175857,7.7
Los Angeles County,1996,3,4302182,64.4,3934441,58.9,367741,8.5
Colorado,1996,3,2158703,73.3,2066618,70.1,92085,4.3
Connecticut,1996,3,1743321,68.2,1652272,64.6,91049,5.2
Delaware,1996,3,386281,68.6,367373,65.3,18908,4.9
District of Columbia,1996,3,291745,64.2,266549,58.7,25196,8.6
Florida,1996,3,7119804,61.9,6735546,58.6,384258,5.4
Georgia,1996,3,3752906,67.6,3581997,64.5,170909,4.6
Hawaii,1996,3,591401,67.7,556088,63.6,35313,6.0
Idaho,1996,3,611200,70.0,577266,66.1,33934,5.6
Illinois,1996,3,6219336,68.5,5884838,64.8,334498,5.4
Indiana,1996,3,3101482,69.5,2966972,66.5,134510,4.3
Iowa,1996,3,1606389,73.4,1547827,70.8,58562,3.6
Kansas,1996,3,1360441,70.3,1303064,67.4,57377,4.2
Kentucky,1996,3,1853535,62.2,1752880,58.9,100655,5.4
Louisiana,1996,3,1976823,61.6,1845249,57.5,131574,6.7
Maine,1996,3,649877,67.7,614186,64.0,35691,5.5
Maryland,1996,3,2727663,70.9,2588279,67.3,139384,5.1
Massachusetts,1996,3,3209470,67.3,3053503,64.0,155967,4.9
Michigan,1996,3,4859904,66.2,4618982,62.9,240922,5.0
Minnesota,1996,3,2654206,75.3,2551152,72.4,103054,3.9
Mississippi,1996,3,1257086,62.3,1178860,58.4,78226,6.2
Missouri,1996,3,2874151,70.5,2740182,67.2,133969,4.7
Montana,1996,3,446347,67.2,420837,63.3,25510,5.7
Nebraska,1996,3,910799,73.4,885884,71.4,24915,2.7
Nevada,1996,3,878101,69.3,832214,65.7,45887,5.2
New Hampshire,1996,3,632377,71.0,608751,68.4,23626,3.7
New Jersey,1996,3,4142498,66.5,3878605,62.3,263893,6.4
New Mexico,1996,3,809027,63.5,747559,58.7,61468,7.6
New York,1996,3,8717412,61.3,8165220,57.4,552192,6.3
New York city,1996,3,3358857,56.4,3070839,51.6,288018,8.6
North Carolina,1996,3,3839973,67.6,3663069,64.4,176904,4.6
North Dakota,1996,3,345532,71.6,334441,69.3,11091,3.2
Ohio,1996,3,5639643,66.3,5355959,62.9,283684,5.0
Oklahoma,1996,3,1574912,63.7,1509365,61.0,65547,4.2
Oregon,1996,3,1702651,68.5,1609782,64.8,92869,5.5
Pennsylvania,1996,3,5946492,63.3,5601505,59.6,344987,5.8
Rhode Island,1996,3,515159,65.4,487650,61.9,27509,5.3
South Carolina,1996,3,1868212,65.8,1763972,62.1,104240,5.6
South Dakota,1996,3,388910,71.5,375747,69.1,13163,3.4
Tennessee,1996,3,2744987,66.5,2604503,63.1,140484,5.1
Texas,1996,3,9673017,69.1,9091964,65.0,581053,6.0
Utah,1996,3,1032649,71.7,997660,69.3,34989,3.4
Vermont,1996,3,323894,71.7,310312,68.7,13582,4.2
Virginia,1996,3,3423452,68.1,3275105,65.1,148347,4.3
Washington,1996,3,2867832,68.8,2690857,64.5,176975,6.2
West Virginia,1996,3,789567,55.0,726725,50.6,62842,8.0
Wisconsin,1996,3,2911552,73.9,2802838,71.1,108714,3.7
Wyoming,1996,3,254272,70.3,241765,66.9,12507,4.9
Alabama,1996,4,2077361,63.4,1966726,60.0,110635,5.3
Alaska,1996,4,307664,73.4,284414,67.8,23250,7.6
Arizona,1996,4,2276470,66.2,2152680,62.6,123790,5.4
Arkansas,1996,4,1234292,63.8,1170361,60.5,63931,5.2
California,1996,4,15310667,65.5,14145908,60.5,1164759,7.6
Los Angeles County,1996,4,4305172,64.4,3938998,58.9,366174,8.5
Colorado,1996,4,2159951,73.1,2066931,70.0,93020,4.3
Connecticut,1996,4,1744937,68.3,1653894,64.7,91043,5.2
Delaware,1996,4,387392,68.8,368573,65.5,18819,4.9
District of Columbia,1996,4,291017,64.1,265866,58.6,25151,8.6
Florida,1996,4,7134438,61.9,6751539,58.6,382899,5.4
Georgia,1996,4,3767475,67.7,3595904,64.7,171571,4.6
Hawaii,1996,4,592851,67.8,557407,63.7,35444,6.0
Idaho,1996,4,612151,70.0,578414,66.2,33737,5.5
Illinois,1996,4,6233705,68.6,5896339,64.9,337366,5.4
Indiana,1996,4,3102255,69.4,2970347,66.5,131908,4.3
Iowa,1996,4,1608503,73.5,1549644,70.8,58859,3.7
Kansas,1996,4,1363076,70.4,1304768,67.4,58308,4.3
Kentucky,1996,4,1856764,62.3,1756770,58.9,99994,5.4
Louisiana,1996,4,1980859,61.6,1850060,57.6,130799,6.6
Maine,1996,4,651467,67.8,615907,64.1,35560,5.5
Maryland,1996,4,2733653,71.0,2595545,67.4,138108,5.1
Massachusetts,1996,4,3216649,67.4,3062970,64.2,153679,4.8
Michigan,1996,4,4872237,66.3,4629801,63.0,242436,5.0
Minnesota,1996,4,2658899,75.3,2555006,72.4,103893,3.9
Mississippi,1996,4,1259294,62.3,1181437,58.5,77857,6.2
Missouri,1996,4,2882184,70.6,2745942,67.3,136242,4.7
Montana,1996,4,447167,67.2,421823,63.4,25344,5.7
Nebraska,1996,4,912459,73.4,887427,71.4,25032,2.7
Nevada,1996,4,882492,69.4,836778,65.8,45714,5.2
New Hampshire,1996,4,632889,71.0,608959,68.3,23930,3.8
New Jersey,1996,4,4153871,66.6,3891646,62.4,262225,6.3
New Mexico,1996,4,810622,63.5,748733,58.7,61889,7.6
New York,1996,4,8741196,61.5,8186775,57.6,554421,6.3
New York city,1996,4,3372569,56.6,3080688,51.7,291881,8.7
North Carolina,1996,4,3854887,67.7,3679963,64.6,174924,4.5
North Dakota,1996,4,346299,71.8,335228,69.5,11071,3.2
Ohio,1996,4,5651928,66.4,5368332,63.1,283596,5.0
Oklahoma,1996,4,1578317,63.8,1513898,61.2,64419,4.1
Oregon,1996,4,1707636,68.6,1613369,64.8,94267,5.5
Pennsylvania,1996,4,5958858,63.4,5619814,59.8,339044,5.7
Rhode Island,1996,4,516025,65.5,489148,62.1,26877,5.2
South Carolina,1996,4,1872302,65.9,1766227,62.2,106075,5.7
South Dakota,1996,4,389534,71.6,376358,69.2,13176,3.4
Tennessee,1996,4,2748736,66.5,2608946,63.1,139790,5.1
Texas,1996,4,9683657,69.1,9110433,65.0,573224,5.9
Utah,1996,4,1035068,71.7,1000018,69.2,35050,3.4
Vermont,1996,4,324426,71.8,310699,68.8,13727,4.2
Virginia,1996,4,3427198,68.0,3278348,65.1,148850,4.3
Washington,1996,4,2877012,68.9,2700658,64.7,176354,6.1
West Virginia,1996,4,790143,55.0,728385,50.7,61758,7.8
Wisconsin,1996,4,2917583,74.0,2809600,71.2,107983,3.7
Wyoming,1996,4,254529,70.4,241935,66.9,12594,4.9
Alabama,1996,5,2082905,63.5,1973363,60.1,109542,5.3
Alaska,1996,5,308239,73.3,285260,67.9,22979,7.5
Arizona,1996,5,2282099,66.2,2156306,62.5,125793,5.5
Arkansas,1996,5,1236131,63.9,1171946,60.5,64185,5.2
California,1996,5,15344340,65.6,14194736,60.7,1149604,7.5
Los Angeles County,1996,5,4310533,64.5,3948282,59.1,362251,8.4
Colorado,1996,5,2160270,73.0,2066885,69.8,93385,4.3
Connecticut,1996,5,1746402,68.3,1655595,64.8,90807,5.2
Delaware,1996,5,388349,68.9,369602,65.5,18747,4.8
District of Columbia,1996,5,290445,64.1,265406,58.6,25039,8.6
Florida,1996,5,7150108,62.0,6769160,58.7,380948,5.3
Georgia,1996,5,3783176,67.9,3611147,64.8,172029,4.5
Hawaii,1996,5,593878,67.9,558635,63.8,35243,5.9
Idaho,1996,5,613353,70.0,579927,66.2,33426,5.4
Illinois,1996,5,6245968,68.7,5907179,65.0,338789,5.4
Indiana,1996,5,3102652,69.4,2973827,66.5,128825,4.2
Iowa,1996,5,1610113,73.5,1551362,70.8,58751,3.6
Kansas,1996,5,1365542,70.5,1306688,67.5,58854,4.3
Kentucky,1996,5,1861286,62.4,1762359,59.1,98927,5.3
Louisiana,1996,5,1984763,61.7,1855073,57.7,129690,6.5
Maine,1996,5,652988,67.9,617679,64.3,35309,5.4
Maryland,1996,5,2740564,71.1,2604135,67.6,136429,5.0
Massachusetts,1996,5,3225113,67.5,3074004,64.4,151109,4.7
Michigan,1996,5,4884088,66.4,4640745,63.1,243343,5.0
Minnesota,1996,5,2663353,75.4,2559287,72.4,104066,3.9
Mississippi,1996,5,1261634,62.4,1184693,58.6,76941,6.1
Missouri,1996,5,2889310,70.7,2751947,67.4,137363,4.8
Montana,1996,5,447884,67.2,422748,63.4,25136,5.6
Nebraska,1996,5,914012,73.4,889005,71.4,25007,2.7
Nevada,1996,5,887225,69.5,841685,65.9,45540,5.1
New Hampshire,1996,5,633671,71.0,609544,68.3,24127,3.8
New Jersey,1996,5,4166169,66.8,3906831,62.6,259338,6.2
New Mexico,1996,5,812089,63.5,750061,58.7,62028,7.6
New York,1996,5,8764348,61.6,8210941,57.7,553407,6.3
New York city,1996,5,3384286,56.8,3090220,51.8,294066,8.7
North Carolina,1996,5,3868849,67.8,3696717,64.8,172132,4.4
North Dakota,1996,5,347055,71.9,336054,69.6,11001,3.2
Ohio,1996,5,5664034,66.5,5380741,63.2,283293,5.0
Oklahoma,1996,5,1581879,63.8,1518871,61.3,63008,4.0
Oregon,1996,5,1711412,68.6,1616462,64.8,94950,5.5
Pennsylvania,1996,5,5971366,63.5,5639387,60.0,331979,5.6
Rhode Island,1996,5,516797,65.5,490510,62.2,26287,5.1
South Carolina,1996,5,1877387,66.0,1769715,62.2,107672,5.7
South Dakota,1996,5,390133,71.6,377042,69.2,13091,3.4
Tennessee,1996,5,2753341,66.5,2614483,63.2,138858,5.0
Texas,1996,5,9694535,69.1,9131506,65.1,563029,5.8
Utah,1996,5,1037696,71.7,1002734,69.3,34962,3.4
Vermont,1996,5,324904,71.7,311055,68.7,13849,4.3
Virginia,1996,5,3432141,68.1,3282881,65.1,149260,4.3
Washington,1996,5,2885468,69.0,2710330,64.8,175138,6.1
West Virginia,1996,5,790577,55.0,730035,50.8,60542,7.7
Wisconsin,1996,5,2922075,74.0,2815259,71.3,106816,3.7
Wyoming,1996,5,254808,70.3,242149,66.8,12659,5.0
Alabama,1996,6,2088801,63.6,1980603,60.3,108198,5.2
Alaska,1996,6,308734,73.5,286038,68.1,22696,7.4
Arizona,1996,6,2287464,66.1,2159934,62.5,127530,5.6
Arkansas,1996,6,1238099,63.9,1173880,60.6,64219,5.2
California,1996,6,15378518,65.7,14246367,60.8,1132151,7.4
Los Angeles County,1996,6,4318305,64.6,3961681,59.3,356624,8.3
Colorado,1996,6,2159571,72.8,2066571,69.7,93000,4.3
Connecticut,1996,6,1747908,68.3,1657442,64.8,90466,5.2
Delaware,1996,6,389078,68.9,370256,65.5,18822,4.8
District of Columbia,1996,6,290012,63.9,265199,58.5,24813,8.6
Florida,1996,6,7166984,62.0,6788711,58.7,378273,5.3
Georgia,1996,6,3799143,68.0,3626867,65.0,172276,4.5
Hawaii,1996,6,594564,67.9,559683,63.9,34881,5.9
Idaho,1996,6,614870,70.0,581792,66.3,33078,5.4
Illinois,1996,6,6253741,68.7,5915743,65.0,337998,5.4
Indiana,1996,6,3102151,69.3,2976942,66.5,125209,4.0
Iowa,1996,6,1611398,73.5,1553039,70.9,58359,3.6
Kansas,1996,6,1367769,70.5,1308733,67.5,59036,4.3
Kentucky,1996,6,1866931,62.5,1769027,59.2,97904,5.2
Louisiana,1996,6,1988617,61.8,1860079,57.8,128538,6.5
Maine,1996,6,654414,68.0,619484,64.4,34930,5.3
Maryland,1996,6,2748132,71.2,2613416,67.7,134716,4.9
Massachusetts,1996,6,3233738,67.7,3085300,64.6,148438,4.6
Michigan,1996,6,4894836,66.5,4651696,63.2,243140,5.0
Minnesota,1996,6,2667212,75.4,2563681,72.5,103531,3.9
Mississippi,1996,6,1263788,62.4,1188016,58.7,75772,6.0
Missouri,1996,6,2895210,70.8,2757688,67.4,137522,4.7
Montana,1996,6,448493,67.2,423626,63.5,24867,5.5
Nebraska,1996,6,915331,73.5,890453,71.5,24878,2.7
Nevada,1996,6,892139,69.5,846796,66.0,45343,5.1
New Hampshire,1996,6,634742,71.0,610506,68.3,24236,3.8
New Jersey,1996,6,4178696,66.9,3922787,62.8,255909,6.1
New Mexico,1996,6,813414,63.5,751457,58.6,61957,7.6
New York,1996,6,8785657,61.7,8236441,57.9,549216,6.3
New York city,1996,6,3393778,56.9,3099141,52.0,294637,8.7
North Carolina,1996,6,3881392,67.9,3712115,65.0,169277,4.4
North Dakota,1996,6,347724,71.9,336837,69.6,10887,3.1
Ohio,1996,6,5673381,66.6,5390976,63.3,282405,5.0
Oklahoma,1996,6,1585357,63.9,1523725,61.4,61632,3.9
Oregon,1996,6,1714176,68.6,1619087,64.8,95089,5.5
Pennsylvania,1996,6,5983218,63.6,5658135,60.1,325083,5.4
Rhode Island,1996,6,517572,65.6,491716,62.3,25856,5.0
South Carolina,1996,6,1882857,66.1,1774094,62.3,108763,5.8
South Dakota,1996,6,390689,71.7,377757,69.3,12932,3.3
Tennessee,1996,6,2759318,66.5,2620964,63.2,138354,5.0
Texas,1996,6,9707126,69.1,9154959,65.1,552167,5.7
Utah,1996,6,1040462,71.7,1005647,69.3,34815,3.3
Vermont,1996,6,325352,71.8,311410,68.8,13942,4.3
Virginia,1996,6,3437543,68.1,3288238,65.1,149305,4.3
Washington,1996,6,2893260,69.1,2720076,64.9,173184,6.0
West Virginia,1996,6,790912,55.0,731470,50.9,59442,7.5
Wisconsin,1996,6,2924967,74.0,2819766,71.3,105201,3.6
Wyoming,1996,6,255079,70.3,242396,66.8,12683,5.0
Alabama,1996,7,2094676,63.7,1987805,60.5,106871,5.1
Alaska,1996,7,309136,73.4,286664,68.0,22472,7.3
Arizona,1996,7,2292487,66.1,2163604,62.4,128883,5.6
Arkansas,1996,7,1240051,63.9,1175855,60.6,64196,5.2
California,1996,7,15413793,65.8,14298555,61.0,1115238,7.2
Los Angeles County,1996,7,4327925,64.7,3977532,59.5,350393,8.1
Colorado,1996,7,2158069,72.6,2066257,69.5,91812,4.3
Connecticut,1996,7,1749691,68.4,1659456,64.9,90235,5.2
Delaware,1996,7,389661,68.8,370562,65.5,19099,4.9
District of Columbia,1996,7,289816,64.0,265325,58.6,24491,8.5
Florida,1996,7,7185019,62.0,6809786,58.8,375233,5.2
Georgia,1996,7,3815199,68.2,3642450,65.1,172749,4.5
Hawaii,1996,7,595248,67.8,560587,63.9,34661,5.8
Idaho,1996,7,616765,70.1,583952,66.4,32813,5.3
Illinois,1996,7,6257937,68.7,5922883,65.1,335054,5.4
Indiana,1996,7,3101086,69.2,2979735,66.5,121351,3.9
Iowa,1996,7,1612535,73.5,1554638,70.9,57897,3.6
Kansas,1996,7,1369822,70.6,1310864,67.5,58958,4.3
Kentucky,1996,7,1873575,62.7,1775948,59.4,97627,5.2
Louisiana,1996,7,1992597,61.9,1865013,57.9,127584,6.4
Maine,1996,7,655805,68.1,621347,64.5,34458,5.3
Maryland,1996,7,2755840,71.4,2622419,67.9,133421,4.8
Massachusetts,1996,7,3241652,67.8,3095626,64.7,146026,4.5
Michigan,1996,7,4904530,66.6,4662809,63.3,241721,4.9
Minnesota,1996,7,2670394,75.4,2567909,72.5,102485,3.8
Mississippi,1996,7,1265620,62.5,1191022,58.8,74598,5.9
Missouri,1996,7,2900097,70.9,2762797,67.5,137300,4.7
Montana,1996,7,449056,67.2,424476,63.5,24580,5.5
Nebraska,1996,7,916416,73.5,891731,71.5,24685,2.7
Nevada,1996,7,897098,69.6,851948,66.1,45150,5.0
New Hampshire,1996,7,636082,71.0,611817,68.3,24265,3.8
New Jersey,1996,7,4191350,67.1,3938556,63.0,252794,6.0
New Mexico,1996,7,814642,63.5,752859,58.6,61783,7.6
New York,1996,7,8805219,61.9,8261837,58.0,543382,6.2
New York city,1996,7,3402082,57.0,3107484,52.1,294598,8.7
North Carolina,1996,7,3892624,68.0,3725733,65.1,166891,4.3
North Dakota,1996,7,348244,72.0,337459,69.8,10785,3.1
Ohio,1996,7,5678388,66.6,5397360,63.3,281028,4.9
Oklahoma,1996,7,1588659,64.0,1527933,61.5,60726,3.8
Oregon,1996,7,1716492,68.6,1621352,64.8,95140,5.5
Pennsylvania,1996,7,5994307,63.7,5674695,60.3,319612,5.3
Rhode Island,1996,7,518482,65.7,492774,62.4,25708,5.0
South Carolina,1996,7,1888281,66.2,1779076,62.4,109205,5.8
South Dakota,1996,7,391175,71.6,378427,69.3,12748,3.3
Tennessee,1996,7,2766558,66.6,2627625,63.3,138933,5.0
Texas,1996,7,9723214,69.1,9180061,65.2,543153,5.6
Utah,1996,7,1043359,71.7,1008569,69.3,34790,3.3
Vermont,1996,7,325816,71.8,311791,68.7,14025,4.3
Virginia,1996,7,3442676,68.1,3293676,65.2,149000,4.3
Washington,1996,7,2900628,69.2,2729847,65.1,170781,5.9
West Virginia,1996,7,791251,55.0,732575,50.9,58676,7.4
Wisconsin,1996,7,2926717,74.0,2823380,71.4,103337,3.5
Wyoming,1996,7,255335,70.2,242651,66.7,12684,5.0
Alabama,1996,8,2100380,63.9,1994400,60.6,105980,5.0
Alaska,1996,8,309475,73.5,287120,68.1,22355,7.2
Arizona,1996,8,2297155,66.0,2167534,62.3,129621,5.6
Arkansas,1996,8,1241579,63.9,1177368,60.6,64211,5.2
California,1996,8,15450920,65.8,14349188,61.1,1101732,7.1
Los Angeles County,1996,8,4338323,64.8,3993586,59.7,344737,7.9
Colorado,1996,8,2156662,72.4,2066514,69.4,90148,4.2
Connecticut,1996,8,1751868,68.4,1661570,64.9,90298,5.2
Delaware,1996,8,390242,68.9,370725,65.5,19517,5.0
District of Columbia,1996,8,289856,64.0,265701,58.6,24155,8.3
Florida,1996,8,7204630,62.1,6831668,58.9,372962,5.2
Georgia,1996,8,3831441,68.3,3657316,65.2,174125,4.5
Hawaii,1996,8,596149,67.9,561464,63.9,34685,5.8
Idaho,1996,8,619133,70.2,586364,66.5,32769,5.3
Illinois,1996,8,6260158,68.7,5929616,65.1,330542,5.3
Indiana,1996,8,3099894,69.1,2982368,66.5,117526,3.8
Iowa,1996,8,1613494,73.5,1555973,70.9,57521,3.6
Kansas,1996,8,1371832,70.6,1313059,67.6,58773,4.3
Kentucky,1996,8,1881019,62.9,1782396,59.6,98623,5.2
Louisiana,1996,8,1996572,62.0,1869723,58.0,126849,6.4
Maine,1996,8,657153,68.2,623133,64.6,34020,5.2
Maryland,1996,8,2762682,71.5,2629958,68.1,132724,4.8
Massachusetts,1996,8,3248883,67.9,3104632,64.9,144251,4.4
Michigan,1996,8,4913165,66.7,4673292,63.4,239873,4.9
Minnesota,1996,8,2672626,75.3,2571408,72.5,101218,3.8
Mississippi,1996,8,1267133,62.5,1193441,58.8,73692,5.8
Missouri,1996,8,2904566,70.9,2767234,67.6,137332,4.7
Montana,1996,8,449595,67.3,425237,63.6,24358,5.4
Nebraska,1996,8,917253,73.5,892797,71.5,24456,2.7
Nevada,1996,8,902027,69.7,857042,66.2,44985,5.0
New Hampshire,1996,8,637579,71.1,613379,68.4,24200,3.8
New Jersey,1996,8,4203926,67.2,3953044,63.2,250882,6.0
New Mexico,1996,8,815732,63.5,754244,58.7,61488,7.5
New York,1996,8,8824631,62.0,8285611,58.2,539020,6.1
New York city,1996,8,3411220,57.1,3115419,52.2,295801,8.7
North Carolina,1996,8,3902519,68.0,3737821,65.2,164698,4.2
North Dakota,1996,8,348591,72.1,337849,69.8,10742,3.1
Ohio,1996,8,5679513,66.6,5399825,63.3,279688,4.9
Oklahoma,1996,8,1591889,64.0,1531251,61.6,60638,3.8
Oregon,1996,8,1718844,68.5,1623220,64.7,95624,5.6
Pennsylvania,1996,8,6004912,63.8,5688691,60.4,316221,5.3
Rhode Island,1996,8,519614,65.8,493721,62.5,25893,5.0
South Carolina,1996,8,1893717,66.3,1784529,62.5,109188,5.8
South Dakota,1996,8,391585,71.7,378970,69.4,12615,3.2
Tennessee,1996,8,2773772,66.7,2633091,63.3,140681,5.1
Texas,1996,8,9743203,69.1,9205783,65.3,537420,5.5
Utah,1996,8,1046331,71.7,1011392,69.3,34939,3.3
Vermont,1996,8,326301,71.9,312177,68.8,14124,4.3
Virginia,1996,8,3447091,68.1,3298486,65.2,148605,4.3
Washington,1996,8,2907610,69.2,2739193,65.2,168417,5.8
West Virginia,1996,8,791688,55.1,733309,51.0,58379,7.4
Wisconsin,1996,8,2927826,73.9,2826042,71.4,101784,3.5
Wyoming,1996,8,255591,70.3,242870,66.8,12721,5.0
Alabama,1996,9,2105533,64.0,1999611,60.8,105922,5.0
Alaska,1996,9,309764,73.5,287406,68.2,22358,7.2
Arizona,1996,9,2300511,65.9,2170843,62.2,129668,5.6
Arkansas,1996,9,1242165,63.9,1177866,60.6,64299,5.2
California,1996,9,15487870,65.9,14394854,61.2,1093016,7.1
Los Angeles County,1996,9,4348197,64.9,4007781,59.8,340416,7.8
Colorado,1996,9,2155858,72.2,2067518,69.2,88340,4.1
Connecticut,1996,9,1754095,68.5,1663398,64.9,90697,5.2
Delaware,1996,9,390829,68.9,370906,65.4,19923,5.1
District of Columbia,1996,9,289898,64.0,266018,58.8,23880,8.2
Florida,1996,9,7224607,62.1,6852347,58.9,372260,5.2
Georgia,1996,9,3846976,68.4,3670178,65.3,176798,4.6
Hawaii,1996,9,597251,67.9,562311,63.9,34940,5.9
Idaho,1996,9,621652,70.3,588718,66.6,32934,5.3
Illinois,1996,9,6260730,68.7,5935096,65.1,325634,5.2
Indiana,1996,9,3098452,69.0,2984655,66.5,113797,3.7
Iowa,1996,9,1613953,73.5,1556656,70.9,57297,3.6
Kansas,1996,9,1373726,70.7,1315044,67.6,58682,4.3
Kentucky,1996,9,1888306,63.1,1787476,59.7,100830,5.3
Louisiana,1996,9,1999644,62.0,1873493,58.1,126151,6.3
Maine,1996,9,658220,68.2,624451,64.7,33769,5.1
Maryland,1996,9,2767203,71.5,2634728,68.1,132475,4.8
Massachusetts,1996,9,3255704,68.0,3112392,65.0,143312,4.4
Michigan,1996,9,4919969,66.7,4681639,63.5,238330,4.8
Minnesota,1996,9,2673371,75.3,2573445,72.5,99926,3.7
Mississippi,1996,9,1268247,62.5,1194947,58.9,73300,5.8
Missouri,1996,9,2908771,70.9,2770774,67.6,137997,4.7
Montana,1996,9,449994,67.2,425754,63.6,24240,5.4
Nebraska,1996,9,917705,73.4,893429,71.5,24276,2.6
Nevada,1996,9,906675,69.7,861847,66.3,44828,4.9
New Hampshire,1996,9,639073,71.2,615016,68.5,24057,3.8
New Jersey,1996,9,4215628,67.3,3965071,63.3,250557,5.9
New Mexico,1996,9,816424,63.4,755401,58.7,61023,7.5
New York,1996,9,8844615,62.1,8305179,58.3,539436,6.1
New York city,1996,9,3422687,57.3,3122737,52.2,299950,8.8
North Carolina,1996,9,3910992,68.1,3748350,65.2,162642,4.2
North Dakota,1996,9,348722,71.9,337965,69.7,10757,3.1
Ohio,1996,9,5678114,66.5,5398669,63.3,279445,4.9
Oklahoma,1996,9,1594801,64.1,1533530,61.6,61271,3.8
Oregon,1996,9,1721096,68.5,1624451,64.7,96645,5.6
Pennsylvania,1996,9,6014550,63.9,5699735,60.5,314815,5.2
Rhode Island,1996,9,520882,65.9,494525,62.6,26357,5.1
South Carolina,1996,9,1899012,66.4,1789972,62.6,109040,5.7
South Dakota,1996,9,391854,71.6,379294,69.3,12560,3.2
Tennessee,1996,9,2779011,66.7,2635714,63.3,143297,5.2
Texas,1996,9,9765578,69.1,9229227,65.3,536351,5.5
Utah,1996,9,1049068,71.7,1013851,69.3,35217,3.4
Vermont,1996,9,326729,71.8,312498,68.7,14231,4.4
Virginia,1996,9,3450325,68.1,3301840,65.1,148485,4.3
Washington,1996,9,2913717,69.2,2747445,65.3,166272,5.7
West Virginia,1996,9,792118,55.1,733614,51.0,58504,7.4
Wisconsin,1996,9,2928299,73.9,2827328,71.3,100971,3.4
Wyoming,1996,9,255805,70.3,242970,66.8,12835,5.0
Alabama,1996,10,2109820,64.1,2003211,60.8,106609,5.1
Alaska,1996,10,309997,73.4,287523,68.1,22474,7.2
Arizona,1996,10,2301884,65.7,2172736,62.1,129148,5.6
Arkansas,1996,10,1241684,63.8,1177156,60.5,64528,5.2
California,1996,10,15522838,65.9,14433664,61.3,1089174,7.0
Los Angeles County,1996,10,4356494,65.0,4018702,59.9,337792,7.8
Colorado,1996,10,2156228,72.0,2069602,69.1,86626,4.0
Connecticut,1996,10,1755949,68.5,1664570,65.0,91379,5.2
Delaware,1996,10,391302,68.9,371161,65.3,20141,5.1
District of Columbia,1996,10,289734,64.0,266062,58.7,23672,8.2
Florida,1996,10,7242446,62.2,6869526,59.0,372920,5.1
Georgia,1996,10,3860928,68.5,3680440,65.3,180488,4.7
Hawaii,1996,10,598469,67.9,563088,63.9,35381,5.9
Idaho,1996,10,623834,70.5,590614,66.7,33220,5.3
Illinois,1996,10,6260526,68.6,5938392,65.1,322134,5.1
Indiana,1996,10,3096852,68.9,2986143,66.5,110709,3.6
Iowa,1996,10,1613564,73.4,1556330,70.8,57234,3.5
Kansas,1996,10,1375174,70.7,1316465,67.7,58709,4.3
Kentucky,1996,10,1894595,63.3,1790698,59.8,103897,5.5
Louisiana,1996,10,2001414,62.0,1875790,58.1,125624,6.3
Maine,1996,10,658876,68.3,625092,64.8,33784,5.1
Maryland,1996,10,2769061,71.5,2636344,68.1,132717,4.8
Massachusetts,1996,10,3262348,68.0,3119083,65.1,143265,4.4
Michigan,1996,10,4924303,66.7,4687127,63.5,237176,4.8
Minnesota,1996,10,2672462,75.1,2573904,72.4,98558,3.7
Mississippi,1996,10,1269092,62.4,1195569,58.8,73523,5.8
Missouri,1996,10,2912434,70.9,2773299,67.5,139135,4.8
Montana,1996,10,450171,67.2,425920,63.5,24251,5.4
Nebraska,1996,10,917729,73.4,893517,71.4,24212,2.6
Nevada,1996,10,910898,69.8,866234,66.3,44664,4.9
New Hampshire,1996,10,640437,71.3,616542,68.6,23895,3.7
New Jersey,1996,10,4225559,67.4,3974305,63.4,251254,5.9
New Mexico,1996,10,816644,63.4,756165,58.7,60479,7.4
New York,1996,10,8865107,62.2,8319379,58.4,545728,6.2
New York city,1996,10,3436557,57.4,3129314,52.3,307243,8.9
North Carolina,1996,10,3919081,68.1,3757565,65.3,161516,4.1
North Dakota,1996,10,348639,71.9,337853,69.7,10786,3.1
Ohio,1996,10,5676161,66.5,5394951,63.2,281210,5.0
Oklahoma,1996,10,1597268,64.1,1534821,61.6,62447,3.9
Oregon,1996,10,1723032,68.5,1624893,64.6,98139,5.7
Pennsylvania,1996,10,6023142,63.9,5707604,60.6,315538,5.2
Rhode Island,1996,10,522114,66.0,495130,62.6,26984,5.2
South Carolina,1996,10,1903963,66.5,1795024,62.7,108939,5.7
South Dakota,1996,10,391912,71.6,379371,69.3,12541,3.2
Tennessee,1996,10,2781322,66.7,2634775,63.1,146547,5.3
Texas,1996,10,9788916,69.1,9247692,65.3,541224,5.5
Utah,1996,10,1051344,71.7,1015799,69.3,35545,3.4
Vermont,1996,10,327061,71.9,312724,68.7,14337,4.4
Virginia,1996,10,3452625,68.0,3303569,65.1,149056,4.3
Washington,1996,10,2918883,69.2,2754351,65.3,164532,5.6
West Virginia,1996,10,792447,55.1,733544,51.0,58903,7.4
Wisconsin,1996,10,2928057,73.8,2826887,71.3,101170,3.5
Wyoming,1996,10,255906,70.4,242901,66.8,13005,5.1
Alabama,1996,11,2113270,64.1,2005595,60.8,107675,5.1
Alaska,1996,11,310169,73.5,287511,68.1,22658,7.3
Arizona,1996,11,2301360,65.5,2173399,61.9,127961,5.6
Arkansas,1996,11,1240505,63.6,1175717,60.3,64788,5.2
California,1996,11,15555852,66.0,14468388,61.3,1087464,7.0
Los Angeles County,1996,11,4363479,65.0,4027248,60.0,336231,7.7
Colorado,1996,11,2158691,72.0,2073607,69.1,85084,3.9
Connecticut,1996,11,1757192,68.5,1665146,65.0,92046,5.2
Delaware,1996,11,391546,68.9,371498,65.4,20048,5.1
District of Columbia,1996,11,289350,64.0,265853,58.8,23497,8.1
Florida,1996,11,7257425,62.2,6882913,59.0,374512,5.2
Georgia,1996,11,3873119,68.6,3688933,65.3,184186,4.8
Hawaii,1996,11,599677,68.0,563810,63.9,35867,6.0
Idaho,1996,11,625483,70.5,591980,66.7,33503,5.4
Illinois,1996,11,6260775,68.6,5939981,65.1,320794,5.1
Indiana,1996,11,3095827,68.9,2987240,66.5,108587,3.5
Iowa,1996,11,1612025,73.3,1554813,70.7,57212,3.5
Kansas,1996,11,1376099,70.6,1317432,67.6,58667,4.3
Kentucky,1996,11,1899474,63.4,1792512,59.8,106962,5.6
Louisiana,1996,11,2001962,62.0,1876862,58.1,125100,6.2
Maine,1996,11,659196,68.2,625079,64.7,34117,5.2
Maryland,1996,11,2768990,71.5,2635678,68.0,133312,4.8
Massachusetts,1996,11,3269198,68.1,3125493,65.1,143705,4.4
Michigan,1996,11,4926768,66.7,4690772,63.5,235996,4.8
Minnesota,1996,11,2670491,75.0,2573406,72.3,97085,3.6
Mississippi,1996,11,1269777,62.4,1195633,58.8,74144,5.8
Missouri,1996,11,2915579,70.9,2775547,67.5,140032,4.8
Montana,1996,11,450153,67.2,425756,63.5,24397,5.4
Nebraska,1996,11,917486,73.3,893306,71.3,24180,2.6
Nevada,1996,11,914796,69.7,870394,66.3,44402,4.9
New Hampshire,1996,11,641672,71.3,617917,68.7,23755,3.7
New Jersey,1996,11,4233437,67.5,3981783,63.5,251654,5.9
New Mexico,1996,11,816530,63.3,756660,58.7,59870,7.3
New York,1996,11,8885637,62.3,8329339,58.4,556298,6.3
New York city,1996,11,3451500,57.6,3135007,52.4,316493,9.2
North Carolina,1996,11,3927512,68.1,3766600,65.3,160912,4.1
North Dakota,1996,11,348464,71.9,337706,69.6,10758,3.1
Ohio,1996,11,5675960,66.5,5391374,63.1,284586,5.0
Oklahoma,1996,11,1599295,64.1,1535517,61.6,63778,4.0
Oregon,1996,11,1724800,68.5,1624825,64.5,99975,5.8
Pennsylvania,1996,11,6030338,64.0,5712788,60.6,317550,5.3
Rhode Island,1996,11,523278,66.1,495626,62.6,27652,5.3
South Carolina,1996,11,1908527,66.5,1799836,62.7,108691,5.7
South Dakota,1996,11,391828,71.6,379316,69.3,12512,3.2
Tennessee,1996,11,2781600,66.6,2631734,63.0,149866,5.4
Texas,1996,11,9811341,69.2,9261290,65.3,550051,5.6
Utah,1996,11,1053253,71.7,1017494,69.3,35759,3.4
Vermont,1996,11,327277,71.8,312867,68.6,14410,4.4
Virginia,1996,11,3454630,68.0,3304399,65.0,150231,4.3
Washington,1996,11,2923366,69.2,2760292,65.3,163074,5.6
West Virginia,1996,11,792653,55.1,733345,51.0,59308,7.5
Wisconsin,1996,11,2927495,73.7,2825083,71.1,102412,3.5
Wyoming,1996,11,255878,70.1,242725,66.5,13153,5.1
Alabama,1996,12,2116205,64.2,2007664,60.9,108541,5.1
Alaska,1996,12,310387,73.5,287553,68.1,22834,7.4
Arizona,1996,12,2299423,65.3,2173660,61.7,125763,5.5
Arkansas,1996,12,1239275,63.5,1174469,60.2,64806,5.2
California,1996,12,15587392,66.0,14503984,61.4,1083408,7.0
Los Angeles County,1996,12,4370159,65.0,4035846,60.1,334313,7.6
Colorado,1996,12,2163231,72.0,2079715,69.2,83516,3.9
Connecticut,1996,12,1757704,68.6,1665438,65.0,92266,5.2
Delaware,1996,12,391512,68.8,371847,65.3,19665,5.0
District of Columbia,1996,12,288761,63.9,265472,58.8,23289,8.1
Florida,1996,12,7270824,62.2,6895033,59.0,375791,5.2
Georgia,1996,12,3883735,68.7,3697120,65.4,186615,4.8
Hawaii,1996,12,600662,68.0,564450,63.9,36212,6.0
Idaho,1996,12,626612,70.5,592965,66.7,33647,5.4
Illinois,1996,12,6262090,68.6,5941826,65.1,320264,5.1
Indiana,1996,12,3095874,68.8,2988733,66.5,107141,3.5
Iowa,1996,12,1609602,73.2,1552659,70.6,56943,3.5
Kansas,1996,12,1376638,70.6,1318336,67.6,58302,4.2
Kentucky,1996,12,1902980,63.5,1793932,59.9,109048,5.7
Louisiana,1996,12,2001668,61.9,1877367,58.1,124301,6.2
Maine,1996,12,659368,68.2,624688,64.6,34680,5.3
Maryland,1996,12,2768191,71.4,2634273,68.0,133918,4.8
Massachusetts,1996,12,3276203,68.2,3132290,65.2,143913,4.4
Michigan,1996,12,4928399,66.7,4694532,63.6,233867,4.7
Minnesota,1996,12,2668540,74.9,2572976,72.2,95564,3.6
Mississippi,1996,12,1270328,62.4,1195760,58.7,74568,5.9
Missouri,1996,12,2918140,71.0,2778392,67.6,139748,4.8
Montana,1996,12,450052,67.1,425445,63.4,24607,5.5
Nebraska,1996,12,917197,73.2,893175,71.3,24022,2.6
Nevada,1996,12,918574,69.7,874636,66.4,43938,4.8
New Hampshire,1996,12,642930,71.4,619325,68.7,23605,3.7
New Jersey,1996,12,4239388,67.6,3989108,63.6,250280,5.9
New Mexico,1996,12,816265,63.2,757185,58.7,59080,7.2
New York,1996,12,8906168,62.4,8338342,58.4,567826,6.4
New York city,1996,12,3465943,57.8,3140304,52.4,325639,9.4
North Carolina,1996,12,3936421,68.2,3776388,65.4,160033,4.1
North Dakota,1996,12,348379,71.8,337686,69.6,10693,3.1
Ohio,1996,12,5678460,66.5,5390556,63.1,287904,5.1
Oklahoma,1996,12,1600852,64.1,1536182,61.5,64670,4.0
Oregon,1996,12,1726466,68.4,1624996,64.4,101470,5.9
Pennsylvania,1996,12,6036201,64.1,5716802,60.7,319399,5.3
Rhode Island,1996,12,524409,66.2,496171,62.6,28238,5.4
South Carolina,1996,12,1912501,66.6,1804725,62.8,107776,5.6
South Dakota,1996,12,391744,71.6,379313,69.3,12431,3.2
Tennessee,1996,12,2781341,66.5,2629112,62.8,152229,5.5
Texas,1996,12,9830983,69.2,9272462,65.3,558521,5.7
Utah,1996,12,1055025,71.6,1019340,69.2,35685,3.4
Vermont,1996,12,327402,71.8,312995,68.6,14407,4.4
Virginia,1996,12,3456766,68.0,3305490,65.0,151276,4.4
Washington,1996,12,2927542,69.2,2766267,65.4,161275,5.5
West Virginia,1996,12,792499,55.1,733141,51.0,59358,7.5
Wisconsin,1996,12,2927299,73.7,2823237,71.1,104062,3.6
Wyoming,1996,12,255770,70.1,242548,66.5,13222,5.2
Alabama,1997,1,2118833,64.2,2009942,60.9,108891,5.1
Alaska,1997,1,310662,73.6,287746,68.1,22916,7.4
Arizona,1997,1,2296685,65.0,2174126,61.5,122559,5.3
Arkansas,1997,1,1238426,63.4,1173905,60.1,64521,5.2
California,1997,1,15618081,66.0,14543009,61.5,1075072,6.9
Los Angeles County,1997,1,4377240,65.1,4045986,60.2,331254,7.6
Colorado,1997,1,2168878,72.0,2087271,69.3,81607,3.8
Connecticut,1997,1,1757646,68.5,1665799,65.0,91847,5.2
Delaware,1997,1,391272,68.6,372127,65.2,19145,4.9
District of Columbia,1997,1,287986,63.7,264951,58.6,23035,8.0
Florida,1997,1,7284573,62.2,6908554,59.0,376019,5.2
Georgia,1997,1,3893440,68.7,3706215,65.4,187225,4.8
Hawaii,1997,1,601288,68.0,564924,63.9,36364,6.0
Idaho,1997,1,627482,70.4,593829,66.6,33653,5.4
Illinois,1997,1,6264684,68.6,5945892,65.1,318792,5.1
Indiana,1997,1,3097220,68.8,2991013,66.5,106207,3.4
Iowa,1997,1,1607063,73.1,1550766,70.5,56297,3.5
Kansas,1997,1,1376980,70.6,1319421,67.7,57559,4.2
Kentucky,1997,1,1905243,63.5,1795583,59.9,109660,5.8
Louisiana,1997,1,2001102,61.9,1877683,58.0,123419,6.2
Maine,1997,1,659521,68.1,624212,64.5,35309,5.4
Maryland,1997,1,2767733,71.4,2633334,67.9,134399,4.9
Massachusetts,1997,1,3283299,68.3,3139784,65.4,143515,4.4
Michigan,1997,1,4929741,66.7,4699501,63.6,230240,4.7
Minnesota,1997,1,2667432,74.8,2573237,72.1,94195,3.5
Mississippi,1997,1,1270737,62.4,1196201,58.7,74536,5.9
Missouri,1997,1,2919921,70.9,2782121,67.6,137800,4.7
Montana,1997,1,449999,67.1,425175,63.4,24824,5.5
Nebraska,1997,1,917061,73.1,893314,71.3,23747,2.6
Nevada,1997,1,922463,69.7,879117,66.4,43346,4.7
New Hampshire,1997,1,644398,71.4,620966,68.8,23432,3.6
New Jersey,1997,1,4243424,67.6,3996558,63.6,246866,5.8
New Mexico,1997,1,816099,63.2,757945,58.7,58154,7.1
New York,1997,1,8927761,62.6,8349931,58.5,577830,6.5
New York city,1997,1,3478992,58.0,3145785,52.5,333207,9.6
North Carolina,1997,1,3945342,68.2,3786572,65.5,158770,4.0
North Dakota,1997,1,348481,71.8,337795,69.6,10686,3.1
Ohio,1997,1,5683545,66.5,5394515,63.2,289030,5.1
Oklahoma,1997,1,1601959,64.1,1536981,61.5,64978,4.1
Oregon,1997,1,1728097,68.4,1626081,64.3,102016,5.9
Pennsylvania,1997,1,6040661,64.1,5720280,60.7,320381,5.3
Rhode Island,1997,1,525549,66.3,496836,62.7,28713,5.5
South Carolina,1997,1,1915773,66.6,1809872,62.9,105901,5.5
South Dakota,1997,1,391774,71.6,379491,69.3,12283,3.1
Tennessee,1997,1,2781307,66.4,2628136,62.7,153171,5.5
Texas,1997,1,9847371,69.2,9283773,65.3,563598,5.7
Utah,1997,1,1056851,71.6,1021529,69.3,35322,3.3
Vermont,1997,1,327498,71.7,313187,68.5,14311,4.4
Virginia,1997,1,3459125,67.9,3307659,65.0,151466,4.4
Washington,1997,1,2932060,69.2,2773291,65.4,158769,5.4
West Virginia,1997,1,791866,55.1,732977,51.0,58889,7.4
Wisconsin,1997,1,2928223,73.7,2822608,71.0,105615,3.6
Wyoming,1997,1,255643,70.1,242430,66.5,13213,5.2
Alabama,1997,2,2121101,64.3,2012414,61.0,108687,5.1
Alaska,1997,2,310956,73.6,288118,68.2,22838,7.3
Arizona,1997,2,2294012,64.8,2175360,61.4,118652,5.2
Arkansas,1997,2,1238133,63.3,1174040,60.0,64093,5.2
California,1997,2,15648451,66.1,14586270,61.6,1062181,6.8
Los Angeles County,1997,2,4385289,65.2,4058515,60.3,326774,7.5
Colorado,1997,2,2175382,72.1,2096135,69.5,79247,3.6
Connecticut,1997,2,1757626,68.6,1666824,65.0,90802,5.2
Delaware,1997,2,390974,68.5,372302,65.3,18672,4.8
District of Columbia,1997,2,287113,63.6,264330,58.6,22783,7.9
Florida,1997,2,7300060,62.2,6925178,59.0,374882,5.1
Georgia,1997,2,3902864,68.7,3716822,65.5,186042,4.8
Hawaii,1997,2,601521,68.0,565180,63.9,36341,6.0
Idaho,1997,2,628378,70.4,594845,66.7,33533,5.3
Illinois,1997,2,6267959,68.6,5952698,65.1,315261,5.0
Indiana,1997,2,3100416,68.9,2994801,66.6,105615,3.4
Iowa,1997,2,1605070,73.0,1549862,70.4,55208,3.4
Kansas,1997,2,1377245,70.6,1320782,67.7,56463,4.1
Kentucky,1997,2,1906487,63.6,1797765,60.0,108722,5.7
Louisiana,1997,2,2000916,61.8,1878194,58.0,122722,6.1
Maine,1997,2,659627,68.1,623823,64.4,35804,5.4
Maryland,1997,2,2768295,71.4,2633621,67.9,134674,4.9
Massachusetts,1997,2,3290677,68.5,3148222,65.5,142455,4.3
Michigan,1997,2,4931402,66.7,4706072,63.7,225330,4.6
Minnesota,1997,2,2667672,74.7,2574818,72.1,92854,3.5
Mississippi,1997,2,1270854,62.3,1196854,58.7,74000,5.8
Missouri,1997,2,2920921,70.9,2786563,67.7,134358,4.6
Montana,1997,2,450082,67.0,425084,63.2,24998,5.6
Nebraska,1997,2,917104,73.1,893750,71.3,23354,2.5
Nevada,1997,2,926624,69.7,883885,66.5,42739,4.6
New Hampshire,1997,2,646243,71.5,622987,69.0,23256,3.6
New Jersey,1997,2,4246241,67.6,4004197,63.7,242044,5.7
New Mexico,1997,2,816243,63.1,759096,58.7,57147,7.0
New York,1997,2,8951227,62.7,8366322,58.6,584905,6.5
New York city,1997,2,3490297,58.2,3151907,52.6,338390,9.7
North Carolina,1997,2,3953675,68.3,3796358,65.6,157317,4.0
North Dakota,1997,2,348713,71.9,337959,69.7,10754,3.1
Ohio,1997,2,5689993,66.6,5403581,63.3,286412,5.0
Oklahoma,1997,2,1602824,64.1,1537996,61.5,64828,4.0
Oregon,1997,2,1729946,68.4,1628508,64.4,101438,5.9
Pennsylvania,1997,2,6043710,64.2,5723251,60.8,320459,5.3
Rhode Island,1997,2,526809,66.5,497741,62.8,29068,5.5
South Carolina,1997,2,1918281,66.6,1815281,63.0,103000,5.4
South Dakota,1997,2,391971,71.6,379908,69.4,12063,3.1
Tennessee,1997,2,2781764,66.3,2628737,62.7,153027,5.5
Texas,1997,2,9861005,69.2,9296775,65.3,564230,5.7
Utah,1997,2,1058845,71.7,1024095,69.3,34750,3.3
Vermont,1997,2,327684,71.7,313569,68.6,14115,4.3
Virginia,1997,2,3461445,68.0,3311228,65.0,150217,4.3
Washington,1997,2,2937816,69.2,2781978,65.6,155838,5.3
West Virginia,1997,2,790969,55.0,732978,51.0,57991,7.3
Wisconsin,1997,2,2930448,73.7,2823931,71.0,106517,3.6
Wyoming,1997,2,255565,70.0,242450,66.5,13115,5.1
Alabama,1997,3,2123294,64.3,2015220,61.0,108074,5.1
Alaska,1997,3,311268,73.5,288670,68.2,22598,7.3
Arizona,1997,3,2292360,64.6,2178046,61.3,114314,5.0
Arkansas,1997,3,1238454,63.3,1174772,60.0,63682,5.1
California,1997,3,15680435,66.2,14634967,61.7,1045468,6.7
Los Angeles County,1997,3,4395188,65.3,4074264,60.5,320924,7.3
Colorado,1997,3,2183120,72.2,2106429,69.7,76691,3.5
Connecticut,1997,3,1758243,68.6,1669001,65.1,89242,5.1
Delaware,1997,3,390869,68.5,372512,65.3,18357,4.7
District of Columbia,1997,3,286319,63.5,263751,58.5,22568,7.9
Florida,1997,3,7318632,62.3,6946428,59.1,372204,5.1
Georgia,1997,3,3912784,68.8,3729387,65.6,183397,4.7
Hawaii,1997,3,601516,67.9,565322,63.8,36194,6.0
Idaho,1997,3,629435,70.5,596129,66.8,33306,5.3
Illinois,1997,3,6271910,68.6,5962689,65.2,309221,4.9
Indiana,1997,3,3105925,69.0,3000701,66.7,105224,3.4
Iowa,1997,3,1603710,72.9,1550005,70.4,53705,3.3
Kansas,1997,3,1377729,70.6,1322684,67.8,55045,4.0
Kentucky,1997,3,1907202,63.6,1800548,60.0,106654,5.6
Louisiana,1997,3,2001606,61.8,1879419,58.1,122187,6.1
Maine,1997,3,659674,68.1,623708,64.4,35966,5.5
Maryland,1997,3,2769946,71.4,2635564,67.9,134382,4.9
Massachusetts,1997,3,3298009,68.6,3157189,65.7,140820,4.3
Michigan,1997,3,4934323,66.8,4714922,63.8,219401,4.4
Minnesota,1997,3,2669715,74.7,2578320,72.2,91395,3.4
Mississippi,1997,3,1270775,62.3,1197697,58.7,73078,5.8
Missouri,1997,3,2921676,70.9,2791739,67.8,129937,4.4
Montana,1997,3,450362,67.0,425297,63.3,25065,5.6
Nebraska,1997,3,917402,73.1,894544,71.3,22858,2.5
Nevada,1997,3,931123,69.8,889000,66.6,42123,4.5
New Hampshire,1997,3,648530,71.7,625445,69.2,23085,3.6
New Jersey,1997,3,4248560,67.6,4012049,63.8,236511,5.6
New Mexico,1997,3,816796,63.1,760818,58.8,55978,6.9
New York,1997,3,8976127,62.9,8387881,58.8,588246,6.6
New York city,1997,3,3500022,58.3,3159295,52.7,340727,9.7
North Carolina,1997,3,3960615,68.3,3804846,65.6,155769,3.9
North Dakota,1997,3,348992,71.9,338148,69.7,10844,3.1
Ohio,1997,3,5696494,66.7,5416850,63.4,279644,4.9
Oklahoma,1997,3,1603765,64.1,1539398,61.5,64367,4.0
Oregon,1997,3,1732231,68.4,1632358,64.5,99873,5.8
Pennsylvania,1997,3,6046416,64.2,5726875,60.8,319541,5.3
Rhode Island,1997,3,528286,66.7,499023,63.0,29263,5.5
South Carolina,1997,3,1920333,66.6,1821052,63.2,99281,5.2
South Dakota,1997,3,392381,71.6,380586,69.5,11795,3.0
Tennessee,1997,3,2782361,66.3,2630083,62.6,152278,5.5
Texas,1997,3,9873434,69.2,9313064,65.3,560370,5.7
Utah,1997,3,1061136,71.6,1027071,69.3,34065,3.2
Vermont,1997,3,328079,71.8,314251,68.7,13828,4.2
Virginia,1997,3,3463678,67.9,3316310,65.0,147368,4.3
Washington,1997,3,2945081,69.3,2792364,65.7,152717,5.2
West Virginia,1997,3,790117,55.0,733275,51.0,56842,7.2
Wisconsin,1997,3,2934064,73.7,2827691,71.1,106373,3.6
Wyoming,1997,3,255600,70.1,242681,66.5,12919,5.1
Alabama,1997,4,2126031,64.4,2018538,61.1,107493,5.1
Alaska,1997,4,311654,73.6,289360,68.4,22294,7.2
Arizona,1997,4,2292434,64.4,2182243,61.3,110191,4.8
Arkansas,1997,4,1239305,63.3,1175769,60.0,63536,5.1
California,1997,4,15717198,66.2,14687711,61.9,1029487,6.6
Los Angeles County,1997,4,4407471,65.4,4092390,60.7,315081,7.1
Colorado,1997,4,2191865,72.4,2117439,69.9,74426,3.4
Connecticut,1997,4,1759648,68.6,1672122,65.2,87526,5.0
Delaware,1997,4,390197,68.3,372877,65.2,17320,4.4
District of Columbia,1997,4,285955,63.4,263461,58.4,22494,7.9
Florida,1997,4,7341282,62.4,6972024,59.2,369258,5.0
Georgia,1997,4,3923810,68.9,3743378,65.7,180432,4.6
Hawaii,1997,4,601598,67.9,565495,63.8,36103,6.0
Idaho,1997,4,630686,70.5,597592,66.8,33094,5.2
Illinois,1997,4,6277711,68.6,5975522,65.3,302189,4.8
Indiana,1997,4,3113224,69.1,3007930,66.8,105294,3.4
Iowa,1997,4,1602941,72.8,1550783,70.5,52158,3.3
Kansas,1997,4,1378668,70.6,1325074,67.8,53594,3.9
Kentucky,1997,4,1908130,63.6,1803770,60.1,104360,5.5
Louisiana,1997,4,2003229,61.8,1881402,58.1,121827,6.1
Maine,1997,4,659763,68.1,623988,64.4,35775,5.4
Maryland,1997,4,2772448,71.4,2638587,68.0,133861,4.8
Massachusetts,1997,4,3304528,68.7,3165396,65.8,139132,4.2
Michigan,1997,4,4939894,66.8,4725944,63.9,213950,4.3
Minnesota,1997,4,2673857,74.8,2583835,72.3,90022,3.4
Mississippi,1997,4,1270939,62.2,1198595,58.7,72344,5.7
Missouri,1997,4,2923148,70.9,2797228,67.8,125920,4.3
Montana,1997,4,450843,67.1,425795,63.4,25048,5.6
Nebraska,1997,4,918020,73.1,895547,71.3,22473,2.4
Nevada,1997,4,935972,69.8,894359,66.7,41613,4.4
New Hampshire,1997,4,651131,71.9,628192,69.4,22939,3.5
New Jersey,1997,4,4251096,67.6,4019427,63.9,231669,5.4
New Mexico,1997,4,817833,63.1,763046,58.9,54787,6.7
New York,1997,4,9002152,63.1,8412593,58.9,589559,6.5
New York city,1997,4,3509453,58.5,3168222,52.8,341231,9.7
North Carolina,1997,4,3965726,68.3,3811289,65.6,154437,3.9
North Dakota,1997,4,349250,72.0,338334,69.7,10916,3.1
Ohio,1997,4,5703263,66.8,5432665,63.6,270598,4.7
Oklahoma,1997,4,1604942,64.1,1540977,61.6,63965,4.0
Oregon,1997,4,1735351,68.4,1637268,64.6,98083,5.7
Pennsylvania,1997,4,6050606,64.3,5731995,60.9,318611,5.3
Rhode Island,1997,4,530008,66.8,500693,63.1,29315,5.5
South Carolina,1997,4,1922308,66.6,1826924,63.3,95384,5.0
South Dakota,1997,4,393001,71.7,381430,69.6,11571,2.9
Tennessee,1997,4,2782808,66.2,2631078,62.6,151730,5.5
Texas,1997,4,9887198,69.2,9333095,65.3,554103,5.6
Utah,1997,4,1063727,71.7,1030277,69.5,33450,3.1
Vermont,1997,4,328704,71.9,315192,68.9,13512,4.1
Virginia,1997,4,3465934,67.9,3322492,65.1,143442,4.1
Washington,1997,4,2953900,69.4,2803914,65.9,149986,5.1
West Virginia,1997,4,789628,55.0,733861,51.1,55767,7.1
Wisconsin,1997,4,2939364,73.9,2833844,71.2,105520,3.6
Wyoming,1997,4,255758,70.1,243084,66.6,12674,5.0
Alabama,1997,5,2129081,64.4,2021980,61.2,107101,5.0
Alaska,1997,5,312060,73.7,290045,68.5,22015,7.1
Arizona,1997,5,2294349,64.3,2187693,61.3,106656,4.6
Arkansas,1997,5,1240235,63.3,1176572,60.0,63663,5.1
California,1997,5,15756329,66.3,14739373,62.0,1016956,6.5
Los Angeles County,1997,5,4420655,65.6,4110713,61.0,309942,7.0
Colorado,1997,5,2200988,72.5,2128332,70.1,72656,3.3
Connecticut,1997,5,1761075,68.7,1675263,65.3,85812,4.9
Delaware,1997,5,389814,68.1,373312,65.2,16502,4.2
District of Columbia,1997,5,286059,63.5,263444,58.5,22615,7.9
Florida,1997,5,7365742,62.5,6998972,59.4,366770,5.0
Georgia,1997,5,3934853,68.9,3757018,65.8,177835,4.5
Hawaii,1997,5,601876,67.8,565722,63.7,36154,6.0
Idaho,1997,5,632047,70.5,599041,66.8,33006,5.2
Illinois,1997,5,6284406,68.7,5988515,65.4,295891,4.7
Indiana,1997,5,3120426,69.3,3014419,66.9,106007,3.4
Iowa,1997,5,1602425,72.8,1551600,70.5,50825,3.2
Kansas,1997,5,1379795,70.6,1327388,67.9,52407,3.8
Kentucky,1997,5,1909191,63.6,1806843,60.2,102348,5.4
Louisiana,1997,5,2005067,61.9,1883717,58.1,121350,6.1
Maine,1997,5,659809,68.0,624528,64.4,35281,5.3
Maryland,1997,5,2774594,71.4,2641130,68.0,133464,4.8
Massachusetts,1997,5,3309324,68.7,3171707,65.9,137617,4.2
Michigan,1997,5,4947401,66.9,4737350,64.1,210051,4.2
Minnesota,1997,5,2679536,74.9,2590667,72.4,88869,3.3
Mississippi,1997,5,1271298,62.2,1199142,58.7,72156,5.7
Missouri,1997,5,2925433,70.9,2801910,67.9,123523,4.2
Montana,1997,5,451435,67.1,426451,63.4,24984,5.5
Nebraska,1997,5,918722,73.1,896403,71.3,22319,2.4
Nevada,1997,5,940971,69.9,899692,66.8,41279,4.4
New Hampshire,1997,5,653625,72.1,630864,69.6,22761,3.5
New Jersey,1997,5,4253347,67.6,4024999,64.0,228348,5.4
New Mexico,1997,5,819104,63.2,765460,59.0,53644,6.5
New York,1997,5,9026376,63.2,8436246,59.1,590130,6.5
New York city,1997,5,3518990,58.6,3178286,52.9,340704,9.7
North Carolina,1997,5,3968224,68.2,3815055,65.6,153169,3.9
North Dakota,1997,5,349379,72.0,338450,69.7,10929,3.1
Ohio,1997,5,5710346,66.9,5448411,63.8,261935,4.6
Oklahoma,1997,5,1606117,64.1,1542258,61.5,63859,4.0
Oregon,1997,5,1739234,68.5,1642592,64.7,96642,5.6
Pennsylvania,1997,5,6055667,64.3,5737790,60.9,317877,5.2
Rhode Island,1997,5,531786,67.0,502529,63.3,29257,5.5
South Carolina,1997,5,1923847,66.5,1832245,63.4,91602,4.8
South Dakota,1997,5,393660,71.7,382201,69.6,11459,2.9
Tennessee,1997,5,2782297,66.1,2630826,62.5,151471,5.4
Texas,1997,5,9901467,69.2,9354030,65.4,547437,5.5
Utah,1997,5,1066376,71.7,1033353,69.5,33023,3.1
Vermont,1997,5,329444,71.9,316230,69.0,13214,4.0
Virginia,1997,5,3467296,67.9,3328730,65.2,138566,4.0
Washington,1997,5,2963097,69.5,2815203,66.0,147894,5.0
West Virginia,1997,5,789504,55.0,734538,51.2,54966,7.0
Wisconsin,1997,5,2945606,74.0,2841183,71.3,104423,3.5
Wyoming,1997,5,255976,70.1,243546,66.7,12430,4.9
Alabama,1997,6,2132077,64.5,2025352,61.2,106725,5.0
Alaska,1997,6,312368,73.8,290596,68.7,21772,7.0
Arizona,1997,6,2297834,64.2,2193876,61.3,103958,4.5
Arkansas,1997,6,1240741,63.2,1176917,60.0,63824,5.1
California,1997,6,15793951,66.4,14786936,62.1,1007015,6.4
Los Angeles County,1997,6,4432336,65.7,4127193,61.1,305143,6.9
Colorado,1997,6,2210180,72.7,2138778,70.4,71402,3.2
Connecticut,1997,6,1761521,68.7,1677488,65.4,84033,4.8
Delaware,1997,6,389527,68.0,373734,65.2,15793,4.1
District of Columbia,1997,6,286460,63.7,263584,58.6,22876,8.0
Florida,1997,6,7388676,62.6,7024202,59.5,364474,4.9
Georgia,1997,6,3944698,69.0,3769149,65.9,175549,4.5
Hawaii,1997,6,602240,67.8,566046,63.7,36194,6.0
Idaho,1997,6,633239,70.5,600269,66.8,32970,5.2
Illinois,1997,6,6291179,68.7,5999569,65.5,291610,4.6
Indiana,1997,6,3125898,69.3,3018751,67.0,107147,3.4
Iowa,1997,6,1601582,72.7,1551829,70.5,49753,3.1
Kansas,1997,6,1380771,70.6,1329251,68.0,51520,3.7
Kentucky,1997,6,1910137,63.6,1809509,60.3,100628,5.3
Louisiana,1997,6,2006695,61.9,1886218,58.2,120477,6.0
Maine,1997,6,659618,68.0,625061,64.4,34557,5.2
Maryland,1997,6,2775358,71.4,2642153,68.0,133205,4.8
Massachusetts,1997,6,3312067,68.8,3175941,65.9,136126,4.1
Michigan,1997,6,4955792,67.0,4747773,64.2,208019,4.2
Minnesota,1997,6,2685760,75.0,2597999,72.5,87761,3.3
Mississippi,1997,6,1271812,62.2,1199371,58.6,72441,5.7
Missouri,1997,6,2928290,70.9,2805367,67.9,122923,4.2
Montana,1997,6,452010,67.2,427125,63.5,24885,5.5
Nebraska,1997,6,919303,73.1,896977,71.4,22326,2.4
Nevada,1997,6,945915,70.0,904846,67.0,41069,4.3
New Hampshire,1997,6,655602,72.2,633107,69.8,22495,3.4
New Jersey,1997,6,4254535,67.6,4028443,64.0,226092,5.3
New Mexico,1997,6,820235,63.2,767768,59.1,52467,6.4
New York,1997,6,9045582,63.3,8456031,59.2,589551,6.5
New York city,1997,6,3527885,58.7,3189019,53.1,338866,9.6
North Carolina,1997,6,3968169,68.1,3816455,65.5,151714,3.8
North Dakota,1997,6,349339,72.0,338509,69.7,10830,3.1
Ohio,1997,6,5717775,66.9,5462080,63.9,255695,4.5
Oklahoma,1997,6,1607301,64.1,1543367,61.5,63934,4.0
Oregon,1997,6,1743469,68.6,1647767,64.8,95702,5.5
Pennsylvania,1997,6,6060359,64.4,5743768,61.0,316591,5.2
Rhode Island,1997,6,533298,67.2,504246,63.5,29052,5.4
South Carolina,1997,6,1924425,66.5,1836640,63.4,87785,4.6
South Dakota,1997,6,394198,71.8,382744,69.7,11454,2.9
Tennessee,1997,6,2780344,65.9,2629537,62.4,150807,5.4
Texas,1997,6,9914223,69.2,9373715,65.4,540508,5.5
Utah,1997,6,1068918,71.8,1036101,69.6,32817,3.1
Vermont,1997,6,330190,72.1,317253,69.2,12937,3.9
Virginia,1997,6,3467186,67.8,3334336,65.2,132850,3.8
Washington,1997,6,2971415,69.6,2825224,66.2,146191,4.9
West Virginia,1997,6,789672,55.0,735230,51.2,54442,6.9
Wisconsin,1997,6,2952171,74.1,2848818,71.5,103353,3.5
Wyoming,1997,6,256159,70.0,243972,66.7,12187,4.8
Alabama,1997,7,2135036,64.5,2028916,61.3,106120,5.0
Alaska,1997,7,312583,73.9,291037,68.8,21546,6.9
Arizona,1997,7,2302301,64.1,2200052,61.3,102249,4.4
Arkansas,1997,7,1240710,63.2,1176922,59.9,63788,5.1
California,1997,7,15829660,66.4,14831156,62.2,998504,6.3
Los Angeles County,1997,7,4441957,65.8,4141361,61.3,300596,6.8
Colorado,1997,7,2219388,72.9,2148620,70.5,70768,3.2
Connecticut,1997,7,1760405,68.6,1678333,65.4,82072,4.7
Delaware,1997,7,389258,67.8,374172,65.2,15086,3.9
District of Columbia,1997,7,286944,63.7,263760,58.6,23184,8.1
Florida,1997,7,7408235,62.6,7046210,59.6,362025,4.9
Georgia,1997,7,3953152,69.0,3779669,65.9,173483,4.4
Hawaii,1997,7,602516,67.8,566432,63.7,36084,6.0
Idaho,1997,7,634005,70.4,601152,66.8,32853,5.2
Illinois,1997,7,6298301,68.8,6008300,65.6,290001,4.6
Indiana,1997,7,3128918,69.4,3020679,67.0,108239,3.5
Iowa,1997,7,1600300,72.6,1551327,70.4,48973,3.1
Kansas,1997,7,1381540,70.6,1330644,68.0,50896,3.7
Kentucky,1997,7,1911087,63.6,1812136,60.3,98951,5.2
Louisiana,1997,7,2008268,61.9,1889121,58.2,119147,5.9
Maine,1997,7,659107,67.9,625360,64.4,33747,5.1
Maryland,1997,7,2774724,71.3,2641735,67.9,132989,4.8
Massachusetts,1997,7,3313129,68.7,3178710,65.9,134419,4.1
Michigan,1997,7,4964552,67.1,4757095,64.3,207457,4.2
Minnesota,1997,7,2691638,75.1,2605197,72.6,86441,3.2
Mississippi,1997,7,1272612,62.2,1199747,58.6,72865,5.7
Missouri,1997,7,2931550,70.9,2807999,67.9,123551,4.2
Montana,1997,7,452550,67.2,427816,63.5,24734,5.5
Nebraska,1997,7,919765,73.1,897425,71.3,22340,2.4
Nevada,1997,7,950694,70.0,909828,67.0,40866,4.3
New Hampshire,1997,7,656773,72.3,634628,69.8,22145,3.4
New Jersey,1997,7,4254415,67.5,4030532,64.0,223883,5.3
New Mexico,1997,7,821130,63.2,769841,59.2,51289,6.2
New York,1997,7,9058479,63.4,8471720,59.3,586759,6.5
New York city,1997,7,3535160,58.8,3200242,53.2,334918,9.5
North Carolina,1997,7,3967018,68.0,3816830,65.4,150188,3.8
North Dakota,1997,7,349210,71.9,338632,69.7,10578,3.0
Ohio,1997,7,5725602,67.0,5472738,64.0,252864,4.4
Oklahoma,1997,7,1608721,64.1,1544752,61.5,63969,4.0
Oregon,1997,7,1747614,68.7,1652513,64.9,95101,5.4
Pennsylvania,1997,7,6065143,64.4,5750912,61.1,314231,5.2
Rhode Island,1997,7,534284,67.3,505612,63.7,28672,5.4
South Carolina,1997,7,1923869,66.4,1840071,63.5,83798,4.4
South Dakota,1997,7,394566,71.9,383089,69.8,11477,2.9
Tennessee,1997,7,2778029,65.8,2628727,62.3,149302,5.4
Texas,1997,7,9925211,69.1,9392271,65.4,532940,5.4
Utah,1997,7,1071323,71.8,1038538,69.6,32785,3.1
Vermont,1997,7,330871,72.1,318179,69.3,12692,3.8
Virginia,1997,7,3466373,67.7,3339792,65.2,126581,3.7
Washington,1997,7,2978354,69.7,2834007,66.3,144347,4.8
West Virginia,1997,7,790137,55.0,735963,51.3,54174,6.9
Wisconsin,1997,7,2959233,74.2,2856765,71.6,102468,3.5
Wyoming,1997,7,256268,70.0,244324,66.8,11944,4.7
Alabama,1997,8,2137759,64.5,2032565,61.4,105194,4.9
Alaska,1997,8,312779,73.7,291451,68.7,21328,6.8
Arizona,1997,8,2307350,64.1,2206009,61.3,101341,4.4
Arkansas,1997,8,1240441,63.1,1176892,59.9,63549,5.1
California,1997,8,15864185,66.4,14873058,62.3,991127,6.2
Los Angeles County,1997,8,4450628,65.8,4154077,61.4,296551,6.7
Colorado,1997,8,2228441,73.0,2157705,70.7,70736,3.2
Connecticut,1997,8,1757599,68.5,1677747,65.3,79852,4.5
Delaware,1997,8,388999,67.8,374654,65.3,14345,3.7
District of Columbia,1997,8,287440,63.8,263944,58.6,23496,8.2
Florida,1997,8,7423771,62.6,7064165,59.6,359606,4.8
Georgia,1997,8,3960463,68.9,3788777,66.0,171686,4.3
Hawaii,1997,8,602580,67.7,566736,63.7,35844,5.9
Idaho,1997,8,634363,70.4,601655,66.8,32708,5.2
Illinois,1997,8,6306211,68.8,6014670,65.6,291541,4.6
Indiana,1997,8,3129672,69.3,3020766,66.9,108906,3.5
Iowa,1997,8,1598794,72.5,1550351,70.3,48443,3.0
Kansas,1997,8,1382203,70.6,1331667,68.0,50536,3.7
Kentucky,1997,8,1912055,63.6,1814971,60.3,97084,5.1
Louisiana,1997,8,2010017,61.9,1892532,58.3,117485,5.8
Maine,1997,8,658319,67.8,625208,64.4,33111,5.0
Maryland,1997,8,2773287,71.3,2640461,67.8,132826,4.8
Massachusetts,1997,8,3313013,68.7,3180682,65.9,132331,4.0
Michigan,1997,8,4973640,67.2,4766042,64.4,207598,4.2
Minnesota,1997,8,2696605,75.1,2611770,72.8,84835,3.1
Mississippi,1997,8,1273681,62.1,1200583,58.6,73098,5.7
Missouri,1997,8,2934933,70.9,2810136,67.9,124797,4.3
Montana,1997,8,453180,67.2,428588,63.6,24592,5.4
Nebraska,1997,8,920144,73.1,897893,71.3,22251,2.4
Nevada,1997,8,955336,70.1,914660,67.1,40676,4.3
New Hampshire,1997,8,657018,72.2,635294,69.8,21724,3.3
New Jersey,1997,8,4253096,67.4,4031885,63.9,221211,5.2
New Mexico,1997,8,821983,63.2,771623,59.3,50360,6.1
New York,1997,8,9065324,63.4,8483806,59.3,581518,6.4
New York city,1997,8,3540451,58.8,3211609,53.3,328842,9.3
North Carolina,1997,8,3965963,67.9,3816928,65.3,149035,3.8
North Dakota,1997,8,349081,71.9,338876,69.8,10205,2.9
Ohio,1997,8,5733377,67.1,5480094,64.1,253283,4.4
Oklahoma,1997,8,1610250,64.1,1546525,61.6,63725,4.0
Oregon,1997,8,1751650,68.7,1656828,65.0,94822,5.4
Pennsylvania,1997,8,6069922,64.4,5759164,61.1,310758,5.1
Rhode Island,1997,8,534639,67.3,506471,63.7,28168,5.3
South Carolina,1997,8,1922395,66.2,1842599,63.5,79796,4.2
South Dakota,1997,8,394788,71.9,383311,69.8,11477,2.9
Tennessee,1997,8,2776940,65.7,2630092,62.2,146848,5.3
Texas,1997,8,9935474,69.1,9409748,65.4,525726,5.3
Utah,1997,8,1073668,71.8,1040727,69.6,32941,3.1
Vermont,1997,8,331412,72.2,318904,69.4,12508,3.8
Virginia,1997,8,3465521,67.6,3345371,65.3,120150,3.5
Washington,1997,8,2984024,69.7,2841523,66.3,142501,4.8
West Virginia,1997,8,790774,55.1,736700,51.3,54074,6.8
Wisconsin,1997,8,2966453,74.3,2864663,71.8,101790,3.4
Wyoming,1997,8,256323,70.0,244601,66.8,11722,4.6
Alabama,1997,9,2139990,64.5,2036259,61.4,103731,4.8
Alaska,1997,9,312999,73.8,291919,68.8,21080,6.7
Arizona,1997,9,2312853,64.1,2212081,61.3,100772,4.4
Arkansas,1997,9,1240208,63.0,1177093,59.8,63115,5.1
California,1997,9,15897303,66.5,14913798,62.4,983505,6.2
Los Angeles County,1997,9,4459282,65.8,4166529,61.5,292753,6.6
Colorado,1997,9,2237410,73.2,2166242,70.8,71168,3.2
Connecticut,1997,9,1753472,68.3,1676153,65.3,77319,4.4
Delaware,1997,9,388801,67.6,375210,65.2,13591,3.5
District of Columbia,1997,9,287975,63.9,264163,58.6,23812,8.3
Florida,1997,9,7436138,62.6,7078940,59.6,357198,4.8
Georgia,1997,9,3967368,68.9,3797199,66.0,170169,4.3
Hawaii,1997,9,602322,67.6,566866,63.6,35456,5.9
Idaho,1997,9,634644,70.3,602032,66.7,32612,5.1
Illinois,1997,9,6314785,68.8,6019376,65.6,295409,4.7
Indiana,1997,9,3128714,69.3,3020022,66.9,108692,3.5
Iowa,1997,9,1597489,72.4,1549576,70.2,47913,3.0
Kansas,1997,9,1382860,70.6,1332613,68.0,50247,3.6
Kentucky,1997,9,1913009,63.5,1818221,60.4,94788,5.0
Louisiana,1997,9,2011964,61.9,1896422,58.4,115542,5.7
Maine,1997,9,657344,67.6,624603,64.3,32741,5.0
Maryland,1997,9,2771728,71.1,2639194,67.7,132534,4.8
Massachusetts,1997,9,3312180,68.6,3182457,65.9,129723,3.9
Michigan,1997,9,4983084,67.2,4775294,64.4,207790,4.2
Minnesota,1997,9,2700416,75.1,2617366,72.8,83050,3.1
Mississippi,1997,9,1274877,62.1,1202046,58.6,72831,5.7
Missouri,1997,9,2938122,71.0,2812125,67.9,125997,4.3
Montana,1997,9,454047,67.3,429511,63.6,24536,5.4
Nebraska,1997,9,920515,73.1,898555,71.3,21960,2.4
Nevada,1997,9,960054,70.2,919458,67.2,40596,4.2
New Hampshire,1997,9,656447,72.1,635227,69.7,21220,3.2
New Jersey,1997,9,4250766,67.3,4032773,63.9,217993,5.1
New Mexico,1997,9,823016,63.1,773201,59.3,49815,6.1
New York,1997,9,9067857,63.4,8493892,59.4,573965,6.3
New York city,1997,9,3544079,58.8,3222758,53.5,321321,9.1
North Carolina,1997,9,3965438,67.7,3817189,65.2,148249,3.7
North Dakota,1997,9,349006,71.7,339197,69.7,9809,2.8
Ohio,1997,9,5739428,67.1,5484337,64.1,255091,4.4
Oklahoma,1997,9,1611704,64.1,1548671,61.6,63033,3.9
Oregon,1997,9,1755509,68.8,1660852,65.1,94657,5.4
Pennsylvania,1997,9,6073668,64.5,5767454,61.2,306214,5.0
Rhode Island,1997,9,534428,67.2,506835,63.7,27593,5.2
South Carolina,1997,9,1920562,66.0,1844603,63.4,75959,4.0
South Dakota,1997,9,394953,71.9,383513,69.8,11440,2.9
Tennessee,1997,9,2777793,65.6,2634641,62.3,143152,5.2
Texas,1997,9,9945353,69.0,9427183,65.4,518170,5.2
Utah,1997,9,1076163,71.8,1042864,69.6,33299,3.1
Vermont,1997,9,331741,72.1,319370,69.4,12371,3.7
Virginia,1997,9,3464869,67.5,3350888,65.3,113981,3.3
Washington,1997,9,2988892,69.7,2847901,66.4,140991,4.7
West Virginia,1997,9,791313,55.1,737396,51.3,53917,6.8
Wisconsin,1997,9,2972840,74.4,2871851,71.9,100989,3.4
Wyoming,1997,9,256389,70.1,244849,66.9,11540,4.5
Alabama,1997,10,2141619,64.5,2039774,61.4,101845,4.8
Alaska,1997,10,313258,73.8,292455,68.9,20803,6.6
Arizona,1997,10,2318914,64.1,2218421,61.3,100493,4.3
Arkansas,1997,10,1240097,63.0,1177409,59.8,62688,5.1
California,1997,10,15930015,66.5,14953209,62.4,976806,6.1
Los Angeles County,1997,10,4469626,65.9,4179882,61.6,289744,6.5
Colorado,1997,10,2246228,73.3,2173997,71.0,72231,3.2
Connecticut,1997,10,1748830,68.1,1674186,65.2,74644,4.3
Delaware,1997,10,389233,67.6,375866,65.2,13367,3.4
District of Columbia,1997,10,288499,64.1,264316,58.7,24183,8.4
Florida,1997,10,7447231,62.6,7091793,59.6,355438,4.8
Georgia,1997,10,3974695,68.9,3805350,66.0,169345,4.3
Hawaii,1997,10,601793,67.5,566738,63.6,35055,5.8
Idaho,1997,10,635314,70.2,602618,66.6,32696,5.1
Illinois,1997,10,6323166,68.9,6023137,65.6,300029,4.7
Indiana,1997,10,3126836,69.2,3019268,66.8,107568,3.4
Iowa,1997,10,1596569,72.3,1549321,70.2,47248,3.0
Kansas,1997,10,1383701,70.5,1333640,68.0,50061,3.6
Kentucky,1997,10,1913994,63.5,1821766,60.4,92228,4.8
Louisiana,1997,10,2013588,61.9,1900210,58.4,113378,5.6
Maine,1997,10,656276,67.5,623641,64.1,32635,5.0
Maryland,1997,10,2770636,71.1,2638531,67.7,132105,4.8
Massachusetts,1997,10,3311342,68.5,3184475,65.9,126867,3.8
Michigan,1997,10,4992520,67.3,4784469,64.5,208051,4.2
Minnesota,1997,10,2702924,75.1,2621521,72.9,81403,3.0
Mississippi,1997,10,1275952,62.1,1203903,58.6,72049,5.6
Missouri,1997,10,2941012,71.0,2814020,67.9,126992,4.3
Montana,1997,10,455169,67.4,430528,63.8,24641,5.4
Nebraska,1997,10,920942,73.0,899357,71.3,21585,2.3
Nevada,1997,10,960651,70.0,919924,67.0,40727,4.2
New Hampshire,1997,10,655431,71.9,634738,69.6,20693,3.2
New Jersey,1997,10,4248067,67.2,4033064,63.8,215003,5.1
New Mexico,1997,10,824404,63.2,774643,59.4,49761,6.0
New York,1997,10,9068585,63.3,8502827,59.4,565758,6.2
New York city,1997,10,3547205,58.8,3233105,53.6,314100,8.9
North Carolina,1997,10,3965140,67.6,3817339,65.1,147801,3.7
North Dakota,1997,10,349016,71.7,339490,69.7,9526,2.7
Ohio,1997,10,5742602,67.1,5485675,64.1,256927,4.5
Oklahoma,1997,10,1613210,64.1,1551032,61.6,62178,3.9
Oregon,1997,10,1759069,68.8,1664660,65.1,94409,5.4
Pennsylvania,1997,10,6075970,64.5,5774209,61.2,301761,5.0
Rhode Island,1997,10,533850,67.1,506785,63.7,27065,5.1
South Carolina,1997,10,1918980,65.9,1846550,63.4,72430,3.8
South Dakota,1997,10,395143,71.8,383742,69.7,11401,2.9
Tennessee,1997,10,2780132,65.6,2641504,62.3,138628,5.0
Texas,1997,10,9955367,69.0,9445349,65.4,510018,5.1
Utah,1997,10,1078919,71.8,1045028,69.6,33891,3.1
Vermont,1997,10,331865,72.1,319580,69.4,12285,3.7
Virginia,1997,10,3464572,67.5,3355802,65.4,108770,3.1
Washington,1997,10,2993178,69.7,2853099,66.4,140079,4.7
West Virginia,1997,10,791753,55.1,737968,51.4,53785,6.8
Wisconsin,1997,10,2977652,74.5,2877487,72.0,100165,3.4
Wyoming,1997,10,256557,70.1,245100,67.0,11457,4.5
Alabama,1997,11,2142520,64.5,2042801,61.5,99719,4.7
Alaska,1997,11,313536,73.7,293057,68.9,20479,6.5
Arizona,1997,11,2325409,64.2,2224755,61.4,100654,4.3
Arkansas,1997,11,1240018,62.9,1177516,59.7,62502,5.0
California,1997,11,15961294,66.5,14989426,62.5,971868,6.1
Los Angeles County,1997,11,4481849,66.0,4193843,61.8,288006,6.4
Colorado,1997,11,2254519,73.4,2180579,71.0,73940,3.3
Connecticut,1997,11,1744275,67.9,1672296,65.1,71979,4.1
Delaware,1997,11,388951,67.5,376609,65.4,12342,3.2
District of Columbia,1997,11,289070,64.1,264462,58.7,24608,8.5
Florida,1997,11,7457775,62.6,7103497,59.6,354278,4.8
Georgia,1997,11,3982696,68.9,3813395,66.0,169301,4.3
Hawaii,1997,11,601101,67.4,566392,63.5,34709,5.8
Idaho,1997,11,636531,70.3,603552,66.6,32979,5.2
Illinois,1997,11,6329141,68.9,6025883,65.6,303258,4.8
Indiana,1997,11,3124546,69.1,3019035,66.7,105511,3.4
Iowa,1997,11,1595848,72.3,1549353,70.2,46495,2.9
Kansas,1997,11,1384720,70.5,1334702,68.0,50018,3.6
Kentucky,1997,11,1914942,63.5,1825219,60.5,89723,4.7
Louisiana,1997,11,2014585,61.9,1903170,58.5,111415,5.5
Maine,1997,11,655097,67.3,622486,64.0,32611,5.0
Maryland,1997,11,2769961,71.0,2638602,67.6,131359,4.7
Massachusetts,1997,11,3310633,68.5,3186619,65.9,124014,3.7
Michigan,1997,11,5000520,67.4,4792998,64.6,207522,4.2
Minnesota,1997,11,2704114,75.1,2624320,72.9,79794,3.0
Mississippi,1997,11,1276691,62.1,1205733,58.7,70958,5.6
Missouri,1997,11,2943278,71.0,2815504,67.9,127774,4.3
Montana,1997,11,456363,67.6,431489,63.9,24874,5.5
Nebraska,1997,11,921398,73.1,900079,71.4,21319,2.3
Nevada,1997,11,961403,69.8,920340,66.8,41063,4.3
New Hampshire,1997,11,654365,71.7,634179,69.5,20186,3.1
New Jersey,1997,11,4245212,67.1,4032388,63.8,212824,5.0
New Mexico,1997,11,826069,63.2,775943,59.4,50126,6.1
New York,1997,11,9068172,63.3,8510271,59.4,557901,6.2
New York city,1997,11,3550163,58.8,3241938,53.7,308225,8.7
North Carolina,1997,11,3964373,67.5,3816366,65.0,148007,3.7
North Dakota,1997,11,349056,71.7,339642,69.8,9414,2.7
Ohio,1997,11,5741597,67.1,5484169,64.1,257428,4.5
Oklahoma,1997,11,1614891,64.1,1553384,61.6,61507,3.8
Oregon,1997,11,1761986,68.8,1667988,65.2,93998,5.3
Pennsylvania,1997,11,6076342,64.4,5778258,61.3,298084,4.9
Rhode Island,1997,11,533068,66.9,506381,63.6,26687,5.0
South Carolina,1997,11,1918024,65.8,1848680,63.4,69344,3.6
South Dakota,1997,11,395351,71.8,383981,69.8,11370,2.9
Tennessee,1997,11,2782544,65.6,2648499,62.4,134045,4.8
Texas,1997,11,9966380,68.9,9464033,65.4,502347,5.0
Utah,1997,11,1081836,71.9,1047113,69.6,34723,3.2
Vermont,1997,11,331838,72.1,319620,69.4,12218,3.7
Virginia,1997,11,3464316,67.4,3359589,65.4,104727,3.0
Washington,1997,11,2996792,69.6,2857048,66.4,139744,4.7
West Virginia,1997,11,792082,55.1,738306,51.4,53776,6.8
Wisconsin,1997,11,2980073,74.5,2880962,72.0,99111,3.3
Wyoming,1997,11,256817,70.2,245332,67.0,11485,4.5
Alabama,1997,12,2142893,64.4,2045347,61.5,97546,4.6
Alaska,1997,12,313765,73.8,293661,69.1,20104,6.4
Arizona,1997,12,2332401,64.2,2231370,61.4,101031,4.3
Arkansas,1997,12,1239993,62.9,1177331,59.7,62662,5.1
California,1997,12,15991346,66.5,15023125,62.5,968221,6.1
Los Angeles County,1997,12,4495366,66.1,4207838,61.9,287528,6.4
Colorado,1997,12,2262706,73.6,2186529,71.1,76177,3.4
Connecticut,1997,12,1740475,67.7,1671088,65.0,69387,4.0
Delaware,1997,12,390232,67.6,377424,65.4,12808,3.3
District of Columbia,1997,12,289863,64.3,264861,58.7,25002,8.6
Florida,1997,12,7468254,62.6,7115230,59.6,353024,4.7
Georgia,1997,12,3991679,69.0,3821967,66.0,169712,4.3
Hawaii,1997,12,600490,67.3,566061,63.4,34429,5.7
Idaho,1997,12,638320,70.3,604976,66.6,33344,5.2
Illinois,1997,12,6330910,68.9,6027846,65.6,303064,4.8
Indiana,1997,12,3122311,69.0,3019734,66.7,102577,3.3
Iowa,1997,12,1595164,72.2,1549410,70.2,45754,2.9
Kansas,1997,12,1385972,70.5,1335938,68.0,50034,3.6
Kentucky,1997,12,1915940,63.5,1828420,60.6,87520,4.6
Louisiana,1997,12,2015474,61.9,1905472,58.6,110002,5.5
Maine,1997,12,653929,67.2,621536,63.9,32393,5.0
Maryland,1997,12,2769503,71.0,2639459,67.6,130044,4.7
Massachusetts,1997,12,3310247,68.4,3188956,65.9,121291,3.7
Michigan,1997,12,5006184,67.5,4800926,64.7,205258,4.1
Minnesota,1997,12,2704832,75.0,2626809,72.9,78023,2.9
Mississippi,1997,12,1277164,62.1,1207345,58.7,69819,5.5
Missouri,1997,12,2944931,71.0,2816644,67.9,128287,4.4
Montana,1997,12,457460,67.8,432307,64.1,25153,5.5
Nebraska,1997,12,921903,73.0,900642,71.3,21261,2.3
Nevada,1997,12,962307,69.6,920829,66.6,41478,4.3
New Hampshire,1997,12,653645,71.5,633913,69.3,19732,3.0
New Jersey,1997,12,4242311,67.0,4030940,63.7,211371,5.0
New Mexico,1997,12,827901,63.3,777187,59.4,50714,6.1
New York,1997,12,9067062,63.2,8516593,59.4,550469,6.1
New York city,1997,12,3552788,58.8,3249066,53.7,303722,8.5
North Carolina,1997,12,3962934,67.4,3814297,64.8,148637,3.8
North Dakota,1997,12,349011,71.8,339604,69.9,9407,2.7
Ohio,1997,12,5736876,67.0,5481285,64.0,255591,4.5
Oklahoma,1997,12,1617010,64.1,1555748,61.7,61262,3.8
Oregon,1997,12,1764435,68.8,1670729,65.2,93706,5.3
Pennsylvania,1997,12,6074933,64.4,5780001,61.3,294932,4.9
Rhode Island,1997,12,532255,66.8,505801,63.5,26454,5.0
South Carolina,1997,12,1918206,65.7,1851294,63.4,66912,3.5
South Dakota,1997,12,395571,71.9,384224,69.8,11347,2.9
Tennessee,1997,12,2784454,65.6,2654335,62.5,130119,4.7
Texas,1997,12,9979944,68.9,9483987,65.5,495957,5.0
Utah,1997,12,1084883,71.9,1049205,69.6,35678,3.3
Vermont,1997,12,331770,71.9,319632,69.3,12138,3.7
Virginia,1997,12,3464718,67.4,3363158,65.4,101560,2.9
Washington,1997,12,3000120,69.6,2860365,66.4,139755,4.7
West Virginia,1997,12,792428,55.2,738610,51.4,53818,6.8
Wisconsin,1997,12,2979934,74.5,2882349,72.0,97585,3.3
Wyoming,1997,12,257173,70.3,245592,67.1,11581,4.5
Alabama,1998,1,2143042,64.4,2047388,61.5,95654,4.5
Alaska,1998,1,314023,73.9,294243,69.2,19780,6.3
Arizona,1998,1,2339726,64.3,2238444,61.5,101282,4.3
Arkansas,1998,1,1240130,62.8,1177088,59.6,63042,5.1
California,1998,1,16020412,66.6,15055216,62.5,965196,6.0
Los Angeles County,1998,1,4508944,66.2,4220846,62.0,288098,6.4
Colorado,1998,1,2271029,73.7,2192414,71.2,78615,3.5
Connecticut,1998,1,1737973,67.6,1671067,65.0,66906,3.8
Delaware,1998,1,391557,67.7,378280,65.4,13277,3.4
District of Columbia,1998,1,290906,64.4,265620,58.8,25286,8.7
Florida,1998,1,7478800,62.6,7127702,59.6,351098,4.7
Georgia,1998,1,4001341,69.0,3831181,66.1,170160,4.3
Hawaii,1998,1,600156,67.2,565890,63.4,34266,5.7
Idaho,1998,1,640515,70.5,606845,66.8,33670,5.3
Illinois,1998,1,6327855,68.8,6028679,65.5,299176,4.7
Indiana,1998,1,3120317,68.9,3021351,66.7,98966,3.2
Iowa,1998,1,1594477,72.2,1549330,70.1,45147,2.8
Kansas,1998,1,1387473,70.5,1337401,68.0,50072,3.6
Kentucky,1998,1,1917027,63.4,1831108,60.6,85919,4.5
Louisiana,1998,1,2016848,62.0,1907729,58.6,109119,5.4
Maine,1998,1,652978,67.1,621133,63.8,31845,4.9
Maryland,1998,1,2768820,70.9,2640756,67.6,128064,4.6
Massachusetts,1998,1,3310093,68.4,3191322,65.9,118771,3.6
Michigan,1998,1,5009309,67.5,4807782,64.8,201527,4.0
Minnesota,1998,1,2706235,75.0,2629983,72.9,76252,2.8
Mississippi,1998,1,1277437,62.0,1208646,58.7,68791,5.4
Missouri,1998,1,2945984,71.0,2817535,67.9,128449,4.4
Montana,1998,1,458362,67.8,432923,64.1,25439,5.5
Nebraska,1998,1,922344,73.0,901019,71.4,21325,2.3
Nevada,1998,1,963366,69.4,921525,66.4,41841,4.3
New Hampshire,1998,1,653541,71.4,634175,69.3,19366,3.0
New Jersey,1998,1,4239769,67.0,4029770,63.6,209999,5.0
New Mexico,1998,1,829816,63.4,778427,59.4,51389,6.2
New York,1998,1,9065416,63.2,8522656,59.4,542760,6.0
New York city,1998,1,3554675,58.8,3254770,53.8,299905,8.4
North Carolina,1998,1,3961197,67.2,3812025,64.7,149172,3.8
North Dakota,1998,1,348814,71.8,339383,69.8,9431,2.7
Ohio,1998,1,5729660,66.9,5477855,64.0,251805,4.4
Oklahoma,1998,1,1619495,64.2,1558055,61.7,61440,3.8
Oregon,1998,1,1766909,68.9,1672966,65.2,93943,5.3
Pennsylvania,1998,1,6072218,64.4,5780079,61.3,292139,4.8
Rhode Island,1998,1,531556,66.7,505306,63.4,26250,4.9
South Carolina,1998,1,1919541,65.6,1854351,63.4,65190,3.4
South Dakota,1998,1,395788,71.9,384447,69.8,11341,2.9
Tennessee,1998,1,2786249,65.5,2659131,62.6,127118,4.6
Texas,1998,1,9996709,68.9,9505297,65.5,491412,4.9
Utah,1998,1,1088022,72.0,1051405,69.6,36617,3.4
Vermont,1998,1,331806,71.9,319746,69.3,12060,3.6
Virginia,1998,1,3466463,67.3,3367410,65.4,99053,2.9
Washington,1998,1,3003634,69.6,2863641,66.4,139993,4.7
West Virginia,1998,1,792927,55.2,739064,51.5,53863,6.8
Wisconsin,1998,1,2977562,74.4,2881877,72.0,95685,3.2
Wyoming,1998,1,257656,70.4,245928,67.2,11728,4.6
Alabama,1998,2,2143140,64.3,2048758,61.5,94382,4.4
Alaska,1998,2,314319,73.9,294736,69.3,19583,6.2
Arizona,1998,2,2347301,64.4,2246083,61.6,101218,4.3
Arkansas,1998,2,1240558,62.8,1177202,59.6,63356,5.1
California,1998,2,16049015,66.6,15086351,62.6,962664,6.0
Los Angeles County,1998,2,4521213,66.4,4231764,62.1,289449,6.4
Colorado,1998,2,2279115,73.9,2198125,71.3,80990,3.6
Connecticut,1998,2,1736847,67.6,1672278,65.1,64569,3.7
Delaware,1998,2,392837,67.9,379133,65.5,13704,3.5
District of Columbia,1998,2,292057,64.6,266640,59.0,25417,8.7
Florida,1998,2,7489695,62.6,7141241,59.7,348454,4.7
Georgia,1998,2,4011182,69.1,3840607,66.1,170575,4.3
Hawaii,1998,2,600167,67.1,565913,63.3,34254,5.7
Idaho,1998,2,642874,70.6,608953,66.9,33921,5.3
Illinois,1998,2,6321417,68.7,6028974,65.5,292443,4.6
Indiana,1998,2,3118417,68.9,3023126,66.8,95291,3.1
Iowa,1998,2,1593924,72.1,1549132,70.1,44792,2.8
Kansas,1998,2,1389273,70.6,1339017,68.0,50256,3.6
Kentucky,1998,2,1918015,63.4,1832901,60.6,85114,4.4
Louisiana,1998,2,2019311,62.0,1910303,58.7,109008,5.4
Maine,1998,2,652357,67.0,621351,63.8,31006,4.8
Maryland,1998,2,2767677,70.8,2641927,67.6,125750,4.5
Massachusetts,1998,2,3310222,68.4,3193665,66.0,116557,3.5
Michigan,1998,2,5010213,67.5,4813318,64.9,196895,3.9
Minnesota,1998,2,2708574,75.0,2633991,73.0,74583,2.8
Mississippi,1998,2,1277531,62.0,1209490,58.7,68041,5.3
Missouri,1998,2,2946645,71.0,2818328,67.9,128317,4.4
Montana,1998,2,459095,67.9,433414,64.1,25681,5.6
Nebraska,1998,2,922765,73.1,901274,71.4,21491,2.3
Nevada,1998,2,964544,69.3,922479,66.2,42065,4.4
New Hampshire,1998,2,654120,71.5,635050,69.4,19070,2.9
New Jersey,1998,2,4237533,66.9,4029496,63.6,208037,4.9
New Mexico,1998,2,831656,63.4,779668,59.5,51988,6.3
New York,1998,2,9063924,63.2,8529559,59.4,534365,5.9
New York city,1998,2,3555901,58.7,3259904,53.8,295997,8.3
North Carolina,1998,2,3959672,67.1,3810798,64.6,148874,3.8
North Dakota,1998,2,348509,71.7,339024,69.8,9485,2.7
Ohio,1998,2,5721402,66.8,5473668,63.9,247734,4.3
Oklahoma,1998,2,1622364,64.2,1560147,61.8,62217,3.8
Oregon,1998,2,1769554,68.9,1674781,65.2,94773,5.4
Pennsylvania,1998,2,6068764,64.4,5779255,61.3,289509,4.8
Rhode Island,1998,2,531018,66.6,505071,63.3,25947,4.9
South Carolina,1998,2,1921953,65.6,1857603,63.4,64350,3.3
South Dakota,1998,2,396023,71.9,384657,69.8,11366,2.9
Tennessee,1998,2,2788313,65.5,2663495,62.6,124818,4.5
Texas,1998,2,10017045,68.9,9527707,65.6,489338,4.9
Utah,1998,2,1091250,72.1,1053748,69.6,37502,3.4
Vermont,1998,2,332016,72.0,320018,69.4,11998,3.6
Virginia,1998,2,3469732,67.4,3372649,65.5,97083,2.8
Washington,1998,2,3007669,69.6,2867310,66.3,140359,4.7
West Virginia,1998,2,793512,55.3,739653,51.5,53859,6.8
Wisconsin,1998,2,2974202,74.3,2880232,71.9,93970,3.2
Wyoming,1998,2,258232,70.5,246331,67.3,11901,4.6
Alabama,1998,3,2142936,64.3,2049134,61.5,93802,4.4
Alaska,1998,3,314531,74.0,295005,69.4,19526,6.2
Arizona,1998,3,2354960,64.5,2254071,61.7,100889,4.3
Arkansas,1998,3,1241121,62.8,1177712,59.6,63409,5.1
California,1998,3,16076033,66.6,15115208,62.6,960825,6.0
Los Angeles County,1998,3,4530198,66.4,4238938,62.2,291260,6.4
Colorado,1998,3,2286442,74.0,2203449,71.3,82993,3.6
Connecticut,1998,3,1736765,67.6,1674396,65.1,62369,3.6
Delaware,1998,3,393985,68.0,379925,65.6,14060,3.6
District of Columbia,1998,3,293015,64.8,267641,59.2,25374,8.7
Florida,1998,3,7499969,62.6,7154711,59.7,345258,4.6
Georgia,1998,3,4020354,69.1,3849489,66.2,170865,4.2
Hawaii,1998,3,600467,67.2,566101,63.3,34366,5.7
Idaho,1998,3,645121,70.7,611079,67.0,34042,5.3
Illinois,1998,3,6313773,68.6,6029421,65.5,284352,4.5
Indiana,1998,3,3116233,68.8,3024014,66.8,92219,3.0
Iowa,1998,3,1593416,72.1,1548675,70.1,44741,2.8
Kansas,1998,3,1391279,70.7,1340571,68.1,50708,3.6
Kentucky,1998,3,1918741,63.4,1833727,60.6,85014,4.4
Louisiana,1998,3,2023005,62.1,1913082,58.7,109923,5.4
Maine,1998,3,652046,67.0,621959,63.9,30087,4.6
Maryland,1998,3,2766106,70.8,2642338,67.6,123768,4.5
Massachusetts,1998,3,3311154,68.4,3196482,66.0,114672,3.5
Michigan,1998,3,5009273,67.5,4816828,64.9,192445,3.8
Minnesota,1998,3,2711064,75.0,2638158,73.0,72906,2.7
Mississippi,1998,3,1277258,61.9,1209641,58.7,67617,5.3
Missouri,1998,3,2947065,70.9,2819017,67.9,128048,4.3
Montana,1998,3,459676,68.0,433842,64.2,25834,5.6
Nebraska,1998,3,923240,73.0,901435,71.3,21805,2.4
Nevada,1998,3,965702,69.1,923573,66.1,42129,4.4
New Hampshire,1998,3,655215,71.5,636427,69.4,18788,2.9
New Jersey,1998,3,4234809,66.8,4029676,63.6,205133,4.8
New Mexico,1998,3,833183,63.5,780761,59.5,52422,6.3
New York,1998,3,9062144,63.1,8536797,59.5,525347,5.8
New York city,1998,3,3556108,58.7,3264621,53.9,291487,8.2
North Carolina,1998,3,3958772,67.0,3811254,64.5,147518,3.7
North Dakota,1998,3,348124,71.6,338543,69.6,9581,2.8
Ohio,1998,3,5713352,66.7,5468349,63.8,245003,4.3
Oklahoma,1998,3,1625433,64.3,1561770,61.8,63663,3.9
Oregon,1998,3,1772036,68.9,1675996,65.2,96040,5.4
Pennsylvania,1998,3,6064558,64.3,5777637,61.3,286921,4.7
Rhode Island,1998,3,530605,66.5,505113,63.3,25492,4.8
South Carolina,1998,3,1925016,65.7,1860558,63.5,64458,3.3
South Dakota,1998,3,396261,71.9,384848,69.9,11413,2.9
Tennessee,1998,3,2791071,65.6,2667993,62.7,123078,4.4
Texas,1998,3,10039917,69.0,9549579,65.6,490338,4.9
Utah,1998,3,1094439,72.2,1056111,69.7,38328,3.5
Vermont,1998,3,332402,71.9,320448,69.3,11954,3.6
Virginia,1998,3,3474137,67.4,3378505,65.6,95632,2.8
Washington,1998,3,3012155,69.6,2871357,66.4,140798,4.7
West Virginia,1998,3,794061,55.3,740256,51.6,53805,6.8
Wisconsin,1998,3,2970936,74.2,2877909,71.8,93027,3.1
Wyoming,1998,3,258807,70.7,246729,67.4,12078,4.7
Alabama,1998,4,2142385,64.2,2048713,61.4,93672,4.4
Alaska,1998,4,314649,73.8,295077,69.2,19572,6.2
Arizona,1998,4,2363059,64.5,2262590,61.8,100469,4.3
Arkansas,1998,4,1241784,62.8,1178613,59.6,63171,5.1
California,1998,4,16101890,66.6,15142786,62.6,959104,6.0
Los Angeles County,1998,4,4535788,66.4,4242755,62.1,293033,6.5
Colorado,1998,4,2293058,74.1,2208651,71.3,84407,3.7
Connecticut,1998,4,1737357,67.6,1677110,65.2,60247,3.5
Delaware,1998,4,394970,68.1,380683,65.7,14287,3.6
District of Columbia,1998,4,293530,64.9,268372,59.3,25158,8.6
Florida,1998,4,7509363,62.5,7167971,59.7,341392,4.5
Georgia,1998,4,4028511,69.1,3857869,66.2,170642,4.2
Hawaii,1998,4,601017,67.2,566451,63.4,34566,5.8
Idaho,1998,4,647156,70.9,613170,67.2,33986,5.3
Illinois,1998,4,6308268,68.5,6031298,65.5,276970,4.4
Indiana,1998,4,3114296,68.7,3024086,66.7,90210,2.9
Iowa,1998,4,1593101,72.1,1548264,70.0,44837,2.8
Kansas,1998,4,1393435,70.7,1342178,68.1,51257,3.7
Kentucky,1998,4,1919548,63.4,1834229,60.6,85319,4.4
Louisiana,1998,4,2027854,62.2,1916063,58.8,111791,5.5
Maine,1998,4,652019,66.9,622728,63.9,29291,4.5
Maryland,1998,4,2764293,70.7,2642141,67.5,122152,4.4
Massachusetts,1998,4,3313710,68.4,3200673,66.0,113037,3.4
Michigan,1998,4,5007596,67.4,4818433,64.9,189163,3.8
Minnesota,1998,4,2713223,75.0,2641816,73.0,71407,2.6
Mississippi,1998,4,1276679,61.9,1209345,58.6,67334,5.3
Missouri,1998,4,2947282,70.9,2820120,67.8,127162,4.3
Montana,1998,4,460187,68.1,434324,64.3,25863,5.6
Nebraska,1998,4,923832,73.1,901691,71.3,22141,2.4
Nevada,1998,4,968803,69.1,926834,66.1,41969,4.3
New Hampshire,1998,4,656646,71.6,638160,69.5,18486,2.8
New Jersey,1998,4,4231858,66.7,4030872,63.6,200986,4.7
New Mexico,1998,4,834336,63.5,781674,59.5,52662,6.3
New York,1998,4,9060216,63.1,8544599,59.5,515617,5.7
New York city,1998,4,3555054,58.6,3269159,53.9,285895,8.0
North Carolina,1998,4,3959466,66.9,3814147,64.4,145319,3.7
North Dakota,1998,4,347669,71.5,337960,69.5,9709,2.8
Ohio,1998,4,5706691,66.6,5462809,63.8,243882,4.3
Oklahoma,1998,4,1628557,64.4,1563091,61.8,65466,4.0
Oregon,1998,4,1774188,68.9,1676689,65.1,97499,5.5
Pennsylvania,1998,4,6060516,64.2,5776248,61.2,284268,4.7
Rhode Island,1998,4,530306,66.4,505405,63.3,24901,4.7
South Carolina,1998,4,1928531,65.7,1863316,63.5,65215,3.4
South Dakota,1998,4,396531,72.0,385107,69.9,11424,2.9
Tennessee,1998,4,2794942,65.6,2673222,62.7,121720,4.4
Texas,1998,4,10064726,69.0,9570244,65.7,494482,4.9
Utah,1998,4,1097519,72.3,1058480,69.7,39039,3.6
Vermont,1998,4,332966,72.0,321059,69.4,11907,3.6
Virginia,1998,4,3480180,67.5,3385486,65.6,94694,2.7
Washington,1998,4,3017192,69.6,2875859,66.4,141333,4.7
West Virginia,1998,4,794517,55.4,740850,51.6,53667,6.8
Wisconsin,1998,4,2968396,74.1,2875367,71.7,93029,3.1
Wyoming,1998,4,259339,70.8,247102,67.5,12237,4.7
Alabama,1998,5,2141884,64.1,2047919,61.3,93965,4.4
Alaska,1998,5,314745,73.9,295036,69.2,19709,6.3
Arizona,1998,5,2372072,64.6,2271841,61.9,100231,4.2
Arkansas,1998,5,1242776,62.8,1179908,59.6,62868,5.1
California,1998,5,16129830,66.6,15170968,62.7,958862,5.9
Los Angeles County,1998,5,4540000,66.4,4244887,62.1,295113,6.5
Colorado,1998,5,2299483,74.2,2213985,71.4,85498,3.7
Connecticut,1998,5,1738261,67.6,1679988,65.3,58273,3.4
Delaware,1998,5,395885,68.2,381487,65.7,14398,3.6
District of Columbia,1998,5,293645,65.0,268785,59.5,24860,8.5
Florida,1998,5,7519936,62.5,7182224,59.7,337712,4.5
Georgia,1998,5,4036397,69.2,3866185,66.2,170212,4.2
Hawaii,1998,5,601843,67.2,566948,63.3,34895,5.8
Idaho,1998,5,649061,71.0,615193,67.3,33868,5.2
Illinois,1998,5,6309017,68.4,6036283,65.5,272734,4.3
Indiana,1998,5,3113346,68.7,3023721,66.7,89625,2.9
Iowa,1998,5,1593131,72.0,1548111,70.0,45020,2.8
Kansas,1998,5,1395909,70.8,1344113,68.2,51796,3.7
Kentucky,1998,5,1920728,63.4,1834861,60.5,85867,4.5
Louisiana,1998,5,2033150,62.4,1919030,58.9,114120,5.6
Maine,1998,5,652405,66.9,623573,64.0,28832,4.4
Maryland,1998,5,2762667,70.6,2641936,67.5,120731,4.4
Massachusetts,1998,5,3318187,68.4,3206369,66.1,111818,3.4
Michigan,1998,5,5007138,67.4,4819210,64.9,187928,3.8
Minnesota,1998,5,2714847,75.0,2644318,73.1,70529,2.6
Mississippi,1998,5,1276162,61.8,1209030,58.5,67132,5.3
Missouri,1998,5,2947537,70.9,2822199,67.8,125338,4.3
Montana,1998,5,460797,68.2,434964,64.4,25833,5.6
Nebraska,1998,5,924666,73.1,902220,71.3,22446,2.4
Nevada,1998,5,967598,68.8,925982,65.8,41616,4.3
New Hampshire,1998,5,658256,71.7,640026,69.7,18230,2.8
New Jersey,1998,5,4229783,66.7,4033667,63.6,196116,4.6
New Mexico,1998,5,835215,63.5,782420,59.5,52795,6.3
New York,1998,5,9059821,63.0,8553281,59.5,506540,5.6
New York city,1998,5,3553843,58.6,3273740,53.9,280103,7.9
North Carolina,1998,5,3962241,66.8,3819384,64.4,142857,3.6
North Dakota,1998,5,347241,71.4,337373,69.4,9868,2.8
Ohio,1998,5,5702787,66.5,5458356,63.7,244431,4.3
Oklahoma,1998,5,1631779,64.5,1564462,61.8,67317,4.1
Oregon,1998,5,1776171,68.9,1677113,65.1,99058,5.6
Pennsylvania,1998,5,6058186,64.2,5775968,61.2,282218,4.7
Rhode Island,1998,5,530200,66.3,505890,63.3,24310,4.6
South Carolina,1998,5,1932842,65.7,1866196,63.5,66646,3.4
South Dakota,1998,5,396904,72.0,385525,70.0,11379,2.9
Tennessee,1998,5,2800115,65.6,2679306,62.8,120809,4.3
Texas,1998,5,10091522,69.1,9590282,65.7,501240,5.0
Utah,1998,5,1100531,72.3,1060904,69.7,39627,3.6
Vermont,1998,5,333653,72.1,321795,69.6,11858,3.6
Virginia,1998,5,3488292,67.6,3393675,65.7,94617,2.7
Washington,1998,5,3023126,69.7,2880723,66.4,142403,4.7
West Virginia,1998,5,794971,55.4,741453,51.7,53518,6.7
Wisconsin,1998,5,2967088,74.0,2872940,71.6,94148,3.2
Wyoming,1998,5,259827,71.0,247451,67.6,12376,4.8
Alabama,1998,6,2141637,64.1,2046918,61.3,94719,4.4
Alaska,1998,6,314947,73.9,295026,69.2,19921,6.3
Arizona,1998,6,2381871,64.8,2281558,62.1,100313,4.2
Arkansas,1998,6,1244120,62.8,1181368,59.7,62752,5.0
California,1998,6,16161125,66.6,15199560,62.7,961565,5.9
Los Angeles County,1998,6,4545283,66.4,4247344,62.1,297939,6.6
Colorado,1998,6,2305772,74.2,2219338,71.4,86434,3.7
Connecticut,1998,6,1739265,67.6,1682740,65.4,56525,3.2
Delaware,1998,6,396726,68.3,382277,65.8,14449,3.6
District of Columbia,1998,6,293544,64.9,268936,59.5,24608,8.4
Florida,1998,6,7533239,62.5,7197974,59.8,335265,4.5
Georgia,1998,6,4044437,69.2,3874235,66.3,170202,4.2
Hawaii,1998,6,602796,67.3,567446,63.4,35350,5.9
Idaho,1998,6,650977,71.1,617144,67.4,33833,5.2
Illinois,1998,6,6316947,68.5,6043702,65.5,273245,4.3
Indiana,1998,6,3113932,68.6,3023396,66.6,90536,2.9
Iowa,1998,6,1593434,72.0,1548176,70.0,45258,2.8
Kansas,1998,6,1398677,70.8,1346340,68.2,52337,3.7
Kentucky,1998,6,1922136,63.4,1835563,60.5,86573,4.5
Louisiana,1998,6,2037278,62.5,1921216,58.9,116062,5.7
Maine,1998,6,653322,67.0,624491,64.1,28831,4.4
Maryland,1998,6,2761513,70.5,2641992,67.4,119521,4.3
Massachusetts,1998,6,3324392,68.5,3213227,66.2,111165,3.3
Michigan,1998,6,5009284,67.4,4820253,64.9,189031,3.8
Minnesota,1998,6,2715894,75.0,2645378,73.0,70516,2.6
Mississippi,1998,6,1275846,61.7,1208831,58.5,67015,5.3
Missouri,1998,6,2947890,70.8,2824966,67.9,122924,4.2
Montana,1998,6,461631,68.3,435769,64.5,25862,5.6
Nebraska,1998,6,925725,73.1,902928,71.3,22797,2.5
Nevada,1998,6,972729,68.9,931512,66.0,41217,4.2
New Hampshire,1998,6,659967,71.8,641858,69.8,18109,2.7
New Jersey,1998,6,4228933,66.6,4037199,63.6,191734,4.5
New Mexico,1998,6,835866,63.5,782940,59.5,52926,6.3
New York,1998,6,9062760,63.0,8562593,59.6,500167,5.5
New York city,1998,6,3554232,58.5,3278462,54.0,275770,7.8
North Carolina,1998,6,3966610,66.8,3825834,64.4,140776,3.5
North Dakota,1998,6,346936,71.3,336873,69.3,10063,2.9
Ohio,1998,6,5702210,66.5,5455660,63.6,246550,4.3
Oklahoma,1998,6,1634873,64.5,1565963,61.8,68910,4.2
Oregon,1998,6,1777991,68.9,1677324,65.0,100667,5.7
Pennsylvania,1998,6,6058038,64.2,5776457,61.2,281581,4.6
Rhode Island,1998,6,530438,66.2,506561,63.3,23877,4.5
South Carolina,1998,6,1937969,65.8,1869127,63.5,68842,3.6
South Dakota,1998,6,397404,72.1,386082,70.1,11322,2.8
Tennessee,1998,6,2806184,65.7,2685713,62.9,120471,4.3
Texas,1998,6,10118364,69.2,9609464,65.7,508900,5.0
Utah,1998,6,1103385,72.4,1063320,69.8,40065,3.6
Vermont,1998,6,334319,72.1,322519,69.6,11800,3.5
Virginia,1998,6,3497375,67.7,3401813,65.8,95562,2.7
Washington,1998,6,3029648,69.7,2885227,66.4,144421,4.8
West Virginia,1998,6,795397,55.5,741976,51.7,53421,6.7
Wisconsin,1998,6,2966613,73.9,2870282,71.5,96331,3.2
Wyoming,1998,6,260287,70.9,247766,67.5,12521,4.8
Alabama,1998,7,2141431,64.0,2045672,61.2,95759,4.5
Alaska,1998,7,315238,74.0,295090,69.3,20148,6.4
Arizona,1998,7,2392194,64.9,2291444,62.2,100750,4.2
Arkansas,1998,7,1245540,62.9,1182653,59.7,62887,5.0
California,1998,7,16193744,66.7,15227742,62.7,966002,6.0
Los Angeles County,1998,7,4552104,66.4,4251103,62.0,301001,6.6
Colorado,1998,7,2311565,74.3,2224574,71.5,86991,3.8
Connecticut,1998,7,1740286,67.6,1685295,65.5,54991,3.2
Delaware,1998,7,397381,68.3,382939,65.8,14442,3.6
District of Columbia,1998,7,293302,64.8,268873,59.4,24429,8.3
Florida,1998,7,7549448,62.6,7215568,59.8,333880,4.4
Georgia,1998,7,4052507,69.2,3882007,66.3,170500,4.2
Hawaii,1998,7,603659,67.3,567868,63.3,35791,5.9
Idaho,1998,7,652996,71.2,619014,67.5,33982,5.2
Illinois,1998,7,6329871,68.6,6052083,65.6,277788,4.4
Indiana,1998,7,3116461,68.7,3023836,66.6,92625,3.0
Iowa,1998,7,1593919,72.0,1548456,69.9,45463,2.9
Kansas,1998,7,1401480,71.0,1348633,68.3,52847,3.8
Kentucky,1998,7,1923442,63.4,1836210,60.5,87232,4.5
Louisiana,1998,7,2038860,62.5,1921925,58.9,116935,5.7
Maine,1998,7,654711,67.1,625579,64.1,29132,4.4
Maryland,1998,7,2760794,70.4,2642589,67.4,118205,4.3
Massachusetts,1998,7,3332005,68.6,3220989,66.3,111016,3.3
Michigan,1998,7,4979160,67.0,4745637,63.9,233523,4.7
Minnesota,1998,7,2716661,74.9,2645299,73.0,71362,2.6
Mississippi,1998,7,1275623,61.7,1208629,58.4,66994,5.3
Missouri,1998,7,2948122,70.8,2827848,67.9,120274,4.1
Montana,1998,7,462725,68.4,436714,64.6,26011,5.6
Nebraska,1998,7,926918,73.2,903630,71.4,23288,2.5
Nevada,1998,7,977761,69.0,936882,66.1,40879,4.2
New Hampshire,1998,7,661844,71.9,643684,69.9,18160,2.7
New Jersey,1998,7,4229040,66.6,4040407,63.6,188633,4.5
New Mexico,1998,7,836235,63.5,783246,59.4,52989,6.3
New York,1998,7,9069095,63.0,8571754,59.6,497341,5.5
New York city,1998,7,3557158,58.5,3283190,54.0,273968,7.7
North Carolina,1998,7,3971327,66.8,3832107,64.4,139220,3.5
North Dakota,1998,7,346759,71.3,336453,69.2,10306,3.0
Ohio,1998,7,5704868,66.5,5455407,63.6,249461,4.4
Oklahoma,1998,7,1637493,64.6,1567582,61.8,69911,4.3
Oregon,1998,7,1779566,68.9,1677361,64.9,102205,5.7
Pennsylvania,1998,7,6059297,64.2,5777102,61.2,282195,4.7
Rhode Island,1998,7,531068,66.3,507446,63.3,23622,4.4
South Carolina,1998,7,1943441,65.9,1872018,63.5,71423,3.7
South Dakota,1998,7,398003,72.2,386697,70.2,11306,2.8
Tennessee,1998,7,2812514,65.8,2692034,63.0,120480,4.3
Texas,1998,7,10142571,69.2,9627400,65.7,515171,5.1
Utah,1998,7,1105990,72.5,1065655,69.8,40335,3.6
Vermont,1998,7,334864,72.2,323164,69.7,11700,3.5
Virginia,1998,7,3506102,67.8,3408878,65.9,97224,2.8
Washington,1998,7,3036139,69.7,2888825,66.4,147314,4.9
West Virginia,1998,7,795657,55.5,742372,51.8,53285,6.7
Wisconsin,1998,7,2965905,73.9,2866954,71.4,98951,3.3
Wyoming,1998,7,260703,71.0,248052,67.6,12651,4.9
Alabama,1998,8,2141496,64.0,2044872,61.1,96624,4.5
Alaska,1998,8,315551,73.9,295260,69.1,20291,6.4
Arizona,1998,8,2403044,65.1,2301473,62.3,101571,4.2
Arkansas,1998,8,1246904,62.9,1183779,59.7,63125,5.1
California,1998,8,16225922,66.7,15257102,62.7,968820,6.0
Los Angeles County,1998,8,4558863,66.4,4255701,62.0,303162,6.6
Colorado,1998,8,2316791,74.3,2229897,71.5,86894,3.8
Connecticut,1998,8,1741524,67.7,1687975,65.6,53549,3.1
Delaware,1998,8,397826,68.2,383510,65.8,14316,3.6
District of Columbia,1998,8,293067,64.7,268837,59.3,24230,8.3
Florida,1998,8,7568241,62.6,7235880,59.9,332361,4.4
Georgia,1998,8,4060920,69.2,3890472,66.3,170448,4.2
Hawaii,1998,8,604333,67.4,568279,63.4,36054,6.0
Idaho,1998,8,654956,71.3,620769,67.5,34187,5.2
Illinois,1998,8,6345473,68.7,6062120,65.6,283353,4.5
Indiana,1998,8,3120931,68.7,3026004,66.6,94927,3.0
Iowa,1998,8,1594464,72.0,1548812,70.0,45652,2.9
Kansas,1998,8,1404032,71.0,1350963,68.3,53069,3.8
Kentucky,1998,8,1924829,63.4,1837170,60.5,87659,4.6
Louisiana,1998,8,2037809,62.4,1921421,58.8,116388,5.7
Maine,1998,8,656352,67.2,627023,64.2,29329,4.5
Maryland,1998,8,2760627,70.4,2644420,67.4,116207,4.2
Massachusetts,1998,8,3340295,68.8,3229203,66.5,111092,3.3
Michigan,1998,8,5022617,67.5,4826928,64.9,195689,3.9
Minnesota,1998,8,2717879,74.8,2645321,72.8,72558,2.7
Mississippi,1998,8,1275662,61.6,1208693,58.4,66969,5.2
Missouri,1998,8,2947973,70.7,2830846,67.9,117127,4.0
Montana,1998,8,463926,68.6,437734,64.7,26192,5.6
Nebraska,1998,8,928200,73.2,904319,71.4,23881,2.6
Nevada,1998,8,982659,69.1,942138,66.3,40521,4.1
New Hampshire,1998,8,664019,72.0,645659,70.0,18360,2.8
New Jersey,1998,8,4230394,66.5,4043764,63.6,186630,4.4
New Mexico,1998,8,836343,63.4,783544,59.4,52799,6.3
New York,1998,8,9077460,63.1,8580999,59.6,496461,5.5
New York city,1998,8,3562248,58.5,3288284,54.0,273964,7.7
North Carolina,1998,8,3976374,66.8,3838501,64.5,137873,3.5
North Dakota,1998,8,346673,71.3,336114,69.1,10559,3.0
Ohio,1998,8,5709791,66.6,5457965,63.6,251826,4.4
Oklahoma,1998,8,1639860,64.6,1569705,61.8,70155,4.3
Oregon,1998,8,1780897,68.9,1677482,64.9,103415,5.8
Pennsylvania,1998,8,6061663,64.2,5778427,61.2,283236,4.7
Rhode Island,1998,8,532075,66.4,508552,63.4,23523,4.4
South Carolina,1998,8,1948792,66.0,1875149,63.5,73643,3.8
South Dakota,1998,8,398681,72.2,387363,70.1,11318,2.8
Tennessee,1998,8,2818788,65.9,2698245,63.1,120543,4.3
Texas,1998,8,10162921,69.3,9645403,65.7,517518,5.1
Utah,1998,8,1108415,72.5,1067983,69.9,40432,3.6
Vermont,1998,8,335332,72.2,323800,69.7,11532,3.4
Virginia,1998,8,3513986,67.9,3415142,66.0,98844,2.8
Washington,1998,8,3042244,69.8,2892135,66.4,150109,4.9
West Virginia,1998,8,795859,55.5,742791,51.8,53068,6.7
Wisconsin,1998,8,2965044,73.8,2863841,71.3,101203,3.4
Wyoming,1998,8,261075,71.1,248354,67.6,12721,4.9
Alabama,1998,9,2142100,64.0,2044910,61.1,97190,4.5
Alaska,1998,9,315921,74.0,295561,69.2,20360,6.4
Arizona,1998,9,2414525,65.3,2311749,62.5,102776,4.3
Arkansas,1998,9,1248337,62.8,1185046,59.7,63291,5.1
California,1998,9,16256955,66.7,15288403,62.7,968552,6.0
Los Angeles County,1998,9,4563929,66.4,4259966,62.0,303963,6.7
Colorado,1998,9,2321189,74.2,2235298,71.5,85891,3.7
Connecticut,1998,9,1743017,67.7,1690862,65.7,52155,3.0
Delaware,1998,9,398078,68.3,384022,65.9,14056,3.5
District of Columbia,1998,9,293150,64.7,269186,59.4,23964,8.2
Florida,1998,9,7588751,62.7,7258379,60.0,330372,4.4
Georgia,1998,9,4069995,69.2,3900046,66.3,169949,4.2
Hawaii,1998,9,604728,67.4,568655,63.4,36073,6.0
Idaho,1998,9,656607,71.4,622278,67.6,34329,5.2
Illinois,1998,9,6361241,68.8,6073939,65.7,287302,4.5
Indiana,1998,9,3126488,68.8,3029840,66.7,96648,3.1
Iowa,1998,9,1594932,72.0,1549048,69.9,45884,2.9
Kansas,1998,9,1406182,71.1,1353296,68.4,52886,3.8
Kentucky,1998,9,1926663,63.4,1838697,60.5,87966,4.6
Louisiana,1998,9,2035414,62.3,1920619,58.8,114795,5.6
Maine,1998,9,658050,67.3,628870,64.3,29180,4.4
Maryland,1998,9,2761136,70.3,2647697,67.4,113439,4.1
Massachusetts,1998,9,3348186,68.9,3236949,66.6,111237,3.3
Michigan,1998,9,5032502,67.6,4833601,65.0,198901,4.0
Minnesota,1998,9,2720080,74.8,2646511,72.8,73569,2.7
Mississippi,1998,9,1275832,61.6,1209124,58.4,66708,5.2
Missouri,1998,9,2947318,70.6,2833971,67.9,113347,3.8
Montana,1998,9,465058,68.6,438721,64.8,26337,5.7
Nebraska,1998,9,929417,73.3,904967,71.3,24450,2.6
Nevada,1998,9,987398,69.2,947296,66.4,40102,4.1
New Hampshire,1998,9,666474,72.2,647805,70.2,18669,2.8
New Jersey,1998,9,4233575,66.5,4048245,63.6,185330,4.4
New Mexico,1998,9,836342,63.3,784008,59.4,52334,6.3
New York,1998,9,9086383,63.1,8590251,59.6,496132,5.5
New York city,1998,9,3568689,58.6,3294133,54.1,274556,7.7
North Carolina,1998,9,3982338,66.8,3845858,64.5,136480,3.4
North Dakota,1998,9,346655,71.2,335860,69.0,10795,3.1
Ohio,1998,9,5715893,66.6,5462883,63.7,253010,4.4
Oklahoma,1998,9,1642299,64.6,1572521,61.9,69778,4.2
Oregon,1998,9,1782215,68.8,1677993,64.8,104222,5.8
Pennsylvania,1998,9,6065569,64.2,5781637,61.2,283932,4.7
Rhode Island,1998,9,533324,66.5,509763,63.5,23561,4.4
South Carolina,1998,9,1953858,66.1,1878583,63.6,75275,3.9
South Dakota,1998,9,399393,72.3,388057,70.3,11336,2.8
Tennessee,1998,9,2825037,66.0,2704261,63.1,120776,4.3
Texas,1998,9,10179313,69.3,9663832,65.7,515481,5.1
Utah,1998,9,1110756,72.5,1070328,69.9,40428,3.6
Vermont,1998,9,335827,72.3,324496,69.9,11331,3.4
Virginia,1998,9,3521024,67.9,3421380,66.0,99644,2.8
Washington,1998,9,3047995,69.9,2895899,66.4,152096,5.0
West Virginia,1998,9,796203,55.5,743365,51.8,52838,6.6
Wisconsin,1998,9,2964536,73.7,2861874,71.2,102662,3.5
Wyoming,1998,9,261444,71.2,248688,67.7,12756,4.9
Alabama,1998,10,2143068,64.0,2045738,61.1,97330,4.5
Alaska,1998,10,316366,73.9,295990,69.1,20376,6.4
Arizona,1998,10,2425980,65.4,2322033,62.6,103947,4.3
Arkansas,1998,10,1249624,62.9,1186622,59.7,63002,5.0
California,1998,10,16283158,66.7,15320806,62.8,962352,5.9
Los Angeles County,1998,10,4565225,66.4,4262745,62.0,302480,6.6
Colorado,1998,10,2324291,74.2,2240675,71.5,83616,3.6
Connecticut,1998,10,1744301,67.7,1693662,65.7,50639,2.9
Delaware,1998,10,398144,68.2,384474,65.8,13670,3.4
District of Columbia,1998,10,293731,64.7,270185,59.5,23546,8.0
Florida,1998,10,7608367,62.7,7281208,60.0,327159,4.3
Georgia,1998,10,4078974,69.3,3910174,66.4,168800,4.1
Hawaii,1998,10,604686,67.4,568931,63.4,35755,5.9
Idaho,1998,10,657706,71.3,623392,67.6,34314,5.2
Illinois,1998,10,6374446,68.9,6087261,65.8,287185,4.5
Indiana,1998,10,3131295,68.8,3034564,66.7,96731,3.1
Iowa,1998,10,1595085,72.0,1549161,69.9,45924,2.9
Kansas,1998,10,1407777,71.1,1355597,68.5,52180,3.7
Kentucky,1998,10,1928764,63.4,1840731,60.5,88033,4.6
Louisiana,1998,10,2032895,62.2,1920402,58.7,112493,5.5
Maine,1998,10,659607,67.5,630966,64.5,28641,4.3
Maryland,1998,10,2761955,70.3,2651941,67.5,110014,4.0
Massachusetts,1998,10,3354428,68.9,3243374,66.6,111054,3.3
Michigan,1998,10,5042713,67.7,4841840,65.0,200873,4.0
Minnesota,1998,10,2722955,74.8,2649177,72.8,73778,2.7
Mississippi,1998,10,1275934,61.5,1209896,58.3,66038,5.2
Missouri,1998,10,2946015,70.6,2837202,67.9,108813,3.7
Montana,1998,10,465927,68.8,439559,64.9,26368,5.7
Nebraska,1998,10,930311,73.3,905516,71.4,24795,2.7
Nevada,1998,10,991864,69.3,952300,66.5,39564,4.0
New Hampshire,1998,10,668967,72.3,650000,70.3,18967,2.8
New Jersey,1998,10,4238341,66.6,4054254,63.7,184087,4.3
New Mexico,1998,10,836227,63.3,784640,59.4,51587,6.2
New York,1998,10,9093778,63.1,8599246,59.7,494532,5.4
New York city,1998,10,3574308,58.6,3300522,54.1,273786,7.7
North Carolina,1998,10,3989054,66.8,3854486,64.5,134568,3.4
North Dakota,1998,10,346580,71.2,335608,69.0,10972,3.2
Ohio,1998,10,5721347,66.7,5469359,63.7,251988,4.4
Oklahoma,1998,10,1644758,64.7,1575962,61.9,68796,4.2
Oregon,1998,10,1783725,68.8,1679159,64.8,104566,5.9
Pennsylvania,1998,10,6070281,64.2,5787362,61.3,282919,4.7
Rhode Island,1998,10,534512,66.6,511006,63.7,23506,4.4
South Carolina,1998,10,1958098,66.2,1881781,63.6,76317,3.9
South Dakota,1998,10,400078,72.3,388743,70.2,11335,2.8
Tennessee,1998,10,2830903,66.0,2710037,63.2,120866,4.3
Texas,1998,10,10190794,69.2,9682154,65.8,508640,5.0
Utah,1998,10,1112980,72.5,1072635,69.9,40345,3.6
Vermont,1998,10,336387,72.4,325252,70.0,11135,3.3
Virginia,1998,10,3526668,67.9,3427634,66.0,99034,2.8
Washington,1998,10,3053126,69.9,2900395,66.4,152731,5.0
West Virginia,1998,10,796577,55.6,744099,51.9,52478,6.6
Wisconsin,1998,10,2963996,73.7,2861309,71.1,102687,3.5
Wyoming,1998,10,261807,71.3,249052,67.8,12755,4.9
Alabama,1998,11,2144105,64.0,2046835,61.1,97270,4.5
Alaska,1998,11,316821,73.8,296444,69.1,20377,6.4
Arizona,1998,11,2436877,65.6,2331824,62.8,105053,4.3
Arkansas,1998,11,1250504,62.8,1188432,59.7,62072,5.0
California,1998,11,16302073,66.7,15351428,62.8,950645,5.8
Los Angeles County,1998,11,4561877,66.2,4263159,61.9,298718,6.5
Colorado,1998,11,2326015,74.0,2245785,71.5,80230,3.4
Connecticut,1998,11,1744995,67.7,1695937,65.8,49058,2.8
Delaware,1998,11,398061,68.1,384819,65.9,13242,3.3
District of Columbia,1998,11,294752,64.9,271755,59.8,22997,7.8
Florida,1998,11,7624544,62.8,7301630,60.1,322914,4.2
Georgia,1998,11,4086788,69.3,3919545,66.4,167243,4.1
Hawaii,1998,11,604214,67.3,569017,63.4,35197,5.8
Idaho,1998,11,658077,71.3,623923,67.6,34154,5.2
Illinois,1998,11,6383802,68.9,6101211,65.9,282591,4.4
Indiana,1998,11,3133576,68.8,3038601,66.8,94975,3.0
Iowa,1998,11,1594968,71.9,1549349,69.9,45619,2.9
Kansas,1998,11,1408581,71.1,1357494,68.5,51087,3.6
Kentucky,1998,11,1930837,63.4,1842915,60.5,87922,4.6
Louisiana,1998,11,2030873,62.1,1920977,58.7,109896,5.4
Maine,1998,11,660806,67.5,633006,64.7,27800,4.2
Maryland,1998,11,2762615,70.2,2656142,67.5,106473,3.9
Massachusetts,1998,11,3358407,68.9,3247800,66.7,110607,3.3
Michigan,1998,11,5051752,67.8,4849893,65.1,201859,4.0
Minnesota,1998,11,2725732,74.8,2652803,72.8,72929,2.7
Mississippi,1998,11,1275768,61.5,1210737,58.4,65031,5.1
Missouri,1998,11,2943923,70.4,2839967,68.0,103956,3.5
Montana,1998,11,466456,68.8,440209,64.9,26247,5.6
Nebraska,1998,11,930599,73.3,905743,71.3,24856,2.7
Nevada,1998,11,995975,69.4,956983,66.7,38992,3.9
New Hampshire,1998,11,671180,72.5,652019,70.4,19161,2.9
New Jersey,1998,11,4244178,66.6,4061122,63.7,183056,4.3
New Mexico,1998,11,836007,63.2,785295,59.4,50712,6.1
New York,1998,11,9097877,63.1,8606606,59.7,491271,5.4
New York city,1998,11,3577384,58.6,3306668,54.2,270716,7.6
North Carolina,1998,11,3995956,66.8,3863963,64.6,131993,3.3
North Dakota,1998,11,346267,71.1,335184,68.9,11083,3.2
Ohio,1998,11,5725153,66.7,5475697,63.8,249456,4.4
Oklahoma,1998,11,1646896,64.7,1579474,62.0,67422,4.1
Oregon,1998,11,1785330,68.8,1681001,64.8,104329,5.8
Pennsylvania,1998,11,6074761,64.3,5794514,61.3,280247,4.6
Rhode Island,1998,11,535382,66.7,512217,63.8,23165,4.3
South Carolina,1998,11,1961052,66.2,1884023,63.6,77029,3.9
South Dakota,1998,11,400639,72.4,389334,70.3,11305,2.8
Tennessee,1998,11,2835742,66.1,2715218,63.3,120524,4.3
Texas,1998,11,10197118,69.1,9698755,65.8,498363,4.9
Utah,1998,11,1114958,72.5,1074724,69.9,40234,3.6
Vermont,1998,11,336971,72.4,325989,70.0,10982,3.3
Virginia,1998,11,3530602,67.9,3433272,66.1,97330,2.8
Washington,1998,11,3057025,69.9,2905240,66.4,151785,5.0
West Virginia,1998,11,796922,55.6,744827,51.9,52095,6.5
Wisconsin,1998,11,2962609,73.6,2861529,71.1,101080,3.4
Wyoming,1998,11,262157,71.2,249427,67.7,12730,4.9
Alabama,1998,12,2145047,64.0,2047579,61.1,97468,4.5
Alaska,1998,12,317241,73.9,296793,69.2,20448,6.4
Arizona,1998,12,2447015,65.8,2340441,62.9,106574,4.4
Arkansas,1998,12,1250945,62.8,1190253,59.8,60692,4.9
California,1998,12,16314638,66.6,15378088,62.8,936550,5.7
Los Angeles County,1998,12,4555428,66.0,4261958,61.8,293470,6.4
Colorado,1998,12,2326640,73.9,2250216,71.5,76424,3.3
Connecticut,1998,12,1745040,67.7,1697404,65.8,47636,2.7
Delaware,1998,12,397927,68.0,385026,65.8,12901,3.2
District of Columbia,1998,12,296079,65.1,273629,60.2,22450,7.6
Florida,1998,12,7636382,62.8,7317505,60.2,318877,4.2
Georgia,1998,12,4092818,69.3,3927083,66.4,165735,4.0
Hawaii,1998,12,603509,67.2,568931,63.3,34578,5.7
Idaho,1998,12,657684,71.1,623701,67.4,33983,5.2
Illinois,1998,12,6390685,69.0,6114453,66.0,276232,4.3
Indiana,1998,12,3132859,68.8,3040477,66.8,92382,2.9
Iowa,1998,12,1594581,71.8,1549553,69.8,45028,2.8
Kansas,1998,12,1408446,71.1,1358526,68.5,49920,3.5
Kentucky,1998,12,1932908,63.4,1844969,60.5,87939,4.5
Louisiana,1998,12,2029105,62.0,1921640,58.7,107465,5.3
Maine,1998,12,661538,67.5,634572,64.8,26966,4.1
Maryland,1998,12,2763048,70.2,2659495,67.6,103553,3.7
Massachusetts,1998,12,3360348,68.9,3250033,66.7,110315,3.3
Michigan,1998,12,5059051,67.9,4856451,65.2,202600,4.0
Minnesota,1998,12,2727728,74.7,2656349,72.8,71379,2.6
Mississippi,1998,12,1275206,61.4,1211176,58.3,64030,5.0
Missouri,1998,12,2941316,70.3,2841687,68.0,99629,3.4
Montana,1998,12,466647,68.8,440614,65.0,26033,5.6
Nebraska,1998,12,930164,73.2,905414,71.3,24750,2.7
Nevada,1998,12,999743,69.4,961152,66.7,38591,3.9
New Hampshire,1998,12,672880,72.6,653665,70.5,19215,2.9
New Jersey,1998,12,4250838,66.7,4067947,63.8,182891,4.3
New Mexico,1998,12,835665,63.1,785769,59.4,49896,6.0
New York,1998,12,9097840,63.0,8610676,59.7,487164,5.4
New York city,1998,12,3577493,58.6,3311724,54.2,265769,7.4
North Carolina,1998,12,4002518,66.8,3873264,64.7,129254,3.2
North Dakota,1998,12,345645,71.0,334497,68.7,11148,3.2
Ohio,1998,12,5727531,66.7,5480409,63.8,247122,4.3
Oklahoma,1998,12,1648520,64.7,1582502,62.1,66018,4.0
Oregon,1998,12,1786482,68.8,1682949,64.8,103533,5.8
Pennsylvania,1998,12,6078670,64.3,5801518,61.4,277152,4.6
Rhode Island,1998,12,535898,66.7,513320,63.9,22578,4.2
South Carolina,1998,12,1962732,66.1,1885006,63.5,77726,4.0
South Dakota,1998,12,401020,72.4,389759,70.4,11261,2.8
Tennessee,1998,12,2838879,66.1,2719000,63.3,119879,4.2
Texas,1998,12,10200471,69.0,9711967,65.7,488504,4.8
Utah,1998,12,1116584,72.5,1076388,69.9,40196,3.6
Vermont,1998,12,337529,72.5,326638,70.1,10891,3.2
Virginia,1998,12,3532765,67.9,3437251,66.1,95514,2.7
Washington,1998,12,3059091,69.9,2909204,66.4,149887,4.9
West Virginia,1998,12,797263,55.6,745253,52.0,52010,6.5
Wisconsin,1998,12,2960141,73.4,2861555,71.0,98586,3.3
Wyoming,1998,12,262468,71.3,249742,67.8,12726,4.8
Alabama,1999,1,2145883,64.0,2047925,61.1,97958,4.6
Alaska,1999,1,317506,73.8,296955,69.0,20551,6.5
Arizona,1999,1,2456251,65.9,2347725,63.0,108526,4.4
Arkansas,1999,1,1251062,62.7,1191937,59.8,59125,4.7
California,1999,1,16323209,66.6,15402202,62.8,921007,5.6
Los Angeles County,1999,1,4547992,65.9,4260889,61.7,287103,6.3
Colorado,1999,1,2326817,73.7,2253833,71.4,72984,3.1
Connecticut,1999,1,1744288,67.6,1697878,65.8,46410,2.7
Delaware,1999,1,397786,67.8,385087,65.7,12699,3.2
District of Columbia,1999,1,297673,65.4,275729,60.6,21944,7.4
Florida,1999,1,7645106,62.8,7330040,60.2,315066,4.1
Georgia,1999,1,4097159,69.2,3933171,66.4,163988,4.0
Hawaii,1999,1,602787,67.1,568864,63.3,33923,5.6
Idaho,1999,1,656653,70.9,622828,67.3,33825,5.2
Illinois,1999,1,6396961,69.0,6126346,66.1,270615,4.2
Indiana,1999,1,3129901,68.7,3039983,66.7,89918,2.9
Iowa,1999,1,1594190,71.8,1549965,69.8,44225,2.8
Kansas,1999,1,1407550,71.0,1358695,68.5,48855,3.5
Kentucky,1999,1,1935358,63.4,1847211,60.6,88147,4.6
Louisiana,1999,1,2027133,61.9,1921887,58.7,105246,5.2
Maine,1999,1,661916,67.5,635521,64.8,26395,4.0
Maryland,1999,1,2763253,70.2,2661901,67.6,101352,3.7
Massachusetts,1999,1,3360938,68.9,3250723,66.7,110215,3.3
Michigan,1999,1,5064723,67.9,4861891,65.2,202832,4.0
Minnesota,1999,1,2728597,74.7,2658938,72.8,69659,2.6
Mississippi,1999,1,1274385,61.3,1211180,58.3,63205,5.0
Missouri,1999,1,2939130,70.2,2842540,67.9,96590,3.3
Montana,1999,1,466542,68.8,440805,65.0,25737,5.5
Nebraska,1999,1,929210,73.1,904604,71.1,24606,2.6
Nevada,1999,1,1003285,69.4,964841,66.8,38444,3.8
New Hampshire,1999,1,673921,72.6,654827,70.5,19094,2.8
New Jersey,1999,1,4257520,66.7,4073672,63.9,183848,4.3
New Mexico,1999,1,835220,63.0,786064,59.3,49156,5.9
New York,1999,1,9094074,63.0,8611289,59.6,482785,5.3
New York city,1999,1,3574996,58.5,3315384,54.3,259612,7.3
North Carolina,1999,1,4008017,66.8,3881016,64.7,127001,3.2
North Dakota,1999,1,344789,71.0,333644,68.7,11145,3.2
Ohio,1999,1,5728281,66.7,5482706,63.8,245575,4.3
Oklahoma,1999,1,1649706,64.7,1585001,62.1,64705,3.9
Oregon,1999,1,1786516,68.7,1684299,64.8,102217,5.7
Pennsylvania,1999,1,6082056,64.3,5808045,61.4,274011,4.5
Rhode Island,1999,1,536139,66.7,514233,63.9,21906,4.1
South Carolina,1999,1,1963455,66.1,1885007,63.5,78448,4.0
South Dakota,1999,1,401247,72.5,390053,70.4,11194,2.8
Tennessee,1999,1,2839899,66.1,2721154,63.3,118745,4.2
Texas,1999,1,10203530,69.0,9722444,65.7,481086,4.7
Utah,1999,1,1117910,72.6,1077674,69.9,40236,3.6
Vermont,1999,1,337996,72.4,327174,70.1,10822,3.2
Virginia,1999,1,3533720,67.8,3439676,66.0,94044,2.7
Washington,1999,1,3059237,69.8,2911412,66.4,147825,4.8
West Virginia,1999,1,797471,55.6,745295,52.0,52176,6.5
Wisconsin,1999,1,2956895,73.3,2861202,71.0,95693,3.2
Wyoming,1999,1,262720,71.3,249972,67.9,12748,4.9
Alabama,1999,2,2146853,64.0,2048086,61.0,98767,4.6
Alaska,1999,2,317628,73.9,296974,69.1,20654,6.5
Arizona,1999,2,2464632,66.0,2353853,63.0,110779,4.5
Arkansas,1999,2,1251256,62.7,1193443,59.8,57813,4.6
California,1999,2,16333134,66.5,15426805,62.8,906329,5.5
Los Angeles County,1999,2,4542877,65.7,4262142,61.7,280735,6.2
Colorado,1999,2,2327515,73.6,2256884,71.4,70631,3.0
Connecticut,1999,2,1742869,67.6,1697421,65.8,45448,2.6
Delaware,1999,2,397686,67.8,385038,65.7,12648,3.2
District of Columbia,1999,2,299464,65.8,277950,61.1,21514,7.2
Florida,1999,2,7653316,62.7,7341549,60.2,311767,4.1
Georgia,1999,2,4100694,69.2,3938692,66.4,162002,4.0
Hawaii,1999,2,602286,67.0,568957,63.3,33329,5.5
Idaho,1999,2,655382,70.7,621686,67.1,33696,5.1
Illinois,1999,2,6405177,69.1,6136810,66.2,268367,4.2
Indiana,1999,2,3125995,68.6,3037775,66.7,88220,2.8
Iowa,1999,2,1594329,71.8,1550861,69.9,43468,2.7
Kansas,1999,2,1406407,70.9,1358254,68.5,48153,3.4
Kentucky,1999,2,1938495,63.5,1849929,60.6,88566,4.6
Louisiana,1999,2,2024930,61.8,1921718,58.7,103212,5.1
Maine,1999,2,662245,67.5,636044,64.9,26201,4.0
Maryland,1999,2,2763463,70.1,2663667,67.6,99796,3.6
Massachusetts,1999,2,3361175,68.9,3250730,66.6,110445,3.3
Michigan,1999,2,5069566,68.0,4867018,65.3,202548,4.0
Minnesota,1999,2,2729460,74.6,2660671,72.7,68789,2.5
Mississippi,1999,2,1273838,61.3,1211104,58.3,62734,4.9
Missouri,1999,2,2938186,70.2,2842884,67.9,95302,3.2
Montana,1999,2,466319,68.6,440891,64.9,25428,5.5
Nebraska,1999,2,928127,73.0,903570,71.0,24557,2.6
Nevada,1999,2,1006835,69.5,968187,66.8,38648,3.8
New Hampshire,1999,2,674329,72.5,655462,70.5,18867,2.8
New Jersey,1999,2,4264230,66.8,4077829,63.9,186401,4.4
New Mexico,1999,2,834812,63.0,786249,59.3,48563,5.8
New York,1999,2,9089825,62.9,8610048,59.6,479777,5.3
New York city,1999,2,3572171,58.4,3318144,54.3,254027,7.1
North Carolina,1999,2,4012867,66.8,3886879,64.7,125988,3.1
North Dakota,1999,2,343883,70.8,332772,68.5,11111,3.2
Ohio,1999,2,5729075,66.7,5483653,63.9,245422,4.3
Oklahoma,1999,2,1650714,64.7,1587351,62.2,63363,3.8
Oregon,1999,2,1785533,68.6,1684773,64.8,100760,5.6
Pennsylvania,1999,2,6085549,64.4,5813808,61.5,271741,4.5
Rhode Island,1999,2,536319,66.7,514927,64.1,21392,4.0
South Carolina,1999,2,1963509,66.0,1884411,63.4,79098,4.0
South Dakota,1999,2,401392,72.4,390268,70.3,11124,2.8
Tennessee,1999,2,2839759,66.0,2722599,63.3,117160,4.1
Texas,1999,2,10209003,68.9,9731758,65.7,477245,4.7
Utah,1999,2,1119080,72.5,1078735,69.9,40345,3.6
Vermont,1999,2,338352,72.5,327579,70.2,10773,3.2
Virginia,1999,2,3534749,67.8,3441525,66.0,93224,2.6
Washington,1999,2,3058412,69.7,2911961,66.4,146451,4.8
West Virginia,1999,2,797617,55.6,745163,52.0,52454,6.6
Wisconsin,1999,2,2953342,73.2,2860504,70.9,92838,3.1
Wyoming,1999,2,262937,71.4,250151,67.9,12786,4.9
Alabama,1999,3,2148065,64.0,2048175,61.0,99890,4.7
Alaska,1999,3,317707,73.7,296946,68.9,20761,6.5
Arizona,1999,3,2472128,66.1,2359117,63.0,113011,4.6
Arkansas,1999,3,1251918,62.7,1194867,59.8,57051,4.6
California,1999,3,16348582,66.5,15454688,62.9,893894,5.5
Los Angeles County,1999,3,4542640,65.6,4267329,61.7,275311,6.1
Colorado,1999,3,2329367,73.5,2259711,71.3,69656,3.0
Connecticut,1999,3,1741264,67.5,1696520,65.8,44744,2.6
Delaware,1999,3,397717,67.7,384999,65.5,12718,3.2
District of Columbia,1999,3,301420,66.2,280225,61.5,21195,7.0
Florida,1999,3,7662750,62.7,7353397,60.2,309353,4.0
Georgia,1999,3,4104732,69.1,3944593,66.4,160139,3.9
Hawaii,1999,3,602170,67.0,569291,63.4,32879,5.5
Idaho,1999,3,654277,70.4,620644,66.8,33633,5.1
Illinois,1999,3,6417500,69.2,6146025,66.2,271475,4.2
Indiana,1999,3,3122345,68.5,3034932,66.6,87413,2.8
Iowa,1999,3,1595270,71.8,1552207,69.9,43063,2.7
Kansas,1999,3,1405451,70.8,1357519,68.4,47932,3.4
Kentucky,1999,3,1941999,63.6,1852879,60.7,89120,4.6
Louisiana,1999,3,2022821,61.8,1921446,58.7,101375,5.0
Maine,1999,3,662807,67.5,636486,64.9,26321,4.0
Maryland,1999,3,2763965,70.1,2665320,67.6,98645,3.6
Massachusetts,1999,3,3361595,68.9,3250598,66.6,110997,3.3
Michigan,1999,3,5074625,68.0,4873380,65.3,201245,4.0
Minnesota,1999,3,2731786,74.6,2662312,72.7,69474,2.5
Mississippi,1999,3,1273926,61.3,1211276,58.3,62650,4.9
Missouri,1999,3,2938792,70.1,2843138,67.9,95654,3.3
Montana,1999,3,466179,68.6,440991,64.9,25188,5.4
Nebraska,1999,3,927273,72.9,902640,71.0,24633,2.7
Nevada,1999,3,1010585,69.6,971380,66.9,39205,3.9
New Hampshire,1999,3,674341,72.5,655718,70.5,18623,2.8
New Jersey,1999,3,4271602,66.9,4081239,63.9,190363,4.5
New Mexico,1999,3,834610,62.9,786458,59.3,48152,5.8
New York,1999,3,9088999,62.9,8610106,59.6,478893,5.3
New York city,1999,3,3571863,58.4,3321342,54.3,250521,7.0
North Carolina,1999,3,4018102,66.8,3891784,64.7,126318,3.1
North Dakota,1999,3,343097,70.6,332017,68.3,11080,3.2
Ohio,1999,3,5732170,66.7,5485492,63.9,246678,4.3
Oklahoma,1999,3,1651770,64.7,1589924,62.3,61846,3.7
Oregon,1999,3,1784155,68.5,1684579,64.7,99576,5.6
Pennsylvania,1999,3,6089976,64.4,5818845,61.5,271131,4.5
Rhode Island,1999,3,536685,66.7,515488,64.1,21197,3.9
South Carolina,1999,3,1963143,66.0,1883561,63.3,79582,4.1
South Dakota,1999,3,401560,72.4,390467,70.4,11093,2.8
Tennessee,1999,3,2839943,66.0,2724561,63.3,115382,4.1
Texas,1999,3,10218114,68.9,9741519,65.6,476595,4.7
Utah,1999,3,1120226,72.5,1079771,69.9,40455,3.6
Vermont,1999,3,338602,72.6,327866,70.3,10736,3.2
Virginia,1999,3,3536891,67.8,3443641,66.0,93250,2.6
Washington,1999,3,3057849,69.6,2911706,66.3,146143,4.8
West Virginia,1999,3,797860,55.7,745131,52.0,52729,6.6
Wisconsin,1999,3,2950389,73.1,2859948,70.9,90441,3.1
Wyoming,1999,3,263150,71.2,250321,67.8,12829,4.9
Alabama,1999,4,2149267,64.0,2048045,61.0,101222,4.7
Alaska,1999,4,317788,73.7,296968,68.9,20820,6.6
Arizona,1999,4,2478412,66.1,2363724,63.1,114688,4.6
Arkansas,1999,4,1253075,62.7,1196248,59.8,56827,4.5
California,1999,4,16370149,66.5,15486567,62.9,883582,5.4
Los Angeles County,1999,4,4548028,65.6,4276747,61.7,271281,6.0
Colorado,1999,4,2332261,73.5,2262405,71.3,69856,3.0
Connecticut,1999,4,1740067,67.4,1695908,65.7,44159,2.5
Delaware,1999,4,397939,67.7,385080,65.5,12859,3.2
District of Columbia,1999,4,303330,66.5,282373,61.9,20957,6.9
Florida,1999,4,7673412,62.7,7365693,60.2,307719,4.0
Georgia,1999,4,4110383,69.1,3951562,66.4,158821,3.9
Hawaii,1999,4,602415,67.0,569885,63.4,32530,5.4
Idaho,1999,4,653510,70.3,619903,66.7,33607,5.1
Illinois,1999,4,6433561,69.3,6154607,66.3,278954,4.3
Indiana,1999,4,3119332,68.4,3031771,66.5,87561,2.8
Iowa,1999,4,1596517,71.9,1553407,69.9,43110,2.7
Kansas,1999,4,1405022,70.7,1356786,68.3,48236,3.4
Kentucky,1999,4,1945190,63.7,1855549,60.7,89641,4.6
Louisiana,1999,4,2021184,61.7,1921299,58.6,99885,4.9
Maine,1999,4,663831,67.6,637186,64.9,26645,4.0
Maryland,1999,4,2765009,70.1,2667289,67.6,97720,3.5
Massachusetts,1999,4,3362195,68.8,3250546,66.5,111649,3.3
Michigan,1999,4,5080471,68.1,4882253,65.4,198218,3.9
Minnesota,1999,4,2735663,74.6,2664230,72.7,71433,2.6
Mississippi,1999,4,1274852,61.2,1211877,58.2,62975,4.9
Missouri,1999,4,2941037,70.2,2843748,67.8,97289,3.3
Montana,1999,4,466222,68.6,441167,65.0,25055,5.4
Nebraska,1999,4,927011,72.8,902128,70.8,24883,2.7
Nevada,1999,4,1014556,69.6,974531,66.9,40025,3.9
New Hampshire,1999,4,674200,72.4,655818,70.4,18382,2.7
New Jersey,1999,4,4278927,67.0,4084140,63.9,194787,4.6
New Mexico,1999,4,834702,62.9,786819,59.3,47883,5.7
New York,1999,4,9093451,62.9,8613345,59.6,480106,5.3
New York city,1999,4,3575938,58.4,3326228,54.3,249710,7.0
North Carolina,1999,4,4023746,66.8,3896071,64.7,127675,3.2
North Dakota,1999,4,342569,70.5,331521,68.2,11048,3.2
Ohio,1999,4,5738243,66.8,5489153,63.9,249090,4.3
Oklahoma,1999,4,1653029,64.7,1592811,62.3,60218,3.6
Oregon,1999,4,1782669,68.4,1683753,64.6,98916,5.5
Pennsylvania,1999,4,6094932,64.4,5822647,61.6,272285,4.5
Rhode Island,1999,4,537337,66.8,515992,64.1,21345,4.0
South Carolina,1999,4,1962469,65.8,1882487,63.2,79982,4.1
South Dakota,1999,4,401845,72.4,390718,70.4,11127,2.8
Tennessee,1999,4,2841150,66.0,2727502,63.3,113648,4.0
Texas,1999,4,10229711,68.8,9752200,65.6,477511,4.7
Utah,1999,4,1121410,72.4,1080886,69.8,40524,3.6
Vermont,1999,4,338731,72.6,328054,70.3,10677,3.2
Virginia,1999,4,3540243,67.8,3446170,66.0,94073,2.7
Washington,1999,4,3058180,69.6,2911381,66.2,146799,4.8
West Virginia,1999,4,798290,55.7,745392,52.0,52898,6.6
Wisconsin,1999,4,2949008,73.0,2860114,70.8,88894,3.0
Wyoming,1999,4,263365,71.3,250516,67.8,12849,4.9
Alabama,1999,5,2150068,64.0,2047678,60.9,102390,4.8
Alaska,1999,5,317871,73.6,297095,68.8,20776,6.5
Arizona,1999,5,2483008,66.1,2367577,63.0,115431,4.6
Arkansas,1999,5,1254437,62.7,1197474,59.9,56963,4.5
California,1999,5,16395775,66.5,15521145,63.0,874630,5.3
Los Angeles County,1999,5,4557709,65.7,4289044,61.8,268665,5.9
Colorado,1999,5,2335349,73.4,2264653,71.2,70696,3.0
Connecticut,1999,5,1739678,67.4,1696098,65.7,43580,2.5
Delaware,1999,5,398332,67.7,385340,65.5,12992,3.3
District of Columbia,1999,5,304973,66.8,284263,62.3,20710,6.8
Florida,1999,5,7683876,62.7,7377601,60.2,306275,4.0
Georgia,1999,5,4117680,69.1,3959716,66.5,157964,3.8
Hawaii,1999,5,602896,67.1,570704,63.5,32192,5.3
Idaho,1999,5,653066,70.1,619504,66.5,33562,5.1
Illinois,1999,5,6450641,69.4,6162657,66.3,287984,4.5
Indiana,1999,5,3117246,68.3,3028696,66.4,88550,2.8
Iowa,1999,5,1597224,71.8,1553772,69.9,43452,2.7
Kansas,1999,5,1405102,70.7,1356296,68.2,48806,3.5
Kentucky,1999,5,1947810,63.7,1857833,60.7,89977,4.6
Louisiana,1999,5,2020679,61.6,1921495,58.6,99184,4.9
Maine,1999,5,665353,67.7,638343,65.0,27010,4.1
Maryland,1999,5,2766674,70.1,2669794,67.6,96880,3.5
Massachusetts,1999,5,3362702,68.8,3250534,66.5,112168,3.3
Michigan,1999,5,5087246,68.2,4893218,65.6,194028,3.8
Minnesota,1999,5,2740602,74.7,2666778,72.7,73824,2.7
Mississippi,1999,5,1276644,61.3,1212929,58.2,63715,5.0
Missouri,1999,5,2944121,70.2,2845079,67.8,99042,3.4
Montana,1999,5,466387,68.6,441383,64.9,25004,5.4
Nebraska,1999,5,927430,72.8,902189,70.8,25241,2.7
Nevada,1999,5,1018568,69.7,977626,66.9,40942,4.0
New Hampshire,1999,5,674099,72.3,655954,70.3,18145,2.7
New Jersey,1999,5,4284749,67.0,4086426,63.9,198323,4.6
New Mexico,1999,5,835056,62.8,787385,59.2,47671,5.7
New York,1999,5,9102479,62.9,8620236,59.6,482243,5.3
New York city,1999,5,3584215,58.5,3333349,54.4,250866,7.0
North Carolina,1999,5,4030270,66.9,3900334,64.7,129936,3.2
North Dakota,1999,5,342305,70.4,331295,68.1,11010,3.2
Ohio,1999,5,5746303,66.9,5494585,63.9,251718,4.4
Oklahoma,1999,5,1654310,64.7,1595759,62.4,58551,3.5
Oregon,1999,5,1781289,68.3,1682493,64.5,98796,5.5
Pennsylvania,1999,5,6099229,64.5,5824692,61.6,274537,4.5
Rhode Island,1999,5,538229,66.8,516457,64.1,21772,4.0
South Carolina,1999,5,1961241,65.7,1880896,63.0,80345,4.1
South Dakota,1999,5,402280,72.5,391077,70.5,11203,2.8
Tennessee,1999,5,2843291,66.0,2731099,63.3,112192,3.9
Texas,1999,5,10242502,68.8,9763252,65.6,479250,4.7
Utah,1999,5,1122560,72.4,1082031,69.8,40529,3.6
Vermont,1999,5,338784,72.4,328191,70.2,10593,3.1
Virginia,1999,5,3544632,67.8,3449315,65.9,95317,2.7
Washington,1999,5,3059358,69.5,2911396,66.1,147962,4.8
West Virginia,1999,5,798872,55.8,745994,52.1,52878,6.6
Wisconsin,1999,5,2949497,73.0,2861261,70.8,88236,3.0
Wyoming,1999,5,263572,71.3,250743,67.9,12829,4.9
Alabama,1999,6,2150499,64.0,2047450,60.9,103049,4.8
Alaska,1999,6,317958,73.4,297314,68.7,20644,6.5
Arizona,1999,6,2486175,66.1,2371025,63.0,115150,4.6
Arkansas,1999,6,1255837,62.7,1198611,59.8,57226,4.6
California,1999,6,16423832,66.5,15557372,63.0,866460,5.3
Los Angeles County,1999,6,4569296,65.8,4301975,61.9,267321,5.9
Colorado,1999,6,2338146,73.3,2266537,71.1,71609,3.1
Connecticut,1999,6,1740207,67.4,1697201,65.7,43006,2.5
Delaware,1999,6,398952,67.8,385868,65.5,13084,3.3
District of Columbia,1999,6,306263,67.1,285873,62.6,20390,6.7
Florida,1999,6,7693780,62.7,7389066,60.2,304714,4.0
Georgia,1999,6,4126138,69.1,3968809,66.5,157329,3.8
Hawaii,1999,6,603524,67.1,571680,63.6,31844,5.3
Idaho,1999,6,652947,70.0,619482,66.4,33465,5.1
Illinois,1999,6,6466707,69.6,6171178,66.4,295529,4.6
Indiana,1999,6,3116455,68.2,3026200,66.3,90255,2.9
Iowa,1999,6,1596850,71.8,1553110,69.9,43740,2.7
Kansas,1999,6,1405585,70.7,1356314,68.2,49271,3.5
Kentucky,1999,6,1949843,63.7,1859917,60.8,89926,4.6
Louisiana,1999,6,2022019,61.6,1922532,58.6,99487,4.9
Maine,1999,6,667214,67.9,639973,65.1,27241,4.1
Maryland,1999,6,2768889,70.1,2672943,67.6,95946,3.5
Massachusetts,1999,6,3362703,68.7,3250245,66.4,112458,3.3
Michigan,1999,6,5095342,68.2,4905256,65.7,190086,3.7
Minnesota,1999,6,2746084,74.7,2670074,72.7,76010,2.8
Mississippi,1999,6,1279277,61.4,1214587,58.3,64690,5.1
Missouri,1999,6,2947220,70.2,2847628,67.8,99592,3.4
Montana,1999,6,466581,68.6,441612,64.9,24969,5.4
Nebraska,1999,6,928428,72.8,902880,70.8,25548,2.8
Nevada,1999,6,1022457,69.7,980739,66.9,41718,4.1
New Hampshire,1999,6,674192,72.2,656212,70.3,17980,2.7
New Jersey,1999,6,4288788,67.1,4089046,63.9,199742,4.7
New Mexico,1999,6,835662,62.9,788224,59.3,47438,5.7
New York,1999,6,9114041,63.0,8630426,59.7,483615,5.3
New York city,1999,6,3594866,58.6,3342477,54.5,252389,7.0
North Carolina,1999,6,4038489,66.9,3905805,64.7,132684,3.3
North Dakota,1999,6,342235,70.5,331279,68.3,10956,3.2
Ohio,1999,6,5754854,67.0,5501339,64.0,253515,4.4
Oklahoma,1999,6,1655612,64.7,1598610,62.4,57002,3.4
Oregon,1999,6,1780774,68.2,1681820,64.4,98954,5.6
Pennsylvania,1999,6,6101749,64.5,5824846,61.6,276903,4.5
Rhode Island,1999,6,539271,66.9,516890,64.2,22381,4.2
South Carolina,1999,6,1959647,65.6,1878786,62.9,80861,4.1
South Dakota,1999,6,402867,72.4,391616,70.4,11251,2.8
Tennessee,1999,6,2846014,66.0,2734705,63.4,111309,3.9
Texas,1999,6,10256398,68.8,9774929,65.6,481469,4.7
Utah,1999,6,1123698,72.4,1083244,69.8,40454,3.6
Vermont,1999,6,338858,72.4,328373,70.2,10485,3.1
Virginia,1999,6,3550388,67.8,3453816,66.0,96572,2.7
Washington,1999,6,3061314,69.5,2912278,66.1,149036,4.9
West Virginia,1999,6,799576,55.8,746898,52.2,52678,6.6
Wisconsin,1999,6,2952013,73.0,2863548,70.8,88465,3.0
Wyoming,1999,6,263765,71.4,251005,67.9,12760,4.8
Alabama,1999,7,2150635,64.0,2047462,60.9,103173,4.8
Alaska,1999,7,318123,73.5,297644,68.7,20479,6.4
Arizona,1999,7,2488302,66.0,2374361,63.0,113941,4.6
Arkansas,1999,7,1257269,62.7,1199867,59.9,57402,4.6
California,1999,7,16452009,66.5,15592715,63.1,859294,5.2
Los Angeles County,1999,7,4580298,65.9,4313209,62.0,267089,5.8
Colorado,1999,7,2340426,73.2,2268208,71.0,72218,3.1
Connecticut,1999,7,1741333,67.4,1698865,65.8,42468,2.4
Delaware,1999,7,399788,67.8,386623,65.6,13165,3.3
District of Columbia,1999,7,307297,67.2,287289,62.9,20008,6.5
Florida,1999,7,7703110,62.7,7400015,60.2,303095,3.9
Georgia,1999,7,4134702,69.2,3977754,66.5,156948,3.8
Hawaii,1999,7,604114,67.2,572659,63.7,31455,5.2
Idaho,1999,7,653033,69.9,619780,66.4,33253,5.1
Illinois,1999,7,6479976,69.7,6180454,66.5,299522,4.6
Indiana,1999,7,3116764,68.2,3024386,66.2,92378,3.0
Iowa,1999,7,1595320,71.7,1551668,69.7,43652,2.7
Kansas,1999,7,1406323,70.7,1356755,68.2,49568,3.5
Kentucky,1999,7,1951098,63.7,1861696,60.8,89402,4.6
Louisiana,1999,7,2024641,61.7,1924376,58.6,100265,5.0
Maine,1999,7,669229,68.0,641889,65.2,27340,4.1
Maryland,1999,7,2771230,70.1,2676266,67.7,94964,3.4
Massachusetts,1999,7,3361620,68.7,3249120,66.4,112500,3.3
Michigan,1999,7,5104568,68.3,4916811,65.8,187757,3.7
Minnesota,1999,7,2751047,74.8,2673677,72.7,77370,2.8
Mississippi,1999,7,1282566,61.5,1216887,58.4,65679,5.1
Missouri,1999,7,2949738,70.2,2851116,67.9,98622,3.3
Montana,1999,7,466721,68.5,441825,64.9,24896,5.3
Nebraska,1999,7,929688,72.9,903964,70.8,25724,2.8
Nevada,1999,7,1026078,69.7,983909,66.9,42169,4.1
New Hampshire,1999,7,674511,72.1,656548,70.2,17963,2.7
New Jersey,1999,7,4291225,67.0,4092717,63.9,198508,4.6
New Mexico,1999,7,836443,62.9,789240,59.3,47203,5.6
New York,1999,7,9124845,63.0,8642160,59.7,482685,5.3
New York city,1999,7,3605040,58.8,3352547,54.7,252493,7.0
North Carolina,1999,7,4048525,67.0,3913030,64.7,135495,3.3
North Dakota,1999,7,342278,70.5,331414,68.3,10864,3.2
Ohio,1999,7,5762936,67.0,5508848,64.1,254088,4.4
Oklahoma,1999,7,1656970,64.6,1601156,62.5,55814,3.4
Oregon,1999,7,1782000,68.1,1682950,64.4,99050,5.6
Pennsylvania,1999,7,6101861,64.5,5823324,61.5,278537,4.6
Rhode Island,1999,7,540366,67.0,517300,64.2,23066,4.3
South Carolina,1999,7,1957988,65.5,1876263,62.7,81725,4.2
South Dakota,1999,7,403517,72.5,392297,70.5,11220,2.8
Tennessee,1999,7,2848129,66.0,2736973,63.4,111156,3.9
Texas,1999,7,10270498,68.8,9786452,65.5,484046,4.7
Utah,1999,7,1124768,72.4,1084513,69.8,40255,3.6
Vermont,1999,7,339024,72.3,328649,70.1,10375,3.1
Virginia,1999,7,3556857,67.8,3459202,66.0,97655,2.7
Washington,1999,7,3063373,69.4,2913910,66.1,149463,4.9
West Virginia,1999,7,800282,55.9,747907,52.2,52375,6.5
Wisconsin,1999,7,2955960,73.0,2866529,70.8,89431,3.0
Wyoming,1999,7,263940,71.4,251287,68.0,12653,4.8
Alabama,1999,8,2150575,63.9,2047648,60.9,102927,4.8
Alaska,1999,8,318383,73.4,298066,68.7,20317,6.4
Arizona,1999,8,2489693,65.9,2377601,62.9,112092,4.5
Arkansas,1999,8,1258654,62.7,1201406,59.9,57248,4.5
California,1999,8,16479001,66.5,15626585,63.1,852416,5.2
Los Angeles County,1999,8,4590280,65.9,4323021,62.1,267259,5.8
Colorado,1999,8,2341976,73.1,2269818,70.9,72158,3.1
Connecticut,1999,8,1742915,67.5,1700976,65.8,41939,2.4
Delaware,1999,8,400723,67.8,387464,65.6,13259,3.3
District of Columbia,1999,8,308022,67.3,288429,63.1,19593,6.4
Florida,1999,8,7712683,62.7,7411469,60.2,301214,3.9
Georgia,1999,8,4142038,69.2,3985368,66.5,156670,3.8
Hawaii,1999,8,604492,67.1,573534,63.7,30958,5.1
Idaho,1999,8,653243,69.8,620377,66.3,32866,5.0
Illinois,1999,8,6489669,69.7,6190525,66.5,299144,4.6
Indiana,1999,8,3117962,68.2,3023630,66.1,94332,3.0
Iowa,1999,8,1593056,71.6,1550060,69.6,42996,2.7
Kansas,1999,8,1407132,70.7,1357409,68.2,49723,3.5
Kentucky,1999,8,1951368,63.7,1863124,60.8,88244,4.5
Louisiana,1999,8,2027324,61.8,1926493,58.7,100831,5.0
Maine,1999,8,671315,68.1,643970,65.4,27345,4.1
Maryland,1999,8,2773197,70.1,2679215,67.7,93982,3.4
Massachusetts,1999,8,3359688,68.6,3247524,66.3,112164,3.3
Michigan,1999,8,5114309,68.4,4927303,65.9,187006,3.7
Minnesota,1999,8,2754900,74.8,2677095,72.6,77805,2.8
Mississippi,1999,8,1286184,61.6,1219657,58.4,66527,5.2
Missouri,1999,8,2951407,70.2,2855064,67.9,96343,3.3
Montana,1999,8,466835,68.5,442088,64.9,24747,5.3
Nebraska,1999,8,930926,72.9,905179,70.9,25747,2.8
Nevada,1999,8,1029422,69.7,987214,66.9,42208,4.1
New Hampshire,1999,8,675091,72.0,656979,70.1,18112,2.7
New Jersey,1999,8,4291967,67.0,4097336,64.0,194631,4.5
New Mexico,1999,8,837193,62.9,790312,59.3,46881,5.6
New York,1999,8,9132508,63.1,8654051,59.8,478457,5.2
New York city,1999,8,3612308,58.8,3362290,54.7,250018,6.9
North Carolina,1999,8,4058998,67.1,3921328,64.8,137670,3.4
North Dakota,1999,8,342361,70.5,331616,68.3,10745,3.1
Ohio,1999,8,5770475,67.1,5517274,64.2,253201,4.4
Oklahoma,1999,8,1658153,64.6,1603162,62.5,54991,3.3
Oregon,1999,8,1784932,68.2,1686307,64.4,98625,5.5
Pennsylvania,1999,8,6099773,64.4,5821493,61.5,278280,4.6
Rhode Island,1999,8,541426,67.1,517809,64.2,23617,4.4
South Carolina,1999,8,1956327,65.3,1873522,62.5,82805,4.2
South Dakota,1999,8,404160,72.5,393064,70.5,11096,2.7
Tennessee,1999,8,2848550,65.9,2737172,63.3,111378,3.9
Texas,1999,8,10283849,68.7,9797733,65.5,486116,4.7
Utah,1999,8,1125649,72.2,1085871,69.7,39778,3.5
Vermont,1999,8,339285,72.4,329027,70.2,10258,3.0
Virginia,1999,8,3563126,67.9,3464757,66.0,98369,2.8
Washington,1999,8,3064877,69.4,2915924,66.0,148953,4.9
West Virginia,1999,8,800691,55.9,748796,52.3,51895,6.5
Wisconsin,1999,8,2960130,73.1,2869519,70.8,90611,3.1
Wyoming,1999,8,264097,71.3,251603,67.9,12494,4.7
Alabama,1999,9,2150783,63.9,2048264,60.9,102519,4.8
Alaska,1999,9,318651,73.4,298501,68.8,20150,6.3
Arizona,1999,9,2490777,65.8,2380802,62.9,109975,4.4
Arkansas,1999,9,1259956,62.7,1203202,59.9,56754,4.5
California,1999,9,16506538,66.6,15661301,63.1,845237,5.1
Los Angeles County,1999,9,4599616,65.9,4332499,62.1,267117,5.8
Colorado,1999,9,2342993,73.0,2271583,70.8,71410,3.0
Connecticut,1999,9,1745152,67.5,1703728,65.9,41424,2.4
Delaware,1999,9,401689,68.0,388329,65.7,13360,3.3
District of Columbia,1999,9,308384,67.4,289240,63.2,19144,6.2
Florida,1999,9,7724791,62.7,7426068,60.2,298723,3.9
Georgia,1999,9,4147774,69.1,3991865,66.5,155909,3.8
Hawaii,1999,9,604728,67.2,574375,63.8,30353,5.0
Idaho,1999,9,653571,69.7,621221,66.2,32350,4.9
Illinois,1999,9,6497136,69.8,6202076,66.6,295060,4.5
Indiana,1999,9,3120249,68.2,3024545,66.1,95704,3.1
Iowa,1999,9,1590903,71.5,1548920,69.6,41983,2.6
Kansas,1999,9,1407813,70.7,1358048,68.2,49765,3.5
Kentucky,1999,9,1951091,63.6,1864529,60.8,86562,4.4
Louisiana,1999,9,2029205,61.8,1928384,58.7,100821,5.0
Maine,1999,9,673444,68.3,646215,65.5,27229,4.0
Maryland,1999,9,2774786,70.0,2681730,67.7,93056,3.4
Massachusetts,1999,9,3357704,68.5,3246334,66.2,111370,3.3
Michigan,1999,9,5123995,68.5,4937539,66.0,186456,3.6
Minnesota,1999,9,2757917,74.7,2680302,72.6,77615,2.8
Mississippi,1999,9,1290148,61.8,1222810,58.6,67338,5.2
Missouri,1999,9,2952481,70.1,2859131,67.9,93350,3.2
Montana,1999,9,467009,68.5,442505,64.9,24504,5.2
Nebraska,1999,9,932119,73.0,906424,71.0,25695,2.8
Nevada,1999,9,1032666,69.7,990777,66.9,41889,4.1
New Hampshire,1999,9,676020,72.1,657630,70.1,18390,2.7
New Jersey,1999,9,4291484,67.0,4102676,64.0,188808,4.4
New Mexico,1999,9,837804,62.8,791429,59.3,46375,5.5
New York,1999,9,9136158,63.0,8665640,59.8,470518,5.2
New York city,1999,9,3615813,58.8,3371197,54.8,244616,6.8
North Carolina,1999,9,4067961,67.1,3929109,64.8,138852,3.4
North Dakota,1999,9,342402,70.5,331791,68.4,10611,3.1
Ohio,1999,9,5777699,67.2,5526559,64.2,251140,4.3
Oklahoma,1999,9,1658881,64.6,1604482,62.5,54399,3.3
Oregon,1999,9,1788993,68.3,1691540,64.5,97453,5.4
Pennsylvania,1999,9,6096878,64.4,5821076,61.4,275802,4.5
Rhode Island,1999,9,542403,67.1,518500,64.2,23903,4.4
South Carolina,1999,9,1954697,65.2,1871067,62.4,83630,4.3
South Dakota,1999,9,404782,72.6,393877,70.7,10905,2.7
Tennessee,1999,9,2847159,65.8,2735716,63.2,111443,3.9
Texas,1999,9,10298131,68.7,9810408,65.5,487723,4.7
Utah,1999,9,1126407,72.2,1087445,69.7,38962,3.5
Vermont,1999,9,339634,72.3,329503,70.1,10131,3.0
Virginia,1999,9,3568909,67.9,3470304,66.0,98605,2.8
Washington,1999,9,3065841,69.3,2917999,66.0,147842,4.8
West Virginia,1999,9,800724,55.9,749502,52.3,51222,6.4
Wisconsin,1999,9,2963806,73.1,2872367,70.8,91439,3.1
Wyoming,1999,9,264244,71.3,251989,68.0,12255,4.6
Alabama,1999,10,2151556,63.9,2049394,60.9,102162,4.7
Alaska,1999,10,318904,73.5,298925,68.9,19979,6.3
Arizona,1999,10,2492121,65.7,2384179,62.8,107942,4.3
Arkansas,1999,10,1261451,62.7,1205287,59.9,56164,4.5
California,1999,10,16537657,66.6,15698952,63.2,838705,5.1
Los Angeles County,1999,10,4608139,66.0,4341786,62.2,266353,5.8
Colorado,1999,10,2344163,72.9,2273941,70.7,70222,3.0
Connecticut,1999,10,1748276,67.6,1707325,66.0,40951,2.3
Delaware,1999,10,402673,68.0,389210,65.7,13463,3.3
District of Columbia,1999,10,308494,67.3,289789,63.3,18705,6.1
Florida,1999,10,7741854,62.7,7445756,60.3,296098,3.8
Georgia,1999,10,4152731,69.1,3998280,66.5,154451,3.7
Hawaii,1999,10,604953,67.1,575269,63.8,29684,4.9
Idaho,1999,10,654015,69.6,622249,66.3,31766,4.9
Illinois,1999,10,6503959,69.8,6214182,66.7,289777,4.5
Indiana,1999,10,3123749,68.2,3027164,66.1,96585,3.1
Iowa,1999,10,1589927,71.4,1548936,69.5,40991,2.6
Kansas,1999,10,1408185,70.6,1358399,68.1,49786,3.5
Kentucky,1999,10,1951127,63.5,1866357,60.8,84770,4.3
Louisiana,1999,10,2030143,61.8,1929745,58.7,100398,4.9
Maine,1999,10,675553,68.4,648577,65.7,26976,4.0
Maryland,1999,10,2776264,70.0,2683972,67.7,92292,3.3
Massachusetts,1999,10,3356051,68.4,3245871,66.2,110180,3.3
Michigan,1999,10,5132672,68.6,4948091,66.1,184581,3.6
Minnesota,1999,10,2760997,74.7,2683520,72.6,77477,2.8
Mississippi,1999,10,1294379,61.9,1226127,58.7,68252,5.3
Missouri,1999,10,2953499,70.1,2862854,67.9,90645,3.1
Montana,1999,10,467390,68.4,443189,64.9,24201,5.2
Nebraska,1999,10,933259,73.0,907636,71.0,25623,2.7
Nevada,1999,10,1036115,69.8,994672,67.0,41443,4.0
New Hampshire,1999,10,677269,72.1,658564,70.1,18705,2.8
New Jersey,1999,10,4290901,66.9,4108776,64.1,182125,4.2
New Mexico,1999,10,838349,62.8,792664,59.4,45685,5.4
New York,1999,10,9137212,63.0,8677224,59.8,459988,5.0
New York city,1999,10,3617679,58.7,3380218,54.9,237461,6.6
North Carolina,1999,10,4074754,67.2,3935625,64.9,139129,3.4
North Dakota,1999,10,342405,70.5,331917,68.4,10488,3.1
Ohio,1999,10,5784427,67.2,5535431,64.3,248996,4.3
Oklahoma,1999,10,1659012,64.6,1605074,62.5,53938,3.3
Oregon,1999,10,1793453,68.4,1697730,64.7,95723,5.3
Pennsylvania,1999,10,6094244,64.3,5822734,61.4,271510,4.5
Rhode Island,1999,10,543262,67.2,519282,64.2,23980,4.4
South Carolina,1999,10,1953609,65.1,1869821,62.3,83788,4.3
South Dakota,1999,10,405378,72.6,394700,70.7,10678,2.6
Tennessee,1999,10,2845332,65.7,2734311,63.1,111021,3.9
Texas,1999,10,10315484,68.7,9825287,65.4,490197,4.8
Utah,1999,10,1127292,72.1,1089341,69.7,37951,3.4
Vermont,1999,10,334278,71.1,324306,69.0,9972,3.0
Virginia,1999,10,3574426,67.9,3476146,66.0,98280,2.7
Washington,1999,10,3067323,69.3,2920395,66.0,146928,4.8
West Virginia,1999,10,800495,55.9,750097,52.4,50398,6.3
Wisconsin,1999,10,2967059,73.1,2875169,70.8,91890,3.1
Wyoming,1999,10,264415,71.2,252469,68.0,11946,4.5
Alabama,1999,11,2152910,63.9,2051106,60.9,101804,4.7
Alaska,1999,11,319163,73.4,299319,68.8,19844,6.2
Arizona,1999,11,2493896,65.6,2387962,62.8,105934,4.2
Arkansas,1999,11,1263283,62.7,1207690,60.0,55593,4.4
California,1999,11,16575273,66.6,15742402,63.3,832871,5.0
Los Angeles County,1999,11,4615978,66.0,4351281,62.2,264697,5.7
Colorado,1999,11,2345972,72.8,2277248,70.7,68724,2.9
Connecticut,1999,11,1752270,67.7,1711817,66.1,40453,2.3
Delaware,1999,11,403712,68.1,390166,65.8,13546,3.4
District of Columbia,1999,11,308571,67.3,290259,63.3,18312,5.9
Florida,1999,11,7765366,62.8,7471727,60.4,293639,3.8
Georgia,1999,11,4158264,69.0,4005865,66.5,152399,3.7
Hawaii,1999,11,605287,67.1,576323,63.9,28964,4.8
Idaho,1999,11,654666,69.6,623506,66.3,31160,4.8
Illinois,1999,11,6511676,69.8,6226158,66.8,285518,4.4
Indiana,1999,11,3128145,68.3,3031099,66.1,97046,3.1
Iowa,1999,11,1590621,71.4,1550430,69.6,40191,2.5
Kansas,1999,11,1408447,70.6,1358567,68.1,49880,3.5
Kentucky,1999,11,1952037,63.5,1869023,60.8,83014,4.3
Louisiana,1999,11,2030516,61.8,1930813,58.7,99703,4.9
Maine,1999,11,677647,68.6,651071,65.9,26576,3.9
Maryland,1999,11,2778193,70.0,2686508,67.7,91685,3.3
Massachusetts,1999,11,3355213,68.3,3246710,66.1,108503,3.2
Michigan,1999,11,5140720,68.7,4959876,66.2,180844,3.5
Minnesota,1999,11,2765098,74.7,2687323,72.6,77775,2.8
Mississippi,1999,11,1298702,62.1,1229568,58.8,69134,5.3
Missouri,1999,11,2955266,70.1,2866391,68.0,88875,3.0
Montana,1999,11,468069,68.5,444195,65.0,23874,5.1
Nebraska,1999,11,934476,73.1,908917,71.1,25559,2.7
Nevada,1999,11,1040046,69.8,998984,67.0,41062,3.9
New Hampshire,1999,11,678766,72.1,659826,70.1,18940,2.8
New Jersey,1999,11,4291670,66.9,4116267,64.1,175403,4.1
New Mexico,1999,11,839001,62.8,794160,59.4,44841,5.3
New York,1999,11,9139593,63.0,8690839,59.9,448754,4.9
New York city,1999,11,3621427,58.7,3391107,55.0,230320,6.4
North Carolina,1999,11,4080122,67.2,3941414,64.9,138708,3.4
North Dakota,1999,11,342497,70.5,332081,68.4,10416,3.0
Ohio,1999,11,5790572,67.3,5543432,64.4,247140,4.3
Oklahoma,1999,11,1658877,64.5,1605476,62.5,53401,3.2
Oregon,1999,11,1797715,68.5,1703991,64.9,93724,5.2
Pennsylvania,1999,11,6093039,64.3,5827310,61.5,265729,4.4
Rhode Island,1999,11,543965,67.2,520116,64.3,23849,4.4
South Carolina,1999,11,1953354,65.0,1870491,62.2,82863,4.2
South Dakota,1999,11,405998,72.7,395575,70.8,10423,2.6
Tennessee,1999,11,2844836,65.6,2734804,63.1,110032,3.9
Texas,1999,11,10336245,68.7,9843320,65.5,492925,4.8
Utah,1999,11,1128621,72.1,1091698,69.7,36923,3.3
Vermont,1999,11,333060,70.7,323294,68.7,9766,2.9
Virginia,1999,11,3580343,67.9,3483107,66.1,97236,2.7
Washington,1999,11,3070647,69.3,2923835,66.0,146812,4.8
West Virginia,1999,11,800102,55.9,750814,52.4,49288,6.2
Wisconsin,1999,11,2970383,73.1,2878425,70.8,91958,3.1
Wyoming,1999,11,264634,71.2,253065,68.1,11569,4.4
Alabama,1999,12,2154424,63.9,2053068,60.9,101356,4.7
Alaska,1999,12,319396,73.4,299637,68.9,19759,6.2
Arizona,1999,12,2495657,65.6,2391791,62.8,103866,4.2
Arkansas,1999,12,1265026,62.7,1209961,60.0,55065,4.4
California,1999,12,16618488,66.7,15790087,63.4,828401,5.0
Los Angeles County,1999,12,4623137,66.0,4360481,62.3,262656,5.7
Colorado,1999,12,2348230,72.8,2281192,70.7,67038,2.9
Connecticut,1999,12,1756521,67.9,1716678,66.3,39843,2.3
Delaware,1999,12,404848,68.3,391230,66.0,13618,3.4
District of Columbia,1999,12,308663,67.3,290680,63.3,17983,5.8
Florida,1999,12,7793500,62.9,7501822,60.5,291678,3.7
Georgia,1999,12,4164990,69.1,4014723,66.6,150267,3.6
Hawaii,1999,12,605731,67.1,577473,64.0,28258,4.7
Idaho,1999,12,655557,69.6,624958,66.3,30599,4.7
Illinois,1999,12,6519925,69.9,6236937,66.9,282988,4.3
Indiana,1999,12,3132355,68.3,3035384,66.2,96971,3.1
Iowa,1999,12,1592386,71.4,1552614,69.6,39772,2.5
Kansas,1999,12,1408789,70.6,1358584,68.1,50205,3.6
Kentucky,1999,12,1953670,63.5,1872247,60.9,81423,4.2
Louisiana,1999,12,2030941,61.8,1931930,58.8,99011,4.9
Maine,1999,12,679611,68.7,653612,66.1,25999,3.8
Maryland,1999,12,2780692,70.0,2689272,67.7,91420,3.3
Massachusetts,1999,12,3354839,68.3,3248582,66.1,106257,3.2
Michigan,1999,12,5147868,68.7,4972268,66.4,175600,3.4
Minnesota,1999,12,2770337,74.8,2691777,72.6,78560,2.8
Mississippi,1999,12,1303019,62.3,1233069,58.9,69950,5.4
Missouri,1999,12,2958058,70.1,2869683,68.0,88375,3.0
Montana,1999,12,468978,68.6,445429,65.1,23549,5.0
Nebraska,1999,12,935840,73.1,910297,71.1,25543,2.7
Nevada,1999,12,1044374,69.9,1003530,67.1,40844,3.9
New Hampshire,1999,12,680316,72.2,661276,70.2,19040,2.8
New Jersey,1999,12,4293806,66.9,4124423,64.2,169383,3.9
New Mexico,1999,12,839882,62.8,795885,59.5,43997,5.2
New York,1999,12,9145231,63.0,8706579,60.0,438652,4.8
New York city,1999,12,3628583,58.7,3404025,55.1,224558,6.2
North Carolina,1999,12,4084682,67.2,3946649,64.9,138033,3.4
North Dakota,1999,12,342700,70.6,332299,68.4,10401,3.0
Ohio,1999,12,5794999,67.3,5549577,64.5,245422,4.2
Oklahoma,1999,12,1658655,64.5,1606004,62.4,52651,3.2
Oregon,1999,12,1801707,68.6,1709679,65.1,92028,5.1
Pennsylvania,1999,12,6093199,64.3,5833571,61.5,259628,4.3
Rhode Island,1999,12,544489,67.2,520961,64.3,23528,4.3
South Carolina,1999,12,1953604,64.9,1872810,62.3,80794,4.1
South Dakota,1999,12,406634,72.7,396456,70.8,10178,2.5
Tennessee,1999,12,2845968,65.6,2737221,63.1,108747,3.8
Texas,1999,12,10357299,68.8,9863294,65.5,494005,4.8
Utah,1999,12,1130412,72.1,1094342,69.8,36070,3.2
Vermont,1999,12,333097,70.7,323556,68.7,9541,2.9
Virginia,1999,12,3586341,68.0,3490979,66.2,95362,2.7
Washington,1999,12,3075931,69.3,2928358,66.0,147573,4.8
West Virginia,1999,12,799753,55.9,751804,52.5,47949,6.0
Wisconsin,1999,12,2973678,73.1,2882035,70.9,91643,3.1
Wyoming,1999,12,264879,71.3,253736,68.3,11143,4.2
Alabama,2000,1,2155396,64.0,2054501,61.0,100895,4.7
Alaska,2000,1,319633,73.5,299870,68.9,19763,6.2
Arizona,2000,1,2497340,65.5,2395317,62.8,102023,4.1
Arkansas,2000,1,1266292,62.8,1211679,60.0,54613,4.3
California,2000,1,16664807,66.8,15837398,63.5,827409,5.0
Los Angeles County,2000,1,4630672,66.0,4369467,62.3,261205,5.6
Colorado,2000,1,2350618,72.7,2285246,70.7,65372,2.8
Connecticut,2000,1,1760389,68.0,1721240,66.5,39149,2.2
Delaware,2000,1,406118,68.3,392385,66.0,13733,3.4
District of Columbia,2000,1,308732,67.4,290982,63.5,17750,5.7
Florida,2000,1,7822185,63.0,7531066,60.7,291119,3.7
Georgia,2000,1,4172874,69.1,4023896,66.6,148978,3.6
Hawaii,2000,1,606243,67.1,578581,64.1,27662,4.6
Idaho,2000,1,656618,69.6,626419,66.4,30199,4.6
Illinois,2000,1,6526981,69.9,6244525,66.9,282456,4.3
Indiana,2000,1,3135118,68.3,3038427,66.2,96691,3.1
Iowa,2000,1,1593903,71.5,1554073,69.7,39830,2.5
Kansas,2000,1,1409187,70.6,1358376,68.0,50811,3.6
Kentucky,2000,1,1955366,63.5,1875237,60.9,80129,4.1
Louisiana,2000,1,2031853,61.8,1932931,58.8,98922,4.9
Maine,2000,1,681190,68.8,655933,66.2,25257,3.7
Maryland,2000,1,2783617,70.0,2691746,67.7,91871,3.3
Massachusetts,2000,1,3354162,68.2,3250508,66.1,103654,3.1
Michigan,2000,1,5153554,68.8,4983267,66.5,170287,3.3
Minnesota,2000,1,2776344,74.9,2696809,72.7,79535,2.9
Mississippi,2000,1,1307058,62.4,1236272,59.1,70786,5.4
Missouri,2000,1,2961435,70.1,2872340,68.0,89095,3.0
Montana,2000,1,470003,68.7,446727,65.3,23276,5.0
Nebraska,2000,1,937258,73.2,911648,71.2,25610,2.7
Nevada,2000,1,1048870,69.9,1007988,67.2,40882,3.9
New Hampshire,2000,1,681779,72.3,662765,70.2,19014,2.8
New Jersey,2000,1,4296475,66.9,4132200,64.3,164275,3.8
New Mexico,2000,1,840962,62.8,797626,59.6,43336,5.2
New York,2000,1,9153721,63.0,8722626,60.1,431095,4.7
New York city,2000,1,3639408,58.8,3418374,55.3,221034,6.1
North Carolina,2000,1,4089999,67.2,3952192,64.9,137807,3.4
North Dakota,2000,1,342900,70.6,332476,68.5,10424,3.0
Ohio,2000,1,5797908,67.4,5553680,64.5,244228,4.2
Oklahoma,2000,1,1658242,64.4,1606427,62.4,51815,3.1
Oregon,2000,1,1805513,68.7,1714341,65.2,91172,5.0
Pennsylvania,2000,1,6094090,64.3,5839250,61.6,254840,4.2
Rhode Island,2000,1,544833,67.2,521722,64.3,23111,4.2
South Carolina,2000,1,1954318,64.9,1876142,62.3,78176,4.0
South Dakota,2000,1,407258,72.8,397251,71.0,10007,2.5
Tennessee,2000,1,2848463,65.6,2740564,63.1,107899,3.8
Texas,2000,1,10374888,68.8,9882205,65.5,492683,4.7
Utah,2000,1,1132480,72.1,1096923,69.9,35557,3.1
Vermont,2000,1,333451,70.8,324117,68.8,9334,2.8
Virginia,2000,1,3591840,68.0,3498977,66.3,92863,2.6
Washington,2000,1,3082251,69.4,2933306,66.1,148945,4.8
West Virginia,2000,1,799687,55.9,752996,52.6,46691,5.8
Wisconsin,2000,1,2976661,73.1,2885231,70.9,91430,3.1
Wyoming,2000,1,265096,71.1,254385,68.3,10711,4.0
Alabama,2000,2,2155360,63.9,2055016,61.0,100344,4.7
Alaska,2000,2,319868,73.4,300021,68.8,19847,6.2
Arizona,2000,2,2498683,65.4,2398154,62.8,100529,4.0
Arkansas,2000,2,1266602,62.7,1212498,60.0,54104,4.3
California,2000,2,16709195,66.9,15880102,63.6,829093,5.0
Los Angeles County,2000,2,4638506,66.1,4378310,62.4,260196,5.6
Colorado,2000,2,2352798,72.7,2288901,70.7,63897,2.7
Connecticut,2000,2,1763187,68.1,1724811,66.6,38376,2.2
Delaware,2000,2,407498,68.6,393590,66.2,13908,3.4
District of Columbia,2000,2,308710,67.3,291123,63.5,17587,5.7
Florida,2000,2,7847658,63.2,7555736,60.8,291922,3.7
Georgia,2000,2,4180891,69.1,4032279,66.7,148612,3.6
Hawaii,2000,2,606667,67.2,579529,64.2,27138,4.5
Idaho,2000,2,657658,69.6,627655,66.4,30003,4.6
Illinois,2000,2,6529947,70.0,6246588,66.9,283359,4.3
Indiana,2000,2,3135810,68.3,3039102,66.2,96708,3.1
Iowa,2000,2,1593990,71.5,1553843,69.7,40147,2.5
Kansas,2000,2,1409276,70.6,1357876,68.0,51400,3.6
Kentucky,2000,2,1956533,63.6,1877374,61.0,79159,4.0
Louisiana,2000,2,2032546,61.8,1933151,58.8,99395,4.9
Maine,2000,2,682105,68.8,657687,66.4,24418,3.6
Maryland,2000,2,2786471,70.1,2693546,67.7,92925,3.3
Massachusetts,2000,2,3352184,68.2,3251345,66.1,100839,3.0
Michigan,2000,2,5157825,68.8,4990893,66.6,166932,3.2
Minnesota,2000,2,2781831,74.9,2701685,72.8,80146,2.9
Mississippi,2000,2,1310521,62.6,1238908,59.2,71613,5.5
Missouri,2000,2,2964402,70.2,2874153,68.0,90249,3.0
Montana,2000,2,470860,68.8,447794,65.4,23066,4.9
Nebraska,2000,2,938453,73.2,912768,71.2,25685,2.7
Nevada,2000,2,1053251,70.0,1012120,67.3,41131,3.9
New Hampshire,2000,2,683046,72.3,664141,70.3,18905,2.8
New Jersey,2000,2,4297883,66.9,4138271,64.4,159612,3.7
New Mexico,2000,2,841996,62.8,799168,59.6,42828,5.1
New York,2000,2,9161373,63.1,8735957,60.2,425416,4.6
New York city,2000,2,3651496,59.0,3432430,55.4,219066,6.0
North Carolina,2000,2,4096180,67.2,3958053,65.0,138127,3.4
North Dakota,2000,2,342984,70.6,332590,68.5,10394,3.0
Ohio,2000,2,5798706,67.4,5555505,64.5,243201,4.2
Oklahoma,2000,2,1657431,64.4,1606463,62.4,50968,3.1
Oregon,2000,2,1808765,68.7,1717663,65.3,91102,5.0
Pennsylvania,2000,2,6094604,64.3,5842749,61.6,251855,4.1
Rhode Island,2000,2,544919,67.1,522257,64.4,22662,4.2
South Carolina,2000,2,1955540,64.9,1879849,62.4,75691,3.9
South Dakota,2000,2,407791,72.8,397876,71.1,9915,2.4
Tennessee,2000,2,2851078,65.6,2743359,63.2,107719,3.8
Texas,2000,2,10385344,68.8,9897422,65.5,487922,4.7
Utah,2000,2,1134577,72.1,1099168,69.9,35409,3.1
Vermont,2000,2,333755,70.7,324594,68.8,9161,2.7
Virginia,2000,2,3596089,68.0,3505996,66.3,90093,2.5
Washington,2000,2,3087622,69.5,2937092,66.1,150530,4.9
West Virginia,2000,2,799843,55.9,754115,52.7,45728,5.7
Wisconsin,2000,2,2979133,73.2,2887250,70.9,91883,3.1
Wyoming,2000,2,265239,71.2,254918,68.4,10321,3.9
Alabama,2000,3,2154461,63.9,2054647,60.9,99814,4.6
Alaska,2000,3,320075,73.4,300110,68.8,19965,6.2
Arizona,2000,3,2499507,65.3,2399905,62.7,99602,4.0
Arkansas,2000,3,1265831,62.6,1212273,60.0,53558,4.2
California,2000,3,16748830,67.0,15915844,63.7,832986,5.0
Los Angeles County,2000,3,4645948,66.1,4386268,62.4,259680,5.6
Colorado,2000,3,2354449,72.6,2291441,70.7,63008,2.7
Connecticut,2000,3,1764456,68.1,1726813,66.6,37643,2.1
Delaware,2000,3,408910,68.7,394744,66.3,14166,3.5
District of Columbia,2000,3,308554,67.2,291089,63.4,17465,5.7
Florida,2000,3,7869137,63.2,7575359,60.9,293778,3.7
Georgia,2000,3,4188003,69.1,4039056,66.7,148947,3.6
Hawaii,2000,3,606814,67.2,580108,64.2,26706,4.4
Idaho,2000,3,658517,69.6,628488,66.4,30029,4.6
Illinois,2000,3,6527138,69.9,6242216,66.8,284922,4.4
Indiana,2000,3,3134968,68.3,3037517,66.2,97451,3.1
Iowa,2000,3,1592732,71.4,1552218,69.6,40514,2.5
Kansas,2000,3,1408777,70.5,1356943,67.9,51834,3.7
Kentucky,2000,3,1957158,63.5,1878502,61.0,78656,4.0
Louisiana,2000,3,2032404,61.8,1932080,58.8,100324,4.9
Maine,2000,3,682282,68.8,658651,66.4,23631,3.5
Maryland,2000,3,2788961,70.1,2694531,67.7,94430,3.4
Massachusetts,2000,3,3348539,68.1,3250360,66.1,98179,2.9
Michigan,2000,3,5161206,68.8,4993328,66.6,167878,3.3
Minnesota,2000,3,2785765,74.9,2705435,72.8,80330,2.9
Mississippi,2000,3,1313326,62.7,1240963,59.2,72363,5.5
Missouri,2000,3,2966277,70.2,2874900,68.0,91377,3.1
Montana,2000,3,471352,68.8,448406,65.5,22946,4.9
Nebraska,2000,3,939217,73.3,913464,71.3,25753,2.7
Nevada,2000,3,1057299,70.1,1015788,67.3,41511,3.9
New Hampshire,2000,3,684016,72.3,665207,70.3,18809,2.7
New Jersey,2000,3,4296980,66.8,4141217,64.4,155763,3.6
New Mexico,2000,3,842924,62.9,800378,59.7,42546,5.0
New York,2000,3,9164960,63.1,8743376,60.2,421584,4.6
New York city,2000,3,3661913,59.1,3443770,55.5,218143,6.0
North Carolina,2000,3,4103091,67.3,3963413,65.0,139678,3.4
North Dakota,2000,3,343010,70.6,332712,68.5,10298,3.0
Ohio,2000,3,5796621,67.3,5554077,64.5,242544,4.2
Oklahoma,2000,3,1656371,64.3,1606060,62.3,50311,3.0
Oregon,2000,3,1811429,68.8,1719558,65.3,91871,5.1
Pennsylvania,2000,3,6094109,64.3,5843115,61.6,250994,4.1
Rhode Island,2000,3,544724,67.1,522422,64.3,22302,4.1
South Carolina,2000,3,1957342,64.9,1883331,62.4,74011,3.8
South Dakota,2000,3,408141,72.8,398243,71.0,9898,2.4
Tennessee,2000,3,2852691,65.6,2744529,63.1,108162,3.8
Texas,2000,3,10387976,68.7,9907586,65.5,480390,4.6
Utah,2000,3,1136540,72.2,1100892,69.9,35648,3.1
Vermont,2000,3,333880,70.7,324816,68.8,9064,2.7
Virginia,2000,3,3598402,68.0,3511053,66.4,87349,2.4
Washington,2000,3,3090786,69.5,2938274,66.1,152512,4.9
West Virginia,2000,3,799971,55.9,754854,52.8,45117,5.6
Wisconsin,2000,3,2981108,73.2,2887713,70.9,93395,3.1
Wyoming,2000,3,265312,71.2,255278,68.5,10034,3.8
Alabama,2000,4,2152933,63.8,2053544,60.9,99389,4.6
Alaska,2000,4,320208,73.7,300087,69.1,20121,6.3
Arizona,2000,4,2500107,65.4,2400733,62.8,99374,4.0
Arkansas,2000,4,1264225,62.5,1211183,59.9,53042,4.2
California,2000,4,16782816,67.0,15944622,63.7,838194,5.0
Los Angeles County,2000,4,4653079,66.0,4393555,62.4,259524,5.6
Colorado,2000,4,2355634,72.6,2292619,70.6,63015,2.7
Connecticut,2000,4,1764216,68.1,1727157,66.7,37059,2.1
Delaware,2000,4,410285,69.0,395778,66.5,14507,3.5
District of Columbia,2000,4,308359,67.4,290974,63.6,17385,5.6
Florida,2000,4,7886709,63.4,7590406,61.1,296303,3.8
Georgia,2000,4,4193495,69.2,4043703,66.7,149792,3.6
Hawaii,2000,4,606544,67.5,580150,64.6,26394,4.4
Idaho,2000,4,659204,69.6,628958,66.4,30246,4.6
Illinois,2000,4,6519408,69.9,6232675,66.8,286733,4.4
Indiana,2000,4,3133462,68.2,3034967,66.1,98495,3.1
Iowa,2000,4,1590764,71.3,1549882,69.5,40882,2.6
Kansas,2000,4,1407475,70.5,1355365,67.9,52110,3.7
Kentucky,2000,4,1957215,63.5,1878639,61.0,78576,4.0
Louisiana,2000,4,2030975,61.8,1929509,58.7,101466,5.0
Maine,2000,4,681689,68.7,658698,66.4,22991,3.4
Maryland,2000,4,2791240,70.1,2694918,67.7,96322,3.5
Massachusetts,2000,4,3343298,68.0,3247355,66.0,95943,2.9
Michigan,2000,4,5163621,68.8,4989797,66.5,173824,3.4
Minnesota,2000,4,2788458,75.0,2707937,72.8,80521,2.9
Mississippi,2000,4,1315163,62.8,1242351,59.4,72812,5.5
Missouri,2000,4,2966814,70.2,2874298,68.0,92516,3.1
Montana,2000,4,471489,68.8,448564,65.4,22925,4.9
Nebraska,2000,4,939417,73.3,913616,71.3,25801,2.7
Nevada,2000,4,1060995,70.3,1019028,67.6,41967,4.0
New Hampshire,2000,4,684663,72.4,665900,70.4,18763,2.7
New Jersey,2000,4,4293955,66.8,4140679,64.4,153276,3.6
New Mexico,2000,4,843697,63.0,801234,59.8,42463,5.0
New York,2000,4,9162783,63.1,8743469,60.2,419314,4.6
New York city,2000,4,3668589,59.2,3450970,55.7,217619,5.9
North Carolina,2000,4,4111263,67.5,3968367,65.2,142896,3.5
North Dakota,2000,4,343001,70.7,332809,68.6,10192,3.0
Ohio,2000,4,5792324,67.3,5549896,64.5,242428,4.2
Oklahoma,2000,4,1655441,64.3,1605448,62.3,49993,3.0
Oregon,2000,4,1813558,68.8,1720353,65.3,93205,5.1
Pennsylvania,2000,4,6093113,64.3,5840938,61.6,252175,4.1
Rhode Island,2000,4,544310,67.2,522197,64.5,22113,4.1
South Carolina,2000,4,1959493,64.9,1886112,62.5,73381,3.7
South Dakota,2000,4,408243,72.8,398298,71.1,9945,2.4
Tennessee,2000,4,2853015,65.6,2743803,63.1,109212,3.8
Texas,2000,4,10384688,68.6,9912894,65.5,471794,4.5
Utah,2000,4,1138282,72.3,1102093,70.0,36189,3.2
Vermont,2000,4,333850,70.6,324776,68.6,9074,2.7
Virginia,2000,4,3598550,68.1,3513704,66.5,84846,2.4
Washington,2000,4,3091286,69.5,2936523,66.0,154763,5.0
West Virginia,2000,4,799822,55.9,755000,52.8,44822,5.6
Wisconsin,2000,4,2982659,73.2,2886607,70.8,96052,3.2
Wyoming,2000,4,265339,71.3,255457,68.6,9882,3.7
Alabama,2000,5,2150985,63.7,2051877,60.8,99108,4.6
Alaska,2000,5,320231,73.7,299944,69.0,20287,6.3
Arizona,2000,5,2501145,65.3,2401520,62.7,99625,4.0
Arkansas,2000,5,1262138,62.4,1209613,59.8,52525,4.2
California,2000,5,16810519,67.1,15968867,63.7,841652,5.0
Los Angeles County,2000,5,4659384,66.1,4400492,62.4,258892,5.6
Colorado,2000,5,2356442,72.5,2292707,70.5,63735,2.7
Connecticut,2000,5,1762879,68.0,1726282,66.6,36597,2.1
Delaware,2000,5,411530,69.1,396680,66.6,14850,3.6
District of Columbia,2000,5,308285,67.4,290928,63.6,17357,5.6
Florida,2000,5,7900636,63.5,7602166,61.1,298470,3.8
Georgia,2000,5,4197324,69.1,4046670,66.6,150654,3.6
Hawaii,2000,5,605902,67.5,579744,64.5,26158,4.3
Idaho,2000,5,659726,69.6,629190,66.3,30536,4.6
Illinois,2000,5,6508674,69.7,6220982,66.7,287692,4.4
Indiana,2000,5,3131375,68.1,3032532,66.0,98843,3.2
Iowa,2000,5,1589019,71.2,1547705,69.4,41314,2.6
Kansas,2000,5,1405410,70.3,1353073,67.7,52337,3.7
Kentucky,2000,5,1956725,63.5,1877920,60.9,78805,4.0
Louisiana,2000,5,2028038,61.7,1925659,58.6,102379,5.0
Maine,2000,5,680306,68.5,657796,66.3,22510,3.3
Maryland,2000,5,2793520,70.1,2695235,67.6,98285,3.5
Massachusetts,2000,5,3337096,67.8,3243031,65.9,94065,2.8
Michigan,2000,5,5164344,68.8,4981678,66.4,182666,3.5
Minnesota,2000,5,2790458,74.9,2709344,72.8,81114,2.9
Mississippi,2000,5,1315641,62.8,1243022,59.4,72619,5.5
Missouri,2000,5,2966631,70.2,2872430,67.9,94201,3.2
Montana,2000,5,471303,68.7,448365,65.3,22938,4.9
Nebraska,2000,5,939063,73.2,913191,71.2,25872,2.8
Nevada,2000,5,1064454,70.3,1022010,67.5,42444,4.0
New Hampshire,2000,5,685083,72.3,666368,70.3,18715,2.7
New Jersey,2000,5,4289627,66.7,4137545,64.3,152082,3.5
New Mexico,2000,5,844321,63.0,801837,59.8,42484,5.0
New York,2000,5,9154327,63.0,8736957,60.1,417370,4.6
New York city,2000,5,3670097,59.2,3453678,55.7,216419,5.9
North Carolina,2000,5,4119908,67.6,3972500,65.2,147408,3.6
North Dakota,2000,5,342919,70.7,332824,68.6,10095,2.9
Ohio,2000,5,5786537,67.2,5544176,64.4,242361,4.2
Oklahoma,2000,5,1654880,64.2,1604931,62.3,49949,3.0
Oregon,2000,5,1814860,68.8,1720191,65.2,94669,5.2
Pennsylvania,2000,5,6092670,64.3,5838132,61.6,254538,4.2
Rhode Island,2000,5,543712,67.1,521696,64.3,22016,4.0
South Carolina,2000,5,1961687,64.9,1888405,62.5,73282,3.7
South Dakota,2000,5,408129,72.8,398097,71.0,10032,2.5
Tennessee,2000,5,2851807,65.5,2741330,63.0,110477,3.9
Texas,2000,5,10378041,68.5,9915154,65.4,462887,4.5
Utah,2000,5,1139792,72.3,1102966,69.9,36826,3.2
Vermont,2000,5,333746,70.5,324580,68.6,9166,2.7
Virginia,2000,5,3597380,68.0,3514656,66.4,82724,2.3
Washington,2000,5,3089352,69.3,2932549,65.8,156803,5.1
West Virginia,2000,5,799302,55.9,754600,52.7,44702,5.6
Wisconsin,2000,5,2983667,73.1,2884394,70.7,99273,3.3
Wyoming,2000,5,265327,71.3,255504,68.6,9823,3.7
Alabama,2000,6,2148644,63.6,2049598,60.7,99046,4.6
Alaska,2000,6,320117,73.6,299705,68.9,20412,6.4
Arizona,2000,6,2503023,65.2,2402986,62.6,100037,4.0
Arkansas,2000,6,1260023,62.2,1207919,59.6,52104,4.1
California,2000,6,16832375,67.1,15990881,63.7,841494,5.0
Los Angeles County,2000,6,4664415,66.1,4407163,62.4,257252,5.5
Colorado,2000,6,2356916,72.3,2292065,70.3,64851,2.8
Connecticut,2000,6,1761016,67.9,1724784,66.5,36232,2.1
Delaware,2000,6,412534,69.2,397439,66.6,15095,3.7
District of Columbia,2000,6,308472,67.5,291090,63.7,17382,5.6
Florida,2000,6,7911818,63.5,7612311,61.1,299507,3.8
Georgia,2000,6,4199914,69.0,4048982,66.5,150932,3.6
Hawaii,2000,6,605064,67.4,579163,64.5,25901,4.3
Idaho,2000,6,660119,69.5,629321,66.2,30798,4.7
Illinois,2000,6,6496583,69.6,6209465,66.5,287118,4.4
Indiana,2000,6,3127934,68.0,3030118,65.9,97816,3.1
Iowa,2000,6,1588514,71.2,1546565,69.3,41949,2.6
Kansas,2000,6,1402858,70.1,1350204,67.5,52654,3.8
Kentucky,2000,6,1955907,63.4,1876553,60.8,79354,4.1
Louisiana,2000,6,2024062,61.5,1920886,58.4,103176,5.1
Maine,2000,6,678347,68.3,656162,66.1,22185,3.3
Maryland,2000,6,2795968,70.1,2695979,67.6,99989,3.6
Massachusetts,2000,6,3330999,67.6,3238498,65.8,92501,2.8
Michigan,2000,6,5162449,68.7,4971024,66.2,191425,3.7
Minnesota,2000,6,2792365,74.9,2709868,72.7,82497,3.0
Mississippi,2000,6,1314761,62.7,1242805,59.3,71956,5.5
Missouri,2000,6,2966275,70.1,2869637,67.8,96638,3.3
Montana,2000,6,470868,68.6,447929,65.2,22939,4.9
Nebraska,2000,6,938411,73.1,912365,71.1,26046,2.8
Nevada,2000,6,1067871,70.3,1024845,67.5,43026,4.0
New Hampshire,2000,6,685311,72.2,666771,70.3,18540,2.7
New Jersey,2000,6,4284843,66.6,4132641,64.2,152202,3.6
New Mexico,2000,6,844893,63.0,802325,59.8,42568,5.0
New York,2000,6,9141115,62.9,8725743,60.0,415372,4.5
New York city,2000,6,3666933,59.1,3452624,55.7,214309,5.8
North Carolina,2000,6,4127509,67.6,3974774,65.1,152735,3.7
North Dakota,2000,6,342744,70.7,332704,68.6,10040,2.9
Ohio,2000,6,5779685,67.1,5537918,64.3,241767,4.2
Oklahoma,2000,6,1654551,64.2,1604477,62.2,50074,3.0
Oregon,2000,6,1815031,68.8,1718994,65.1,96037,5.3
Pennsylvania,2000,6,6093849,64.3,5836466,61.6,257383,4.2
Rhode Island,2000,6,542938,66.9,521016,64.2,21922,4.0
South Carolina,2000,6,1963629,64.9,1890687,62.5,72942,3.7
South Dakota,2000,6,407912,72.7,397742,70.9,10170,2.5
Tennessee,2000,6,2849076,65.4,2737554,62.9,111522,3.9
Texas,2000,6,10371237,68.3,9916003,65.3,455234,4.4
Utah,2000,6,1141131,72.2,1103675,69.8,37456,3.3
Vermont,2000,6,333622,70.4,324309,68.4,9313,2.8
Virginia,2000,6,3596215,67.9,3515274,66.4,80941,2.3
Washington,2000,6,3086127,69.2,2927485,65.6,158642,5.1
West Virginia,2000,6,798512,55.8,753878,52.7,44634,5.6
Wisconsin,2000,6,2983956,73.1,2881710,70.6,102246,3.4
Wyoming,2000,6,265322,71.2,255494,68.6,9828,3.7
Alabama,2000,7,2145873,63.5,2046851,60.6,99022,4.6
Alaska,2000,7,319867,73.5,299400,68.8,20467,6.4
Arizona,2000,7,2505807,65.1,2405631,62.5,100176,4.0
Arkansas,2000,7,1258163,62.1,1206327,59.5,51836,4.1
California,2000,7,16850862,67.1,16014170,63.7,836692,5.0
Los Angeles County,2000,7,4668163,66.1,4413927,62.5,254236,5.4
Colorado,2000,7,2357347,72.2,2291457,70.2,65890,2.8
Connecticut,2000,7,1759361,67.8,1723398,66.4,35963,2.0
Delaware,2000,7,413349,69.2,398153,66.7,15196,3.7
District of Columbia,2000,7,308993,67.6,291549,63.8,17444,5.6
Florida,2000,7,7922274,63.5,7623143,61.1,299131,3.8
Georgia,2000,7,4202076,68.9,4052099,66.5,149977,3.6
Hawaii,2000,7,604284,67.3,578724,64.4,25560,4.2
Idaho,2000,7,660540,69.4,629507,66.2,31033,4.7
Illinois,2000,7,6484866,69.4,6199132,66.3,285734,4.4
Indiana,2000,7,3123279,67.9,3028049,65.8,95230,3.0
Iowa,2000,7,1589606,71.2,1546820,69.3,42786,2.7
Kansas,2000,7,1400182,70.0,1347260,67.3,52922,3.8
Kentucky,2000,7,1955213,63.3,1875040,60.7,80173,4.1
Louisiana,2000,7,2020359,61.4,1916191,58.3,104168,5.2
Maine,2000,7,676253,68.0,654293,65.8,21960,3.2
Maryland,2000,7,2799124,70.1,2697863,67.5,101261,3.6
Massachusetts,2000,7,3326572,67.5,3235403,65.6,91169,2.7
Michigan,2000,7,5157929,68.6,4960549,66.0,197380,3.8
Minnesota,2000,7,2795292,74.9,2710585,72.6,84707,3.0
Mississippi,2000,7,1312718,62.6,1241709,59.2,71009,5.4
Missouri,2000,7,2966424,70.0,2866872,67.7,99552,3.4
Montana,2000,7,470286,68.4,447403,65.1,22883,4.9
Nebraska,2000,7,937760,73.0,911486,71.0,26274,2.8
Nevada,2000,7,1071444,70.3,1027679,67.4,43765,4.1
New Hampshire,2000,7,685467,72.1,667278,70.2,18189,2.7
New Jersey,2000,7,4280707,66.5,4127271,64.1,153436,3.6
New Mexico,2000,7,845568,63.0,802979,59.9,42589,5.0
New York,2000,7,9127546,62.8,8714462,59.9,413084,4.5
New York city,2000,7,3661792,59.0,3450262,55.6,211530,5.8
North Carolina,2000,7,4133433,67.6,3975465,65.0,157968,3.8
North Dakota,2000,7,342504,70.7,332460,68.6,10044,2.9
Ohio,2000,7,5772636,66.9,5532446,64.2,240190,4.2
Oklahoma,2000,7,1654254,64.1,1604129,62.2,50125,3.0
Oregon,2000,7,1814162,68.7,1717235,65.0,96927,5.3
Pennsylvania,2000,7,6097040,64.3,5837145,61.6,259895,4.3
Rhode Island,2000,7,542065,66.7,520301,64.1,21764,4.0
South Carolina,2000,7,1965426,64.9,1893401,62.5,72025,3.7
South Dakota,2000,7,407769,72.6,397419,70.8,10350,2.5
Tennessee,2000,7,2845950,65.3,2733879,62.7,112071,3.9
Texas,2000,7,10367924,68.2,9918859,65.2,449065,4.3
Utah,2000,7,1142501,72.2,1104443,69.8,38058,3.3
Vermont,2000,7,333546,70.3,324086,68.3,9460,2.8
Virginia,2000,7,3596648,67.8,3517376,66.3,79272,2.2
Washington,2000,7,3083380,69.0,2923136,65.5,160244,5.2
West Virginia,2000,7,797771,55.8,753220,52.7,44551,5.6
Wisconsin,2000,7,2984042,73.0,2879561,70.5,104481,3.5
Wyoming,2000,7,265364,71.2,255502,68.6,9862,3.7
Alabama,2000,8,2143247,63.4,2044264,60.5,98983,4.6
Alaska,2000,8,319621,73.3,299149,68.6,20472,6.4
Arizona,2000,8,2510014,65.0,2410099,62.5,99915,4.0
Arkansas,2000,8,1256863,62.0,1205114,59.4,51749,4.1
California,2000,8,16871299,67.1,16042831,63.8,828468,4.9
Los Angeles County,2000,8,4671473,66.1,4421195,62.5,250278,5.4
Colorado,2000,8,2358354,72.0,2292079,70.0,66275,2.8
Connecticut,2000,8,1758398,67.7,1722515,66.3,35883,2.0
Delaware,2000,8,414252,69.3,399036,66.7,15216,3.7
District of Columbia,2000,8,309954,67.7,292393,63.9,17561,5.7
Florida,2000,8,7934744,63.4,7636668,61.1,298076,3.8
Georgia,2000,8,4205615,68.8,4057671,66.4,147944,3.5
Hawaii,2000,8,603799,67.1,578655,64.3,25144,4.2
Idaho,2000,8,661239,69.4,630013,66.1,31226,4.7
Illinois,2000,8,6475245,69.3,6190137,66.2,285108,4.4
Indiana,2000,8,3118838,67.7,3026609,65.7,92229,3.0
Iowa,2000,8,1592249,71.3,1548545,69.3,43704,2.7
Kansas,2000,8,1398066,69.8,1344863,67.2,53203,3.8
Kentucky,2000,8,1955481,63.3,1874187,60.7,81294,4.2
Louisiana,2000,8,2018573,61.3,1913044,58.1,105529,5.2
Maine,2000,8,674473,67.8,652725,65.6,21748,3.2
Maryland,2000,8,2803670,70.1,2701581,67.6,102089,3.6
Massachusetts,2000,8,3325514,67.4,3235303,65.6,90211,2.7
Michigan,2000,8,5152974,68.5,4952767,65.8,200207,3.9
Minnesota,2000,8,2800080,74.9,2712853,72.6,87227,3.1
Mississippi,2000,8,1310023,62.5,1240298,59.1,69725,5.3
Missouri,2000,8,2968461,70.0,2865279,67.6,103182,3.5
Montana,2000,8,469716,68.3,446969,65.0,22747,4.8
Nebraska,2000,8,937517,73.0,911017,70.9,26500,2.8
Nevada,2000,8,1075476,70.3,1030790,67.4,44686,4.2
New Hampshire,2000,8,685823,72.1,668064,70.2,17759,2.6
New Jersey,2000,8,4278838,66.4,4123477,64.0,155361,3.6
New Mexico,2000,8,846626,63.1,804094,59.9,42532,5.0
New York,2000,8,9118922,62.7,8708689,59.8,410233,4.5
New York city,2000,8,3657562,58.9,3449244,55.5,208318,5.7
North Carolina,2000,8,4138444,67.6,3976108,64.9,162336,3.9
North Dakota,2000,8,342328,70.6,332255,68.5,10073,2.9
Ohio,2000,8,5767570,66.8,5529744,64.1,237826,4.1
Oklahoma,2000,8,1654069,64.1,1604248,62.1,49821,3.0
Oregon,2000,8,1812964,68.5,1715989,64.9,96975,5.3
Pennsylvania,2000,8,6102682,64.3,5841097,61.6,261585,4.3
Rhode Island,2000,8,541258,66.6,519758,63.9,21500,4.0
South Carolina,2000,8,1967870,64.9,1896996,62.6,70874,3.6
South Dakota,2000,8,407878,72.6,397346,70.7,10532,2.6
Tennessee,2000,8,2844279,65.2,2732157,62.6,112122,3.9
Texas,2000,8,10371545,68.1,9927737,65.2,443808,4.3
Utah,2000,8,1144356,72.1,1105608,69.7,38748,3.4
Vermont,2000,8,333652,70.3,324092,68.3,9560,2.9
Virginia,2000,8,3600535,67.8,3522749,66.3,77786,2.2
Washington,2000,8,3082534,68.9,2921222,65.3,161312,5.2
West Virginia,2000,8,797505,55.8,753062,52.7,44443,5.6
Wisconsin,2000,8,2984888,73.0,2879078,70.4,105810,3.5
Wyoming,2000,8,265527,71.2,255633,68.6,9894,3.7
Alabama,2000,9,2141123,63.3,2042203,60.4,98920,4.6
Alaska,2000,9,319468,73.2,299035,68.5,20433,6.4
Arizona,2000,9,2515959,65.0,2416580,62.5,99379,3.9
Arkansas,2000,9,1256360,61.9,1204522,59.3,51838,4.1
California,2000,9,16896624,67.1,16077742,63.8,818882,4.8
Los Angeles County,2000,9,4675585,66.1,4429633,62.6,245952,5.3
Colorado,2000,9,2360216,71.9,2294416,69.9,65800,2.8
Connecticut,2000,9,1757954,67.7,1721890,66.3,36064,2.1
Delaware,2000,9,415453,69.4,400210,66.8,15243,3.7
District of Columbia,2000,9,311303,68.0,293567,64.1,17736,5.7
Florida,2000,9,7950023,63.4,7652740,61.1,297283,3.7
Georgia,2000,9,4211500,68.8,4065922,66.4,145578,3.5
Hawaii,2000,9,603783,67.1,579065,64.3,24718,4.1
Idaho,2000,9,662304,69.4,631007,66.1,31297,4.7
Illinois,2000,9,6468288,69.1,6181872,66.1,286416,4.4
Indiana,2000,9,3115798,67.6,3025630,65.7,90168,2.9
Iowa,2000,9,1595899,71.4,1551361,69.4,44538,2.8
Kansas,2000,9,1397072,69.7,1343392,67.0,53680,3.8
Kentucky,2000,9,1956925,63.3,1874369,60.6,82556,4.2
Louisiana,2000,9,2019258,61.4,1912209,58.1,107049,5.3
Maine,2000,9,673290,67.6,651738,65.4,21552,3.2
Maryland,2000,9,2809536,70.2,2707058,67.6,102478,3.6
Massachusetts,2000,9,3328808,67.4,3238983,65.6,89825,2.7
Michigan,2000,9,5150327,68.4,4948522,65.7,201805,3.9
Minnesota,2000,9,2806769,75.0,2717481,72.6,89288,3.2
Mississippi,2000,9,1307260,62.3,1239098,59.0,68162,5.2
Missouri,2000,9,2973070,70.1,2865361,67.5,107709,3.6
Montana,2000,9,469254,68.2,446734,64.9,22520,4.8
Nebraska,2000,9,937888,73.0,911207,70.9,26681,2.8
Nevada,2000,9,1080030,70.4,1034296,67.4,45734,4.2
New Hampshire,2000,9,686596,72.0,669204,70.2,17392,2.5
New Jersey,2000,9,4279650,66.3,4122376,63.9,157274,3.7
New Mexico,2000,9,848142,63.1,805684,60.0,42458,5.0
New York,2000,9,9117064,62.6,8710620,59.8,406444,4.5
New York city,2000,9,3655479,58.8,3450625,55.5,204854,5.6
North Carolina,2000,9,4144132,67.6,3978577,64.9,165555,4.0
North Dakota,2000,9,342327,70.6,332257,68.5,10070,2.9
Ohio,2000,9,5766307,66.8,5531574,64.1,234733,4.1
Oklahoma,2000,9,1654299,64.0,1605173,62.1,49126,3.0
Oregon,2000,9,1812271,68.4,1716020,64.8,96251,5.3
Pennsylvania,2000,9,6110966,64.4,5848728,61.6,262238,4.3
Rhode Island,2000,9,540682,66.4,519558,63.8,21124,3.9
South Carolina,2000,9,1971496,65.0,1901466,62.6,70030,3.6
South Dakota,2000,9,408313,72.6,397642,70.7,10671,2.6
Tennessee,2000,9,2844773,65.1,2732966,62.6,111807,3.9
Texas,2000,9,10382274,68.0,9943815,65.2,438459,4.2
Utah,2000,9,1146846,72.1,1107285,69.7,39561,3.4
Vermont,2000,9,334008,70.3,324405,68.3,9603,2.9
Virginia,2000,9,3608457,67.9,3531752,66.4,76705,2.1
Washington,2000,9,3083855,68.9,2922175,65.2,161680,5.2
West Virginia,2000,9,797856,55.8,753621,52.7,44235,5.5
Wisconsin,2000,9,2987106,73.0,2880752,70.4,106354,3.6
Wyoming,2000,9,265833,71.3,255942,68.6,9891,3.7
Alabama,2000,10,2139926,63.2,2041001,60.3,98925,4.6
Alaska,2000,10,319403,73.0,299064,68.4,20339,6.4
Arizona,2000,10,2523954,65.1,2424942,62.5,99012,3.9
Arkansas,2000,10,1256632,61.9,1204595,59.3,52037,4.1
California,2000,10,16928452,67.1,16118306,63.9,810146,4.8
Los Angeles County,2000,10,4682591,66.1,4440688,62.7,241903,5.2
Colorado,2000,10,2362855,71.9,2298209,69.9,64646,2.7
Connecticut,2000,10,1757803,67.6,1721221,66.2,36582,2.1
Delaware,2000,10,417048,69.6,401740,67.0,15308,3.7
District of Columbia,2000,10,312650,68.2,294698,64.3,17952,5.7
Florida,2000,10,7968603,63.5,7671035,61.1,297568,3.7
Georgia,2000,10,4219708,68.8,4076029,66.5,143679,3.4
Hawaii,2000,10,604311,67.1,579968,64.4,24343,4.0
Idaho,2000,10,663771,69.4,632528,66.1,31243,4.7
Illinois,2000,10,6464848,69.0,6174523,65.9,290325,4.5
Indiana,2000,10,3115383,67.6,3025371,65.6,90012,2.9
Iowa,2000,10,1599621,71.5,1554252,69.5,45369,2.8
Kansas,2000,10,1397470,69.7,1343090,67.0,54380,3.9
Kentucky,2000,10,1959159,63.3,1875394,60.6,83765,4.3
Louisiana,2000,10,2022328,61.4,1913866,58.1,108462,5.4
Maine,2000,10,672805,67.5,651444,65.3,21361,3.2
Maryland,2000,10,2816124,70.2,2713711,67.7,102413,3.6
Massachusetts,2000,10,3336722,67.5,3246473,65.7,90249,2.7
Michigan,2000,10,5152050,68.4,4947870,65.7,204180,4.0
Minnesota,2000,10,2815217,75.2,2724744,72.7,90473,3.2
Mississippi,2000,10,1305140,62.2,1238459,59.0,66681,5.1
Missouri,2000,10,2979947,70.2,2867305,67.5,112642,3.8
Montana,2000,10,468924,68.1,446711,64.9,22213,4.7
Nebraska,2000,10,939042,73.0,912185,70.9,26857,2.9
Nevada,2000,10,1085010,70.5,1038180,67.5,46830,4.3
New Hampshire,2000,10,687938,72.1,670675,70.3,17263,2.5
New Jersey,2000,10,4282124,66.3,4123650,63.9,158474,3.7
New Mexico,2000,10,850024,63.2,807634,60.1,42390,5.0
New York,2000,10,9120777,62.6,8719377,59.8,401400,4.4
New York city,2000,10,3655472,58.8,3454151,55.6,201321,5.5
North Carolina,2000,10,4151937,67.6,3983626,64.9,168311,4.1
North Dakota,2000,10,342574,70.7,332575,68.6,9999,2.9
Ohio,2000,10,5769815,66.8,5539184,64.1,230631,4.0
Oklahoma,2000,10,1655384,64.0,1607005,62.2,48379,2.9
Oregon,2000,10,1812447,68.3,1717292,64.7,95155,5.3
Pennsylvania,2000,10,6122435,64.5,5860231,61.7,262204,4.3
Rhode Island,2000,10,540505,66.4,519732,63.8,20773,3.8
South Carolina,2000,10,1976505,65.0,1906278,62.7,70227,3.6
South Dakota,2000,10,409118,72.7,398340,70.8,10778,2.6
Tennessee,2000,10,2846916,65.1,2735645,62.6,111271,3.9
Texas,2000,10,10398969,68.0,9966658,65.2,432311,4.2
Utah,2000,10,1149844,72.2,1109406,69.6,40438,3.5
Vermont,2000,10,334594,70.4,324966,68.3,9628,2.9
Virginia,2000,10,3619961,68.0,3543654,66.5,76307,2.1
Washington,2000,10,3086855,68.8,2925177,65.2,161678,5.2
West Virginia,2000,10,798734,55.9,754875,52.8,43859,5.5
Wisconsin,2000,10,2991135,73.0,2884542,70.4,106593,3.6
Wyoming,2000,10,266267,71.3,256419,68.7,9848,3.7
Alabama,2000,11,2139965,63.2,2040616,60.3,99349,4.6
Alaska,2000,11,319460,72.9,299264,68.3,20196,6.3
Arizona,2000,11,2533900,65.2,2434431,62.6,99469,3.9
Arkansas,2000,11,1257547,61.9,1205079,59.3,52468,4.2
California,2000,11,16965953,67.1,16159985,63.9,805968,4.8
Los Angeles County,2000,11,4693853,66.2,4454577,62.8,239276,5.1
Colorado,2000,11,2365926,71.8,2302455,69.9,63471,2.7
Connecticut,2000,11,1757617,67.6,1720029,66.1,37588,2.1
Delaware,2000,11,418924,69.8,403523,67.2,15401,3.7
District of Columbia,2000,11,313576,68.4,295375,64.4,18201,5.8
Florida,2000,11,7989957,63.5,7689671,61.1,300286,3.8
Georgia,2000,11,4229457,68.8,4086197,66.5,143260,3.4
Hawaii,2000,11,605309,67.1,581121,64.4,24188,4.0
Idaho,2000,11,665633,69.5,634432,66.2,31201,4.7
Illinois,2000,11,6465149,69.0,6167385,65.8,297764,4.6
Indiana,2000,11,3118498,67.6,3025931,65.6,92567,3.0
Iowa,2000,11,1602761,71.7,1556340,69.6,46421,2.9
Kansas,2000,11,1398926,69.7,1343708,67.0,55218,3.9
Kentucky,2000,11,1961786,63.4,1876498,60.6,85288,4.3
Louisiana,2000,11,2026957,61.6,1917107,58.2,109850,5.4
Maine,2000,11,672955,67.4,651688,65.3,21267,3.2
Maryland,2000,11,2822425,70.3,2720153,67.8,102272,3.6
Massachusetts,2000,11,3347925,67.7,3256027,65.8,91898,2.7
Michigan,2000,11,5158205,68.4,4949225,65.6,208980,4.1
Minnesota,2000,11,2824617,75.3,2733488,72.9,91129,3.2
Mississippi,2000,11,1304138,62.1,1238350,59.0,65788,5.0
Missouri,2000,11,2987904,70.3,2870358,67.5,117546,3.9
Montana,2000,11,468687,68.0,446762,64.8,21925,4.7
Nebraska,2000,11,940867,73.1,913784,71.0,27083,2.9
Nevada,2000,11,1090188,70.6,1042157,67.5,48031,4.4
New Hampshire,2000,11,689755,72.2,672217,70.3,17538,2.5
New Jersey,2000,11,4284698,66.3,4125842,63.9,158856,3.7
New Mexico,2000,11,852051,63.3,809637,60.2,42414,5.0
New York,2000,11,9126380,62.6,8730589,59.9,395791,4.3
New York city,2000,11,3656315,58.8,3458250,55.6,198065,5.4
North Carolina,2000,11,4161618,67.7,3990039,64.9,171579,4.1
North Dakota,2000,11,343034,70.8,333169,68.7,9865,2.9
Ohio,2000,11,5777788,66.9,5551334,64.2,226454,3.9
Oklahoma,2000,11,1657371,64.1,1609291,62.2,48080,2.9
Oregon,2000,11,1813369,68.3,1718860,64.7,94509,5.2
Pennsylvania,2000,11,6136761,64.6,5874011,61.9,262750,4.3
Rhode Island,2000,11,540761,66.3,520059,63.8,20702,3.8
South Carolina,2000,11,1982769,65.2,1910496,62.8,72273,3.6
South Dakota,2000,11,410198,72.8,399282,70.9,10916,2.7
Tennessee,2000,11,2850056,65.1,2739133,62.6,110923,3.9
Texas,2000,11,10419981,68.1,9992279,65.3,427702,4.1
Utah,2000,11,1153064,72.2,1111619,69.6,41445,3.6
Vermont,2000,11,335315,70.5,325599,68.4,9716,2.9
Virginia,2000,11,3633438,68.2,3556205,66.7,77233,2.1
Washington,2000,11,3090504,68.8,2928278,65.2,162226,5.2
West Virginia,2000,11,799972,56.0,756480,52.9,43492,5.4
Wisconsin,2000,11,2996986,73.1,2889490,70.4,107496,3.6
Wyoming,2000,11,266782,71.4,256975,68.8,9807,3.7
Alabama,2000,12,2140886,63.2,2040648,60.3,100238,4.7
Alaska,2000,12,319644,72.8,299627,68.3,20017,6.3
Arizona,2000,12,2544844,65.3,2443973,62.7,100871,4.0
Arkansas,2000,12,1258869,61.9,1205680,59.3,53189,4.2
California,2000,12,17004221,67.2,16196430,64.0,807791,4.8
Los Angeles County,2000,12,4707731,66.3,4469353,63.0,238378,5.1
Colorado,2000,12,2369212,71.7,2306123,69.8,63089,2.7
Connecticut,2000,12,1757049,67.5,1717973,66.0,39076,2.2
Delaware,2000,12,420792,70.1,405350,67.5,15442,3.7
District of Columbia,2000,12,313822,68.4,295386,64.3,18436,5.9
Florida,2000,12,8011808,63.6,7706178,61.2,305630,3.8
Georgia,2000,12,4238961,68.9,4094380,66.5,144581,3.4
Hawaii,2000,12,606510,67.2,582193,64.5,24317,4.0
Idaho,2000,12,667767,69.6,636497,66.3,31270,4.7
Illinois,2000,12,6468207,69.0,6159884,65.7,308323,4.8
Indiana,2000,12,3124584,67.7,3026991,65.6,97593,3.1
Iowa,2000,12,1605280,71.8,1557642,69.6,47638,3.0
Kansas,2000,12,1400629,69.8,1344631,67.0,55998,4.0
Kentucky,2000,12,1964112,63.4,1876903,60.6,87209,4.4
Louisiana,2000,12,2031573,61.7,1920444,58.3,111129,5.5
Maine,2000,12,673545,67.4,652145,65.3,21400,3.2
Maryland,2000,12,2827342,70.3,2725038,67.8,102304,3.6
Massachusetts,2000,12,3359793,67.9,3264889,66.0,94904,2.8
Michigan,2000,12,5167109,68.5,4950193,65.6,216916,4.2
Minnesota,2000,12,2833661,75.5,2741840,73.0,91821,3.2
Mississippi,2000,12,1304068,62.1,1238504,59.0,65564,5.0
Missouri,2000,12,2994981,70.4,2873210,67.6,121771,4.1
Montana,2000,12,468491,67.9,446766,64.8,21725,4.6
Nebraska,2000,12,942907,73.3,915594,71.1,27313,2.9
Nevada,2000,12,1095217,70.7,1045870,67.5,49347,4.5
New Hampshire,2000,12,691673,72.3,673477,70.4,18196,2.6
New Jersey,2000,12,4285976,66.3,4127345,63.9,158631,3.7
New Mexico,2000,12,853878,63.4,811370,60.3,42508,5.0
New York,2000,12,9129982,62.6,8739200,59.9,390782,4.3
New York city,2000,12,3656824,58.7,3461257,55.6,195567,5.3
North Carolina,2000,12,4172079,67.8,3995828,64.9,176251,4.2
North Dakota,2000,12,343602,70.9,333887,68.9,9715,2.8
Ohio,2000,12,5788181,67.0,5564923,64.4,223258,3.9
Oklahoma,2000,12,1659710,64.2,1611353,62.3,48357,2.9
Oregon,2000,12,1814335,68.2,1719456,64.7,94879,5.2
Pennsylvania,2000,12,6151654,64.8,5887290,62.0,264364,4.3
Rhode Island,2000,12,541228,66.4,520233,63.8,20995,3.9
South Carolina,2000,12,1974250,64.8,1897991,62.3,76259,3.9
South Dakota,2000,12,411336,73.0,400245,71.0,11091,2.7
Tennessee,2000,12,2854088,65.2,2743055,62.6,111033,3.9
Texas,2000,12,10442177,68.1,10015120,65.3,427057,4.1
Utah,2000,12,1156115,72.3,1113525,69.6,42590,3.7
Vermont,2000,12,336031,70.6,326139,68.5,9892,2.9
Virginia,2000,12,3646707,68.3,3566772,66.8,79935,2.2
Washington,2000,12,3093714,68.8,2929874,65.2,163840,5.3
West Virginia,2000,12,801006,56.1,757852,53.0,43154,5.4
Wisconsin,2000,12,3004094,73.2,2894396,70.5,109698,3.7
Wyoming,2000,12,267287,71.5,257505,68.9,9782,3.7
Alabama,2001,1,2141777,63.2,2040374,60.2,101403,4.7
Alaska,2001,1,319846,72.8,300030,68.3,19816,6.2
Arizona,2001,1,2555178,65.4,2452258,62.8,102920,4.0
Arkansas,2001,1,1260049,61.9,1205911,59.3,54138,4.3
California,2001,1,17036516,67.2,16221805,64.0,814711,4.8
Los Angeles County,2001,1,4720492,66.5,4481503,63.1,238989,5.1
Colorado,2001,1,2372165,71.7,2308140,69.7,64025,2.7
Connecticut,2001,1,1755847,67.4,1714969,65.9,40878,2.3
Delaware,2001,1,422324,70.2,406976,67.7,15348,3.6
District of Columbia,2001,1,313380,68.2,294747,64.2,18633,5.9
Florida,2001,1,8031163,63.7,7718636,61.2,312527,3.9
Georgia,2001,1,4246253,68.9,4099176,66.5,147077,3.5
Hawaii,2001,1,607571,67.3,582914,64.5,24657,4.1
Idaho,2001,1,669930,69.7,638460,66.4,31470,4.7
Illinois,2001,1,6472722,69.0,6152750,65.6,319972,4.9
Indiana,2001,1,3131784,67.8,3027860,65.6,103924,3.3
Iowa,2001,1,1607287,71.8,1558411,69.7,48876,3.0
Kansas,2001,1,1401731,69.8,1345113,67.0,56618,4.0
Kentucky,2001,1,1965224,63.4,1875942,60.6,89282,4.5
Louisiana,2001,1,2034561,61.8,1922697,58.4,111864,5.5
Maine,2001,1,674292,67.4,652495,65.3,21797,3.2
Maryland,2001,1,2830333,70.3,2727705,67.8,102628,3.6
Massachusetts,2001,1,3369977,68.0,3270951,66.0,99026,2.9
Michigan,2001,1,5175795,68.6,4948660,65.6,227135,4.4
Minnesota,2001,1,2841094,75.6,2748164,73.1,92930,3.3
Mississippi,2001,1,1304179,62.1,1238457,58.9,65722,5.0
Missouri,2001,1,2999349,70.5,2874567,67.6,124782,4.2
Montana,2001,1,468240,67.8,446626,64.7,21614,4.6
Nebraska,2001,1,944664,73.4,917123,71.2,27541,2.9
Nevada,2001,1,1099598,70.8,1048953,67.5,50645,4.6
New Hampshire,2001,1,693230,72.3,674158,70.4,19072,2.8
New Jersey,2001,1,4285668,66.3,4127117,63.8,158551,3.7
New Mexico,2001,1,855167,63.5,812599,60.3,42568,5.0
New York,2001,1,9128039,62.5,8740605,59.9,387434,4.2
New York city,2001,1,3655027,58.7,3460976,55.6,194051,5.3
North Carolina,2001,1,4181546,67.9,3998775,64.9,182771,4.4
North Dakota,2001,1,344116,71.0,334528,69.0,9588,2.8
Ohio,2001,1,5798294,67.1,5576671,64.5,221623,3.8
Oklahoma,2001,1,1662044,64.2,1612914,62.3,49130,3.0
Oregon,2001,1,1814809,68.2,1718469,64.6,96340,5.3
Pennsylvania,2001,1,6164882,64.9,5897777,62.1,267105,4.3
Rhode Island,2001,1,541675,66.4,520071,63.7,21604,4.0
South Carolina,2001,1,1967678,64.6,1886258,61.9,81420,4.1
South Dakota,2001,1,412289,73.1,401011,71.1,11278,2.7
Tennessee,2001,1,2857893,65.2,2746172,62.7,111721,3.9
Texas,2001,1,10462250,68.1,10030817,65.3,431433,4.1
Utah,2001,1,1158505,72.3,1114739,69.6,43766,3.8
Vermont,2001,1,336609,70.6,326466,68.5,10143,3.0
Virginia,2001,1,3657773,68.4,3573374,66.9,84399,2.3
Washington,2001,1,3095476,68.8,2928958,65.1,166518,5.4
West Virginia,2001,1,801288,56.1,758530,53.1,42758,5.3
Wisconsin,2001,1,3011189,73.3,2898040,70.5,113149,3.8
Wyoming,2001,1,267697,71.6,257920,69.0,9777,3.7
Alabama,2001,2,2141500,63.2,2038930,60.2,102570,4.8
Alaska,2001,2,320026,72.7,300387,68.3,19639,6.1
Arizona,2001,2,2563946,65.5,2458846,62.8,105100,4.1
Arkansas,2001,2,1260761,62.0,1205527,59.2,55234,4.4
California,2001,2,17058192,67.2,16232819,64.0,825373,4.8
Los Angeles County,2001,2,4728681,66.5,4487704,63.1,240977,5.1
Colorado,2001,2,2374647,71.6,2308334,69.6,66313,2.8
Connecticut,2001,2,1754010,67.3,1711268,65.7,42742,2.4
Delaware,2001,2,423256,70.3,408164,67.8,15092,3.6
District of Columbia,2001,2,312446,68.0,293656,63.9,18790,6.0
Florida,2001,2,8045552,63.7,7725933,61.1,319619,4.0
Georgia,2001,2,4250445,68.8,4100338,66.4,150107,3.5
Hawaii,2001,2,608291,67.3,583184,64.5,25107,4.1
Idaho,2001,2,671958,69.8,640170,66.5,31788,4.7
Illinois,2001,2,6477254,69.0,6147239,65.5,330015,5.1
Indiana,2001,2,3137878,67.9,3027812,65.5,110066,3.5
Iowa,2001,2,1608759,71.9,1558748,69.7,50011,3.1
Kansas,2001,2,1401763,69.8,1344731,66.9,57032,4.1
Kentucky,2001,2,1964621,63.4,1873278,60.5,91343,4.6
Louisiana,2001,2,2035264,61.8,1923373,58.4,111891,5.5
Maine,2001,2,674993,67.5,652554,65.2,22439,3.3
Maryland,2001,2,2831516,70.3,2728083,67.7,103433,3.7
Massachusetts,2001,2,3376930,68.1,3273162,66.0,103768,3.1
Michigan,2001,2,5180402,68.6,4943477,65.5,236925,4.6
Minnesota,2001,2,2846314,75.7,2751524,73.1,94790,3.3
Mississippi,2001,2,1303459,62.0,1237565,58.9,65894,5.1
Missouri,2001,2,3000391,70.5,2873793,67.5,126598,4.2
Montana,2001,2,467916,67.7,446355,64.6,21561,4.6
Nebraska,2001,2,945847,73.4,918063,71.3,27784,2.9
Nevada,2001,2,1103074,70.8,1051286,67.5,51788,4.7
New Hampshire,2001,2,694092,72.3,674113,70.3,19979,2.9
New Jersey,2001,2,4284196,66.2,4125144,63.8,159052,3.7
New Mexico,2001,2,855877,63.5,813304,60.3,42573,5.0
New York,2001,2,9120132,62.4,8733557,59.8,386575,4.2
New York city,2001,2,3650337,58.6,3456844,55.5,193493,5.3
North Carolina,2001,2,4188581,67.9,3997445,64.8,191136,4.6
North Dakota,2001,2,344417,71.1,334908,69.1,9509,2.8
Ohio,2001,2,5806144,67.1,5584368,64.6,221776,3.8
Oklahoma,2001,2,1664211,64.3,1613887,62.4,50324,3.0
Oregon,2001,2,1814784,68.1,1716005,64.4,98779,5.4
Pennsylvania,2001,2,6174916,65.0,5904081,62.1,270835,4.4
Rhode Island,2001,2,542014,66.4,519564,63.6,22450,4.1
South Carolina,2001,2,1961288,64.3,1874545,61.4,86743,4.4
South Dakota,2001,2,412944,73.2,401473,71.1,11471,2.8
Tennessee,2001,2,2860066,65.2,2746928,62.6,113138,4.0
Texas,2001,2,10479048,68.1,10037850,65.2,441198,4.2
Utah,2001,2,1160008,72.2,1115153,69.4,44855,3.9
Vermont,2001,2,337020,70.7,326597,68.5,10423,3.1
Virginia,2001,2,3665728,68.5,3575695,66.8,90033,2.5
Washington,2001,2,3095569,68.7,2925810,64.9,169759,5.5
West Virginia,2001,2,800703,56.1,758394,53.1,42309,5.3
Wisconsin,2001,2,3016984,73.4,2899630,70.5,117354,3.9
Wyoming,2001,2,267992,71.7,258178,69.0,9814,3.7
Alabama,2001,3,2139257,63.1,2035813,60.1,103444,4.8
Alaska,2001,3,320242,72.7,300708,68.2,19534,6.1
Arizona,2001,3,2570663,65.6,2463767,62.8,106896,4.2
Arkansas,2001,3,1260887,61.9,1204622,59.2,56265,4.5
California,2001,3,17067462,67.2,16229316,63.9,838146,4.9
Los Angeles County,2001,3,4731093,66.5,4487143,63.1,243950,5.2
Colorado,2001,3,2376838,71.5,2307202,69.4,69636,2.9
Connecticut,2001,3,1751602,67.2,1707158,65.5,44444,2.5
Delaware,2001,3,423429,70.3,408737,67.8,14692,3.5
District of Columbia,2001,3,311421,67.7,292516,63.6,18905,6.1
Florida,2001,3,8053803,63.6,7728117,61.1,325686,4.0
Georgia,2001,3,4251021,68.7,4098047,66.2,152974,3.6
Hawaii,2001,3,608571,67.3,583097,64.5,25474,4.2
Idaho,2001,3,673742,69.9,641583,66.6,32159,4.8
Illinois,2001,3,6479113,69.0,6142766,65.4,336347,5.2
Indiana,2001,3,3140939,68.0,3026034,65.5,114905,3.7
Iowa,2001,3,1609527,71.9,1558694,69.7,50833,3.2
Kansas,2001,3,1400671,69.7,1343513,66.8,57158,4.1
Kentucky,2001,3,1962263,63.3,1868983,60.3,93280,4.8
Louisiana,2001,3,2033367,61.7,1922359,58.4,111008,5.5
Maine,2001,3,675405,67.5,652184,65.1,23221,3.4
Maryland,2001,3,2831057,70.2,2726306,67.6,104751,3.7
Massachusetts,2001,3,3380386,68.2,3271755,66.0,108631,3.2
Michigan,2001,3,5178441,68.5,4934622,65.3,243819,4.7
Minnesota,2001,3,2848984,75.7,2751722,73.1,97262,3.4
Mississippi,2001,3,1301372,61.9,1235470,58.8,65902,5.1
Missouri,2001,3,2998294,70.4,2870983,67.4,127311,4.2
Montana,2001,3,467435,67.6,445940,64.5,21495,4.6
Nebraska,2001,3,946352,73.4,918311,71.3,28041,3.0
Nevada,2001,3,1105674,70.7,1052888,67.4,52786,4.8
New Hampshire,2001,3,694114,72.2,673323,70.1,20791,3.0
New Jersey,2001,3,4281978,66.1,4121899,63.7,160079,3.7
New Mexico,2001,3,855891,63.4,813531,60.3,42360,4.9
New York,2001,3,9108245,62.3,8719823,59.7,388422,4.3
New York city,2001,3,3643943,58.4,3450302,55.3,193641,5.3
North Carolina,2001,3,4192268,67.9,3991708,64.6,200560,4.8
North Dakota,2001,3,344309,71.1,334851,69.1,9458,2.7
Ohio,2001,3,5810671,67.2,5587139,64.6,223532,3.8
Oklahoma,2001,3,1665929,64.3,1614117,62.3,51812,3.1
Oregon,2001,3,1814100,68.0,1712458,64.2,101642,5.6
Pennsylvania,2001,3,6180184,65.0,5905154,62.1,275030,4.5
Rhode Island,2001,3,542098,66.3,518777,63.5,23321,4.3
South Carolina,2001,3,1954252,64.0,1862977,61.0,91275,4.7
South Dakota,2001,3,413298,73.2,401645,71.1,11653,2.8
Tennessee,2001,3,2859771,65.2,2744562,62.5,115209,4.0
Texas,2001,3,10492222,68.1,10037198,65.1,455024,4.3
Utah,2001,3,1160651,72.1,1114848,69.3,45803,3.9
Vermont,2001,3,337288,70.7,326607,68.4,10681,3.2
Virginia,2001,3,3670733,68.5,3574644,66.7,96089,2.6
Washington,2001,3,3093906,68.6,2921179,64.7,172727,5.6
West Virginia,2001,3,799386,56.0,757535,53.1,41851,5.2
Wisconsin,2001,3,3020474,73.4,2898934,70.5,121540,4.0
Wyoming,2001,3,268171,71.7,258287,69.0,9884,3.7
Alabama,2001,4,2135072,63.0,2030986,59.9,104086,4.9
Alaska,2001,4,320488,72.6,300987,68.2,19501,6.1
Arizona,2001,4,2575436,65.5,2467052,62.8,108384,4.2
Arkansas,2001,4,1260413,61.9,1203276,59.1,57137,4.5
California,2001,4,17066003,67.1,16213500,63.7,852503,5.0
Los Angeles County,2001,4,4727642,66.4,4480004,62.9,247638,5.2
Colorado,2001,4,2379022,71.4,2305575,69.2,73447,3.1
Connecticut,2001,4,1748846,67.1,1702915,65.3,45931,2.6
Delaware,2001,4,422887,70.1,408637,67.8,14250,3.4
District of Columbia,2001,4,310624,67.5,291607,63.3,19017,6.1
Florida,2001,4,8057451,63.6,7726938,61.0,330513,4.1
Georgia,2001,4,4248265,68.5,4092954,66.0,155311,3.7
Hawaii,2001,4,608338,67.2,582822,64.4,25516,4.2
Idaho,2001,4,675268,70.0,642708,66.6,32560,4.8
Illinois,2001,4,6475826,68.9,6137057,65.3,338769,5.2
Indiana,2001,4,3140459,67.9,3022219,65.4,118240,3.8
Iowa,2001,4,1610026,71.9,1558753,69.6,51273,3.2
Kansas,2001,4,1398726,69.6,1341682,66.7,57044,4.1
Kentucky,2001,4,1958517,63.1,1863501,60.1,95016,4.9
Louisiana,2001,4,2029478,61.6,1920030,58.3,109448,5.4
Maine,2001,4,675436,67.4,651441,65.0,23995,3.6
Maryland,2001,4,2829251,70.1,2722683,67.4,106568,3.8
Massachusetts,2001,4,3381432,68.1,3268013,65.8,113419,3.4
Michigan,2001,4,5169900,68.4,4922437,65.1,247463,4.8
Minnesota,2001,4,2848906,75.6,2749027,72.9,99879,3.5
Mississippi,2001,4,1298215,61.8,1232251,58.6,65964,5.1
Missouri,2001,4,2993694,70.2,2866523,67.2,127171,4.2
Montana,2001,4,466697,67.5,445317,64.4,21380,4.6
Nebraska,2001,4,946186,73.4,917886,71.2,28300,3.0
Nevada,2001,4,1107606,70.7,1053881,67.2,53725,4.9
New Hampshire,2001,4,693399,72.1,671876,69.8,21523,3.1
New Jersey,2001,4,4279861,66.1,4117826,63.6,162035,3.8
New Mexico,2001,4,855246,63.4,813398,60.3,41848,4.9
New York,2001,4,9095320,62.2,8701872,59.5,393448,4.3
New York city,2001,4,3636999,58.3,3442021,55.2,194978,5.4
North Carolina,2001,4,4191819,67.8,3982108,64.4,209711,5.0
North Dakota,2001,4,343782,71.0,334370,69.0,9412,2.7
Ohio,2001,4,5811816,67.1,5585021,64.5,226795,3.9
Oklahoma,2001,4,1666892,64.4,1613465,62.3,53427,3.2
Oregon,2001,4,1813028,67.9,1708533,64.0,104495,5.8
Pennsylvania,2001,4,6180288,65.0,5901257,62.1,279031,4.5
Rhode Island,2001,4,541856,66.3,517876,63.3,23980,4.4
South Carolina,2001,4,1946825,63.7,1852116,60.6,94709,4.9
South Dakota,2001,4,413376,73.1,401571,71.0,11805,2.9
Tennessee,2001,4,2857284,65.1,2739708,62.4,117576,4.1
Texas,2001,4,10502031,68.1,10031118,65.0,470913,4.5
Utah,2001,4,1160695,72.0,1114003,69.1,46692,4.0
Vermont,2001,4,337429,70.6,326558,68.4,10871,3.2
Virginia,2001,4,3673465,68.5,3571404,66.6,102061,2.8
Washington,2001,4,3090758,68.4,2915751,64.5,175007,5.7
West Virginia,2001,4,797643,55.9,756168,53.0,41475,5.2
Wisconsin,2001,4,3021235,73.4,2896277,70.3,124958,4.1
Wyoming,2001,4,268260,71.7,258279,69.0,9981,3.7
Alabama,2001,5,2130035,62.8,2025197,59.7,104838,4.9
Alaska,2001,5,320814,72.6,301260,68.1,19554,6.1
Arizona,2001,5,2579399,65.5,2469093,62.7,110306,4.3
Arkansas,2001,5,1259729,61.8,1201821,59.0,57908,4.6
California,2001,5,17061915,67.0,16191476,63.6,870439,5.1
Los Angeles County,2001,5,4721303,66.2,4468806,62.7,252497,5.3
Colorado,2001,5,2381894,71.4,2304342,69.1,77552,3.3
Connecticut,2001,5,1746614,67.0,1699291,65.1,47323,2.7
Delaware,2001,5,421954,69.9,408021,67.6,13933,3.3
District of Columbia,2001,5,310303,67.3,291112,63.2,19191,6.2
Florida,2001,5,8060205,63.5,7724967,60.9,335238,4.2
Georgia,2001,5,4244522,68.4,4086701,65.8,157821,3.7
Hawaii,2001,5,607700,67.1,582487,64.3,25213,4.1
Idaho,2001,5,676697,70.0,643669,66.6,33028,4.9
Illinois,2001,5,6468552,68.8,6129446,65.2,339106,5.2
Indiana,2001,5,3138280,67.8,3017196,65.2,121084,3.9
Iowa,2001,5,1610648,71.9,1559211,69.6,51437,3.2
Kansas,2001,5,1396636,69.4,1339756,66.6,56880,4.1
Kentucky,2001,5,1954385,63.0,1857689,59.9,96696,4.9
Louisiana,2001,5,2025314,61.5,1917313,58.2,108001,5.3
Maine,2001,5,675353,67.3,650651,64.9,24702,3.7
Maryland,2001,5,2827494,70.0,2718303,67.3,109191,3.9
Massachusetts,2001,5,3382048,68.1,3263771,65.7,118277,3.5
Michigan,2001,5,5157214,68.2,4907941,64.9,249273,4.8
Minnesota,2001,5,2847221,75.4,2744908,72.7,102313,3.6
Mississippi,2001,5,1294852,61.6,1228504,58.4,66348,5.1
Missouri,2001,5,2988304,70.0,2861336,67.1,126968,4.2
Montana,2001,5,465819,67.3,444567,64.2,21252,4.6
Nebraska,2001,5,945687,73.3,917143,71.1,28544,3.0
Nevada,2001,5,1109352,70.5,1054604,67.1,54748,4.9
New Hampshire,2001,5,692330,71.9,670101,69.6,22229,3.2
New Jersey,2001,5,4279650,66.0,4114060,63.5,165590,3.9
New Mexico,2001,5,854379,63.3,813146,60.2,41233,4.8
New York,2001,5,9087010,62.1,8684335,59.4,402675,4.4
New York city,2001,5,3631949,58.2,3433497,55.0,198452,5.5
North Carolina,2001,5,4189087,67.7,3970968,64.1,218119,5.2
North Dakota,2001,5,343071,70.8,333683,68.9,9388,2.7
Ohio,2001,5,5812072,67.1,5580007,64.4,232065,4.0
Oklahoma,2001,5,1667424,64.4,1612236,62.2,55188,3.3
Oregon,2001,5,1812473,67.8,1705200,63.8,107273,5.9
Pennsylvania,2001,5,6177356,65.0,5894367,62.0,282989,4.6
Rhode Island,2001,5,541488,66.2,517143,63.2,24345,4.5
South Carolina,2001,5,1940163,63.4,1842559,60.2,97604,5.0
South Dakota,2001,5,413319,73.1,401367,71.0,11952,2.9
Tennessee,2001,5,2854355,64.9,2734072,62.2,120283,4.2
Texas,2001,5,10511424,68.0,10023661,64.9,487763,4.6
Utah,2001,5,1160718,71.9,1112990,68.9,47728,4.1
Vermont,2001,5,337553,70.6,326566,68.3,10987,3.3
Virginia,2001,5,3675170,68.5,3567108,66.4,108062,2.9
Washington,2001,5,3087259,68.2,2910430,64.3,176829,5.7
West Virginia,2001,5,795920,55.8,754638,52.9,41282,5.2
Wisconsin,2001,5,3020351,73.3,2892795,70.2,127556,4.2
Wyoming,2001,5,268332,71.7,258220,69.0,10112,3.8
Alabama,2001,6,2125294,62.7,2019160,59.5,106134,5.0
Alaska,2001,6,321252,72.6,301545,68.1,19707,6.1
Arizona,2001,6,2583941,65.5,2470488,62.6,113453,4.4
Arkansas,2001,6,1259197,61.8,1200558,58.9,58639,4.7
California,2001,6,17062514,66.9,16168434,63.4,894080,5.2
Los Angeles County,2001,6,4716100,66.1,4457045,62.5,259055,5.5
Colorado,2001,6,2386088,71.3,2303819,68.9,82269,3.4
Connecticut,2001,6,1745327,66.9,1696540,65.0,48787,2.8
Delaware,2001,6,421064,69.7,407191,67.4,13873,3.3
District of Columbia,2001,6,310421,67.3,290914,63.1,19507,6.3
Florida,2001,6,8064197,63.4,7722943,60.7,341254,4.2
Georgia,2001,6,4242516,68.2,4080730,65.6,161786,3.8
Hawaii,2001,6,606975,66.9,582108,64.2,24867,4.1
Idaho,2001,6,678132,70.0,644538,66.6,33594,5.0
Illinois,2001,6,6459192,68.7,6119367,65.1,339825,5.3
Indiana,2001,6,3137043,67.8,3012271,65.1,124772,4.0
Iowa,2001,6,1611094,71.9,1559480,69.6,51614,3.2
Kansas,2001,6,1395029,69.3,1338024,66.5,57005,4.1
Kentucky,2001,6,1950891,62.8,1852210,59.7,98681,5.1
Louisiana,2001,6,2022275,61.4,1914852,58.1,107423,5.3
Maine,2001,6,675346,67.3,650029,64.7,25317,3.7
Maryland,2001,6,2827207,69.9,2714274,67.1,112933,4.0
Massachusetts,2001,6,3383349,68.1,3259884,65.6,123465,3.6
Michigan,2001,6,5143387,67.9,4891453,64.6,251934,4.9
Minnesota,2001,6,2845315,75.3,2740838,72.5,104477,3.7
Mississippi,2001,6,1291859,61.4,1224684,58.2,67175,5.2
Missouri,2001,6,2983912,69.9,2855975,66.9,127937,4.3
Montana,2001,6,464970,67.1,443817,64.1,21153,4.5
Nebraska,2001,6,945107,73.2,916309,71.0,28798,3.0
Nevada,2001,6,1111300,70.4,1055337,66.9,55963,5.0
New Hampshire,2001,6,691325,71.7,668343,69.3,22982,3.3
New Jersey,2001,6,4282085,66.0,4111205,63.4,170880,4.0
New Mexico,2001,6,853680,63.2,812903,60.1,40777,4.8
New York,2001,6,9087123,62.1,8670637,59.2,416486,4.6
New York city,2001,6,3630812,58.1,3426186,54.8,204626,5.6
North Carolina,2001,6,4186363,67.5,3960189,63.9,226174,5.4
North Dakota,2001,6,342370,70.7,332979,68.8,9391,2.7
Ohio,2001,6,5814261,67.1,5574358,64.3,239903,4.1
Oklahoma,2001,6,1668255,64.4,1611000,62.2,57255,3.4
Oregon,2001,6,1812656,67.7,1702502,63.6,110154,6.1
Pennsylvania,2001,6,6173797,64.9,5886204,61.9,287593,4.7
Rhode Island,2001,6,541149,66.1,516713,63.1,24436,4.5
South Carolina,2001,6,1935156,63.2,1834543,59.9,100613,5.2
South Dakota,2001,6,413228,73.0,401134,70.9,12094,2.9
Tennessee,2001,6,2852236,64.8,2728708,62.0,123528,4.3
Texas,2001,6,10522773,68.0,10017556,64.7,505217,4.8
Utah,2001,6,1161120,71.7,1112080,68.7,49040,4.2
Vermont,2001,6,337764,70.6,326706,68.3,11058,3.3
Virginia,2001,6,3677022,68.4,3562305,66.3,114717,3.1
Washington,2001,6,3084091,68.1,2905333,64.1,178758,5.8
West Virginia,2001,6,794592,55.7,753241,52.8,41351,5.2
Wisconsin,2001,6,3018999,73.2,2889072,70.0,129927,4.3
Wyoming,2001,6,268413,71.6,258166,68.9,10247,3.8
Alabama,2001,7,2122119,62.6,2013716,59.4,108403,5.1
Alaska,2001,7,321790,72.6,301846,68.1,19944,6.2
Arizona,2001,7,2590486,65.5,2472036,62.5,118450,4.6
Arkansas,2001,7,1259269,61.7,1199744,58.8,59525,4.7
California,2001,7,17073157,66.8,16148575,63.2,924582,5.4
Los Angeles County,2001,7,4715500,66.0,4447879,62.3,267621,5.7
Colorado,2001,7,2392144,71.4,2303968,68.7,88176,3.7
Connecticut,2001,7,1745050,66.8,1694574,64.9,50476,2.9
Delaware,2001,7,420520,69.5,406419,67.2,14101,3.4
District of Columbia,2001,7,310775,67.4,290796,63.0,19979,6.4
Florida,2001,7,8070383,63.4,7720797,60.6,349586,4.3
Georgia,2001,7,4244587,68.1,4076332,65.4,168255,4.0
Hawaii,2001,7,606588,66.9,581723,64.1,24865,4.1
Idaho,2001,7,679601,70.1,645370,66.5,34231,5.0
Illinois,2001,7,6450244,68.5,6107545,64.9,342699,5.3
Indiana,2001,7,3138321,67.8,3008039,65.0,130282,4.2
Iowa,2001,7,1611270,71.9,1559066,69.6,52204,3.2
Kansas,2001,7,1394452,69.2,1336746,66.4,57706,4.1
Kentucky,2001,7,1948804,62.7,1847523,59.5,101281,5.2
Louisiana,2001,7,2021385,61.3,1912999,58.1,108386,5.4
Maine,2001,7,675381,67.2,649543,64.6,25838,3.8
Maryland,2001,7,2829195,69.8,2711499,66.9,117696,4.2
Massachusetts,2001,7,3385812,68.1,3256581,65.5,129231,3.8
Michigan,2001,7,5131220,67.7,4873266,64.3,257954,5.0
Minnesota,2001,7,2844372,75.2,2737689,72.4,106683,3.8
Mississippi,2001,7,1289905,61.3,1221187,58.0,68718,5.3
Missouri,2001,7,2981618,69.8,2850902,66.7,130716,4.4
Montana,2001,7,464267,67.0,443137,63.9,21130,4.6
Nebraska,2001,7,944777,73.2,915576,70.9,29201,3.1
Nevada,2001,7,1113746,70.4,1056285,66.8,57461,5.2
New Hampshire,2001,7,690693,71.5,666896,69.0,23797,3.4
New Jersey,2001,7,4287346,66.1,4109485,63.3,177861,4.1
New Mexico,2001,7,853430,63.1,812686,60.1,40744,4.8
New York,2001,7,9096796,62.1,8661781,59.1,435015,4.8
New York city,2001,7,3634240,58.1,3420367,54.7,213873,5.9
North Carolina,2001,7,4185454,67.4,3950343,63.6,235111,5.6
North Dakota,2001,7,341828,70.6,332394,68.6,9434,2.8
Ohio,2001,7,5819450,67.1,5569288,64.2,250162,4.3
Oklahoma,2001,7,1670245,64.4,1610316,62.1,59929,3.6
Oregon,2001,7,1813351,67.6,1699586,63.4,113765,6.3
Pennsylvania,2001,7,6171901,64.9,5878583,61.8,293318,4.8
Rhode Island,2001,7,540980,66.0,516608,63.0,24372,4.5
South Carolina,2001,7,1932382,63.0,1828344,59.6,104038,5.4
South Dakota,2001,7,413245,72.9,400976,70.8,12269,3.0
Tennessee,2001,7,2851637,64.8,2724207,61.9,127430,4.5
Texas,2001,7,10537755,68.0,10013363,64.6,524392,5.0
Utah,2001,7,1162087,71.6,1111452,68.5,50635,4.4
Vermont,2001,7,338109,70.6,326965,68.3,11144,3.3
Virginia,2001,7,3680168,68.4,3557698,66.1,122470,3.3
Washington,2001,7,3081703,67.9,2900044,63.9,181659,5.9
West Virginia,2001,7,793894,55.7,752217,52.8,41677,5.2
Wisconsin,2001,7,3018019,73.1,2885334,69.9,132685,4.4
Wyoming,2001,7,268525,71.6,258174,68.9,10351,3.9
Alabama,2001,8,2120291,62.5,2008675,59.2,111616,5.3
Alaska,2001,8,322275,72.5,302019,68.0,20256,6.3
Arizona,2001,8,2598978,65.5,2473638,62.4,125340,4.8
Arkansas,2001,8,1259971,61.7,1199157,58.7,60814,4.8
California,2001,8,17091666,66.8,16129846,63.1,961820,5.6
Los Angeles County,2001,8,4719876,66.0,4441811,62.1,278065,5.9
Colorado,2001,8,2399781,71.5,2303806,68.6,95975,4.0
Connecticut,2001,8,1745456,66.8,1692990,64.8,52466,3.0
Delaware,2001,8,420277,69.4,405713,67.0,14564,3.5
District of Columbia,2001,8,311144,67.4,290597,63.0,20547,6.6
Florida,2001,8,8076689,63.3,7716575,60.5,360114,4.5
Georgia,2001,8,4250549,68.1,4073248,65.2,177301,4.2
Hawaii,2001,8,606629,66.8,581236,64.0,25393,4.2
Idaho,2001,8,680932,70.1,645959,66.5,34973,5.1
Illinois,2001,8,6442403,68.4,6093093,64.7,349310,5.4
Indiana,2001,8,3141688,67.8,3003900,64.8,137788,4.4
Iowa,2001,8,1611115,71.9,1557650,69.5,53465,3.3
Kansas,2001,8,1394856,69.2,1335748,66.3,59108,4.2
Kentucky,2001,8,1947770,62.7,1843171,59.3,104599,5.4
Louisiana,2001,8,2022156,61.3,1911061,58.0,111095,5.5
Maine,2001,8,675280,67.1,648922,64.5,26358,3.9
Maryland,2001,8,2833098,69.8,2709783,66.8,123315,4.4
Massachusetts,2001,8,3388682,68.1,3253013,65.3,135669,4.0
Michigan,2001,8,5120998,67.6,4852419,64.0,268579,5.2
Minnesota,2001,8,2844775,75.1,2735241,72.2,109534,3.9
Mississippi,2001,8,1289104,61.2,1217850,57.9,71254,5.5
Missouri,2001,8,2980711,69.7,2845723,66.5,134988,4.5
Montana,2001,8,463726,66.8,442516,63.8,21210,4.6
Nebraska,2001,8,944642,73.1,914791,70.8,29851,3.2
Nevada,2001,8,1116526,70.4,1057209,66.6,59317,5.3
New Hampshire,2001,8,690370,71.4,665742,68.8,24628,3.6
New Jersey,2001,8,4294049,66.1,4107542,63.2,186507,4.3
New Mexico,2001,8,853568,63.0,812324,60.0,41244,4.8
New York,2001,8,9113151,62.2,8655226,59.1,457925,5.0
New York city,2001,8,3641653,58.2,3415501,54.6,226152,6.2
North Carolina,2001,8,4186896,67.4,3940606,63.4,246290,5.9
North Dakota,2001,8,341435,70.5,331875,68.5,9560,2.8
Ohio,2001,8,5825748,67.2,5563407,64.1,262341,4.5
Oklahoma,2001,8,1673342,64.5,1609938,62.0,63404,3.8
Oregon,2001,8,1814343,67.6,1695571,63.2,118772,6.5
Pennsylvania,2001,8,6172531,64.8,5871636,61.7,300895,4.9
Rhode Island,2001,8,540990,65.9,516608,63.0,24382,4.5
South Carolina,2001,8,1931337,62.9,1823529,59.4,107808,5.6
South Dakota,2001,8,413374,72.9,400825,70.7,12549,3.0
Tennessee,2001,8,2852352,64.7,2720048,61.7,132304,4.6
Texas,2001,8,10554649,68.0,10007996,64.4,546653,5.2
Utah,2001,8,1163273,71.6,1110823,68.4,52450,4.5
Vermont,2001,8,338468,70.6,327180,68.3,11288,3.3
Virginia,2001,8,3684038,68.4,3552829,65.9,131209,3.6
Washington,2001,8,3080051,67.8,2893570,63.7,186481,6.1
West Virginia,2001,8,793780,55.7,751464,52.7,42316,5.3
Wisconsin,2001,8,3017389,73.0,2880946,69.7,136443,4.5
Wyoming,2001,8,268596,71.6,258172,68.8,10424,3.9
Alabama,2001,9,2119126,62.4,2003790,59.0,115336,5.4
Alaska,2001,9,322657,72.5,302053,67.9,20604,6.4
Arizona,2001,9,2608688,65.6,2475140,62.2,133548,5.1
Arkansas,2001,9,1261044,61.7,1198568,58.7,62476,5.0
California,2001,9,17114525,66.8,16111501,62.9,1003024,5.9
Los Angeles County,2001,9,4728007,66.1,4438437,62.0,289570,6.1
Colorado,2001,9,2408440,71.6,2302903,68.5,105537,4.4
Connecticut,2001,9,1746455,66.8,1691752,64.7,54703,3.1
Delaware,2001,9,420226,69.3,405065,66.8,15161,3.6
District of Columbia,2001,9,311252,67.4,290128,62.9,21124,6.8
Florida,2001,9,8080994,63.2,7709589,60.3,371405,4.6
Georgia,2001,9,4259318,68.1,4071269,65.1,188049,4.4
Hawaii,2001,9,606885,66.8,580511,63.9,26374,4.3
Idaho,2001,9,682023,70.1,646139,66.4,35884,5.3
Illinois,2001,9,6436126,68.3,6076326,64.5,359800,5.6
Indiana,2001,9,3146603,67.9,2999956,64.7,146647,4.7
Iowa,2001,9,1610881,71.9,1555541,69.4,55340,3.4
Kansas,2001,9,1396032,69.2,1334938,66.2,61094,4.4
Kentucky,2001,9,1947289,62.6,1838988,59.1,108301,5.6
Louisiana,2001,9,2023510,61.3,1908467,57.9,115043,5.7
Maine,2001,9,674951,67.0,648073,64.3,26878,4.0
Maryland,2001,9,2838500,69.9,2709147,66.7,129353,4.6
Massachusetts,2001,9,3391514,68.1,3248977,65.2,142537,4.2
Michigan,2001,9,5111382,67.4,4829210,63.7,282172,5.5
Minnesota,2001,9,2846603,75.1,2733236,72.1,113367,4.0
Mississippi,2001,9,1289177,61.2,1214659,57.7,74518,5.8
Missouri,2001,9,2980289,69.6,2840391,66.3,139898,4.7
Montana,2001,9,463380,66.7,442031,63.6,21349,4.6
Nebraska,2001,9,944582,73.1,913864,70.7,30718,3.3
Nevada,2001,9,1119335,70.3,1057937,66.5,61398,5.5
New Hampshire,2001,9,690277,71.2,664832,68.6,25445,3.7
New Jersey,2001,9,4301190,66.2,4104819,63.2,196371,4.6
New Mexico,2001,9,854044,63.0,811848,59.9,42196,4.9
New York,2001,9,9133898,62.3,8650292,59.0,483606,5.3
New York city,2001,9,3652264,58.4,3411913,54.5,240351,6.6
North Carolina,2001,9,4190543,67.3,3930913,63.2,259630,6.2
North Dakota,2001,9,341184,70.4,331402,68.4,9782,2.9
Ohio,2001,9,5831547,67.2,5555756,64.0,275791,4.7
Oklahoma,2001,9,1676984,64.6,1609659,62.0,67325,4.0
Oregon,2001,9,1815624,67.5,1690500,62.9,125124,6.9
Pennsylvania,2001,9,6175610,64.8,5865302,61.6,310308,5.0
Rhode Island,2001,9,541193,65.9,516601,62.9,24592,4.5
South Carolina,2001,9,1931257,62.9,1819631,59.2,111626,5.8
South Dakota,2001,9,413551,72.9,400636,70.6,12915,3.1
Tennessee,2001,9,2854605,64.7,2716455,61.6,138150,4.8
Texas,2001,9,10571682,67.9,10000407,64.3,571275,5.4
Utah,2001,9,1164418,71.5,1110022,68.2,54396,4.7
Vermont,2001,9,338773,70.6,327299,68.2,11474,3.4
Virginia,2001,9,3688173,68.3,3547843,65.7,140330,3.8
Washington,2001,9,3079041,67.7,2886014,63.4,193027,6.3
West Virginia,2001,9,794154,55.7,750851,52.6,43303,5.5
Wisconsin,2001,9,3016955,72.9,2875462,69.5,141493,4.7
Wyoming,2001,9,268547,71.5,258098,68.7,10449,3.9
Alabama,2001,10,2118136,62.4,1999094,58.9,119042,5.6
Alaska,2001,10,323003,72.4,302033,67.7,20970,6.5
Arizona,2001,10,2618988,65.7,2476968,62.1,142020,5.4
Arkansas,2001,10,1262397,61.8,1198077,58.6,64320,5.1
California,2001,10,17139126,66.8,16095235,62.8,1043891,6.1
Los Angeles County,2001,10,4737865,66.1,4436845,61.9,301020,6.4
Colorado,2001,10,2417657,71.8,2301764,68.4,115893,4.8
Connecticut,2001,10,1748089,66.8,1691061,64.6,57028,3.3
Delaware,2001,10,420247,69.2,404457,66.6,15790,3.8
District of Columbia,2001,10,311092,67.4,289466,62.7,21626,7.0
Florida,2001,10,8007931,62.5,7610061,59.4,397870,5.0
Georgia,2001,10,4269917,68.1,4070697,65.0,199220,4.7
Hawaii,2001,10,607057,66.7,579538,63.7,27519,4.5
Idaho,2001,10,682863,70.0,645956,66.2,36907,5.4
Illinois,2001,10,6431162,68.2,6058843,64.3,372319,5.8
Indiana,2001,10,3151903,67.9,2996271,64.6,155632,4.9
Iowa,2001,10,1611068,71.8,1553561,69.3,57507,3.6
Kansas,2001,10,1397804,69.2,1334393,66.1,63411,4.5
Kentucky,2001,10,1947067,62.5,1835318,59.0,111749,5.7
Louisiana,2001,10,2024273,61.3,1905047,57.7,119226,5.9
Maine,2001,10,674462,66.9,647105,64.2,27357,4.1
Maryland,2001,10,2845034,69.9,2710063,66.6,134971,4.7
Massachusetts,2001,10,3394609,68.1,3245271,65.1,149338,4.4
Michigan,2001,10,5101413,67.2,4805317,63.3,296096,5.8
Minnesota,2001,10,2849487,75.1,2731592,72.0,117895,4.1
Mississippi,2001,10,1289626,61.2,1211802,57.5,77824,6.0
Missouri,2001,10,2980040,69.5,2835353,66.2,144687,4.9
Montana,2001,10,463330,66.6,441818,63.5,21512,4.6
Nebraska,2001,10,944631,73.0,912954,70.6,31677,3.4
Nevada,2001,10,1122018,70.3,1058611,66.3,63407,5.7
New Hampshire,2001,10,690396,71.2,664189,68.5,26207,3.8
New Jersey,2001,10,4308923,66.2,4102065,63.1,206858,4.8
New Mexico,2001,10,854889,62.9,811497,59.7,43392,5.1
New York,2001,10,9157095,62.4,8647326,58.9,509769,5.6
New York city,2001,10,3664338,58.5,3409558,54.5,254780,7.0
North Carolina,2001,10,4195507,67.3,3921953,63.0,273554,6.5
North Dakota,2001,10,341048,70.4,330982,68.3,10066,3.0
Ohio,2001,10,5836269,67.2,5546560,63.9,289709,5.0
Oklahoma,2001,10,1680495,64.7,1609570,61.9,70925,4.2
Oregon,2001,10,1817205,67.5,1685269,62.6,131936,7.3
Pennsylvania,2001,10,6180689,64.9,5860262,61.5,320427,5.2
Rhode Island,2001,10,541587,65.9,516658,62.8,24929,4.6
South Carolina,2001,10,1931600,62.8,1816505,59.1,115095,6.0
South Dakota,2001,10,413758,72.9,400448,70.5,13310,3.2
Tennessee,2001,10,2858509,64.7,2713982,61.5,144527,5.1
Texas,2001,10,10588115,67.9,9992389,64.1,595726,5.6
Utah,2001,10,1165570,71.4,1109225,68.0,56345,4.8
Vermont,2001,10,339046,70.6,327378,68.2,11668,3.4
Virginia,2001,10,3692646,68.3,3543843,65.6,148803,4.0
Washington,2001,10,3078364,67.6,2878269,63.2,200095,6.5
West Virginia,2001,10,794894,55.7,750326,52.6,44568,5.6
Wisconsin,2001,10,3016564,72.8,2869184,69.3,147380,4.9
Wyoming,2001,10,268424,71.4,257994,68.6,10430,3.9
Alabama,2001,11,2116512,62.3,1994393,58.7,122119,5.8
Alaska,2001,11,323344,72.4,301982,67.6,21362,6.6
Arizona,2001,11,2628928,65.8,2479380,62.1,149548,5.7
Arkansas,2001,11,1263950,61.8,1197823,58.6,66127,5.2
California,2001,11,17161602,66.8,16081351,62.6,1080251,6.3
Los Angeles County,2001,11,4746086,66.2,4434910,61.9,311176,6.6
Colorado,2001,11,2426577,72.0,2300730,68.2,125847,5.2
Connecticut,2001,11,1750196,66.8,1690859,64.6,59337,3.4
Delaware,2001,11,420223,69.1,403827,66.4,16396,3.9
District of Columbia,2001,11,310782,67.3,288808,62.6,21974,7.1
Florida,2001,11,8010652,62.4,7600865,59.2,409787,5.1
Georgia,2001,11,4280798,68.2,4071417,64.9,209381,4.9
Hawaii,2001,11,606823,66.7,578420,63.5,28403,4.7
Idaho,2001,11,683401,70.0,645460,66.1,37941,5.6
Illinois,2001,11,6425773,68.1,6041133,64.0,384640,6.0
Indiana,2001,11,3155789,68.0,2992463,64.5,163326,5.2
Iowa,2001,11,1611932,71.9,1552302,69.2,59630,3.7
Kansas,2001,11,1399944,69.3,1334154,66.1,65790,4.7
Kentucky,2001,11,1946442,62.5,1832265,58.8,114177,5.9
Louisiana,2001,11,2023422,61.3,1900945,57.6,122477,6.1
Maine,2001,11,673926,66.8,646143,64.0,27783,4.1
Maryland,2001,11,2852049,70.0,2712532,66.6,139517,4.9
Massachusetts,2001,11,3398382,68.1,3242751,65.0,155631,4.6
Michigan,2001,11,5090268,67.0,4782389,63.0,307879,6.0
Minnesota,2001,11,2852819,75.1,2730169,71.9,122650,4.3
Mississippi,2001,11,1289887,61.2,1209224,57.4,80663,6.3
Missouri,2001,11,2979828,69.5,2830930,66.0,148898,5.0
Montana,2001,11,463540,66.6,441864,63.5,21676,4.7
Nebraska,2001,11,944797,73.0,912172,70.5,32625,3.5
Nevada,2001,11,1124320,70.2,1059301,66.2,65019,5.8
New Hampshire,2001,11,690670,71.1,663766,68.3,26904,3.9
New Jersey,2001,11,4316802,66.3,4099508,63.0,217294,5.0
New Mexico,2001,11,855957,62.9,811413,59.7,44544,5.2
New York,2001,11,9180165,62.5,8646147,58.9,534018,5.8
New York city,2001,11,3676068,58.7,3408027,54.4,268041,7.3
North Carolina,2001,11,4201276,67.4,3914756,62.8,286520,6.8
North Dakota,2001,11,340966,70.4,330589,68.2,10377,3.0
Ohio,2001,11,5838599,67.2,5535574,63.7,303025,5.2
Oklahoma,2001,11,1683462,64.7,1609645,61.9,73817,4.4
Oregon,2001,11,1819144,67.5,1681041,62.4,138103,7.6
Pennsylvania,2001,11,6186948,64.9,5856987,61.4,329961,5.3
Rhode Island,2001,11,542096,65.9,516810,62.8,25286,4.7
South Carolina,2001,11,1931952,62.8,1814089,58.9,117863,6.1
South Dakota,2001,11,414001,72.8,400303,70.4,13698,3.3
Tennessee,2001,11,2863235,64.8,2712599,61.4,150636,5.3
Texas,2001,11,10603199,67.9,9985772,64.0,617427,5.8
Utah,2001,11,1166683,71.4,1108531,67.8,58152,5.0
Vermont,2001,11,339308,70.6,327472,68.1,11836,3.5
Virginia,2001,11,3697251,68.4,3541607,65.5,155644,4.2
Washington,2001,11,3078060,67.5,2871302,63.0,206758,6.7
West Virginia,2001,11,795728,55.8,749781,52.5,45947,5.8
Wisconsin,2001,11,3015925,72.8,2862532,69.1,153393,5.1
Wyoming,2001,11,268296,71.2,257882,68.5,10414,3.9
Alabama,2001,12,2114191,62.2,1989957,58.6,124234,5.9
Alaska,2001,12,323723,72.4,301961,67.5,21762,6.7
Arizona,2001,12,2638369,65.9,2482908,62.0,155461,5.9
Arkansas,2001,12,1265827,61.9,1198152,58.6,67675,5.3
California,2001,12,17181811,66.9,16071997,62.5,1109814,6.5
Los Angeles County,2001,12,4750929,66.2,4431599,61.7,319330,6.7
Colorado,2001,12,2434221,72.1,2300238,68.1,133983,5.5
Connecticut,2001,12,1752945,66.9,1691304,64.5,61641,3.5
Delaware,2001,12,420130,69.0,403168,66.2,16962,4.0
District of Columbia,2001,12,310508,67.3,288333,62.5,22175,7.1
Florida,2001,12,8009023,62.3,7594519,59.1,414504,5.2
Georgia,2001,12,4291293,68.3,4073637,64.8,217656,5.1
Hawaii,2001,12,606078,66.5,577372,63.4,28706,4.7
Idaho,2001,12,683725,69.9,644867,65.9,38858,5.7
Illinois,2001,12,6418978,68.0,6023568,63.8,395410,6.2
Indiana,2001,12,3158003,68.0,2989096,64.4,168907,5.3
Iowa,2001,12,1613910,71.9,1552463,69.2,61447,3.8
Kansas,2001,12,1402498,69.4,1334524,66.0,67974,4.8
Kentucky,2001,12,1945384,62.4,1830063,58.7,115321,5.9
Louisiana,2001,12,2021105,61.2,1896856,57.4,124249,6.1
Maine,2001,12,673557,66.7,645444,63.9,28113,4.2
Maryland,2001,12,2858910,70.1,2716339,66.6,142571,5.0
Massachusetts,2001,12,3404004,68.2,3242834,65.0,161170,4.7
Michigan,2001,12,5078323,66.8,4762583,62.7,315740,6.2
Minnesota,2001,12,2856276,75.1,2729268,71.8,127008,4.4
Mississippi,2001,12,1289822,61.2,1207000,57.3,82822,6.4
Missouri,2001,12,2979944,69.4,2827722,65.9,152222,5.1
Montana,2001,12,463919,66.6,442104,63.5,21815,4.7
Nebraska,2001,12,945235,73.0,911738,70.4,33497,3.5
Nevada,2001,12,1126262,70.2,1060173,66.0,66089,5.9
New Hampshire,2001,12,691222,71.1,663624,68.2,27598,4.0
New Jersey,2001,12,4324604,66.4,4097618,62.9,226986,5.2
New Mexico,2001,12,857233,63.0,811765,59.6,45468,5.3
New York,2001,12,9202819,62.7,8648361,58.9,554458,6.0
New York city,2001,12,3686870,58.9,3407655,54.4,279215,7.6
North Carolina,2001,12,4207612,67.4,3910662,62.6,296950,7.1
North Dakota,2001,12,340964,70.4,330280,68.2,10684,3.1
Ohio,2001,12,5838840,67.2,5523828,63.6,315012,5.4
Oklahoma,2001,12,1686131,64.8,1610012,61.9,76119,4.5
Oregon,2001,12,1821580,67.5,1679028,62.2,142552,7.8
Pennsylvania,2001,12,6194821,65.0,5856844,61.4,337977,5.5
Rhode Island,2001,12,542752,65.9,517108,62.8,25644,4.7
South Carolina,2001,12,1932574,62.7,1812648,58.8,119926,6.2
South Dakota,2001,12,414329,72.9,400305,70.4,14024,3.4
Tennessee,2001,12,2868147,64.9,2712678,61.4,155469,5.4
Texas,2001,12,10618828,67.9,9983496,63.9,635332,6.0
Utah,2001,12,1167932,71.3,1108131,67.7,59801,5.1
Vermont,2001,12,339657,70.6,327689,68.1,11968,3.5
Virginia,2001,12,3702599,68.4,3542212,65.4,160387,4.3
Washington,2001,12,3078787,67.4,2866396,62.8,212391,6.9
West Virginia,2001,12,796665,55.8,749314,52.5,47351,5.9
Wisconsin,2001,12,3015244,72.7,2856597,68.9,158647,5.3
Wyoming,2001,12,268265,71.2,257803,68.4,10462,3.9
Alabama,2002,1,2111713,62.1,1986380,58.4,125333,5.9
Alaska,2002,1,324206,72.3,302056,67.4,22150,6.8
Arizona,2002,1,2647457,66.0,2487794,62.0,159663,6.0
Arkansas,2002,1,1268139,61.9,1199349,58.6,68790,5.4
California,2002,1,17200139,66.9,16068216,62.5,1131923,6.6
Los Angeles County,2002,1,4751915,66.1,4426669,61.6,325246,6.8
Colorado,2002,1,2440155,72.2,2300818,68.0,139337,5.7
Connecticut,2002,1,1756478,67.0,1692498,64.5,63980,3.6
Delaware,2002,1,419914,68.9,402426,66.0,17488,4.2
District of Columbia,2002,1,310317,67.2,288071,62.4,22246,7.2
Florida,2002,1,8008565,62.2,7593564,59.0,415001,5.2
Georgia,2002,1,4301092,68.3,4077221,64.8,223871,5.2
Hawaii,2002,1,604976,66.4,576624,63.3,28352,4.7
Idaho,2002,1,684000,69.8,644462,65.8,39538,5.8
Illinois,2002,1,6409946,67.9,6005946,63.6,404000,6.3
Indiana,2002,1,3159154,68.0,2987071,64.3,172083,5.4
Iowa,2002,1,1617279,72.1,1554488,69.3,62791,3.9
Kansas,2002,1,1405363,69.5,1335675,66.1,69688,5.0
Kentucky,2002,1,1944328,62.3,1828934,58.6,115394,5.9
Louisiana,2002,1,2017989,61.1,1893384,57.3,124605,6.2
Maine,2002,1,673611,66.6,645223,63.8,28388,4.2
Maryland,2002,1,2864897,70.2,2720786,66.7,144111,5.0
Massachusetts,2002,1,3411826,68.3,3246003,65.0,165823,4.9
Michigan,2002,1,5066583,66.7,4747137,62.5,319446,6.3
Minnesota,2002,1,2859285,75.2,2728922,71.7,130363,4.6
Mississippi,2002,1,1289645,61.2,1205447,57.2,84198,6.5
Missouri,2002,1,2980576,69.4,2825930,65.8,154646,5.2
Montana,2002,1,464367,66.6,442450,63.5,21917,4.7
Nebraska,2002,1,946025,73.0,911808,70.4,34217,3.6
Nevada,2002,1,1127970,70.1,1061341,65.9,66629,5.9
New Hampshire,2002,1,692184,71.1,663796,68.2,28388,4.1
New Jersey,2002,1,4331879,66.5,4096468,62.9,235411,5.4
New Mexico,2002,1,858753,63.0,812611,59.6,46142,5.4
New York,2002,1,9225509,62.8,8655523,58.9,569986,6.2
New York city,2002,1,3697284,59.0,3409364,54.4,287920,7.8
North Carolina,2002,1,4212924,67.4,3909696,62.6,303228,7.2
North Dakota,2002,1,341099,70.4,330124,68.1,10975,3.2
Ohio,2002,1,5837148,67.2,5512148,63.4,325000,5.6
Oklahoma,2002,1,1688351,64.9,1610625,61.9,77726,4.6
Oregon,2002,1,1824184,67.5,1679563,62.1,144621,7.9
Pennsylvania,2002,1,6203483,65.0,5859751,61.4,343732,5.5
Rhode Island,2002,1,543507,65.9,517593,62.8,25914,4.8
South Carolina,2002,1,1934064,62.7,1812600,58.8,121464,6.3
South Dakota,2002,1,414733,72.9,400515,70.4,14218,3.4
Tennessee,2002,1,2873062,64.9,2714853,61.4,158209,5.5
Texas,2002,1,10636473,67.9,9987112,63.8,649361,6.1
Utah,2002,1,1169481,71.3,1108155,67.6,61326,5.2
Vermont,2002,1,340182,70.7,328107,68.2,12075,3.5
Virginia,2002,1,3708958,68.4,3545878,65.4,163080,4.4
Washington,2002,1,3080706,67.4,2864282,62.6,216424,7.0
West Virginia,2002,1,797761,55.9,749002,52.5,48759,6.1
Wisconsin,2002,1,3014685,72.6,2852321,68.7,162364,5.4
Wyoming,2002,1,268360,71.1,257785,68.3,10575,3.9
Alabama,2002,2,2109535,62.1,1983890,58.4,125645,6.0
Alaska,2002,2,324749,72.4,302240,67.3,22509,6.9
Arizona,2002,2,2655925,66.0,2493370,62.0,162555,6.1
Arkansas,2002,2,1270680,62.1,1201300,58.7,69380,5.5
California,2002,2,17215556,66.8,16068377,62.4,1147179,6.7
Los Angeles County,2002,2,4749624,66.1,4420703,61.5,328921,6.9
Colorado,2002,2,2443835,72.2,2302077,68.0,141758,5.8
Connecticut,2002,2,1760683,67.1,1694261,64.6,66422,3.8
Delaware,2002,2,419539,68.8,401598,65.8,17941,4.3
District of Columbia,2002,2,310219,67.2,288009,62.4,22210,7.2
Florida,2002,2,8011118,62.1,7598085,58.9,413033,5.2
Georgia,2002,2,4309744,68.4,4081734,64.7,228010,5.3
Hawaii,2002,2,603721,66.2,576285,63.2,27436,4.5
Idaho,2002,2,684249,69.7,644343,65.7,39906,5.8
Illinois,2002,2,6397958,67.7,5987195,63.4,410763,6.4
Indiana,2002,2,3159571,68.0,2986676,64.3,172895,5.5
Iowa,2002,2,1621675,72.3,1557984,69.4,63691,3.9
Kansas,2002,2,1408286,69.6,1337401,66.1,70885,5.0
Kentucky,2002,2,1943276,62.3,1828696,58.6,114580,5.9
Louisiana,2002,2,2014815,61.0,1890945,57.2,123870,6.1
Maine,2002,2,674227,66.7,645539,63.8,28688,4.3
Maryland,2002,2,2869442,70.2,2725106,66.7,144336,5.0
Massachusetts,2002,2,3420825,68.5,3251186,65.1,169639,5.0
Michigan,2002,2,5056176,66.5,4735820,62.3,320356,6.3
Minnesota,2002,2,2861594,75.2,2729260,71.7,132334,4.6
Mississippi,2002,2,1289529,61.1,1204671,57.1,84858,6.6
Missouri,2002,2,2981362,69.4,2824957,65.8,156405,5.2
Montana,2002,2,464775,66.6,442794,63.5,21981,4.7
Nebraska,2002,2,947085,73.1,912326,70.4,34759,3.7
Nevada,2002,2,1129405,70.0,1062671,65.8,66734,5.9
New Hampshire,2002,2,693518,71.1,664270,68.1,29248,4.2
New Jersey,2002,2,4337771,66.5,4095448,62.8,242323,5.6
New Mexico,2002,2,860419,63.0,813759,59.6,46660,5.4
New York,2002,2,9246806,62.9,8666443,59.0,580363,6.3
New York city,2002,2,3706899,59.1,3412674,54.4,294225,7.9
North Carolina,2002,2,4216210,67.4,3910954,62.5,305256,7.2
North Dakota,2002,2,341333,70.4,330092,68.1,11241,3.3
Ohio,2002,2,5833268,67.1,5500685,63.3,332583,5.7
Oklahoma,2002,2,1689439,64.9,1610980,61.9,78459,4.6
Oregon,2002,2,1826495,67.5,1682135,62.2,144360,7.9
Pennsylvania,2002,2,6211418,65.1,5864420,61.5,346998,5.6
Rhode Island,2002,2,544226,66.0,518237,62.8,25989,4.8
South Carolina,2002,2,1936606,62.8,1814051,58.8,122555,6.3
South Dakota,2002,2,415124,72.9,400888,70.4,14236,3.4
Tennessee,2002,2,2878124,65.0,2719470,61.4,158654,5.5
Texas,2002,2,10655526,68.0,9995460,63.8,660066,6.2
Utah,2002,2,1171223,71.3,1108460,67.5,62763,5.4
Vermont,2002,2,340842,70.8,328669,68.2,12173,3.6
Virginia,2002,2,3715839,68.5,3551649,65.4,164190,4.4
Washington,2002,2,3083538,67.4,2864747,62.6,218791,7.1
West Virginia,2002,2,798834,56.0,748748,52.5,50086,6.3
Wisconsin,2002,2,3014014,72.6,2849862,68.6,164152,5.4
Wyoming,2002,2,268531,71.1,257812,68.3,10719,4.0
Alabama,2002,3,2107910,62.0,1982330,58.3,125580,6.0
Alaska,2002,3,325267,72.4,302442,67.3,22825,7.0
Arizona,2002,3,2663980,66.1,2499239,62.0,164741,6.2
Arkansas,2002,3,1273099,62.1,1203623,58.8,69476,5.5
California,2002,3,17227144,66.8,16069886,62.3,1157258,6.7
Los Angeles County,2002,3,4745309,65.9,4414631,61.3,330678,7.0
Colorado,2002,3,2445306,72.1,2303570,68.0,141736,5.8
Connecticut,2002,3,1765261,67.2,1696249,64.6,69012,3.9
Delaware,2002,3,419073,68.6,400804,65.6,18269,4.4
District of Columbia,2002,3,310130,67.2,288013,62.4,22117,7.1
Florida,2002,3,8016518,62.1,7606306,58.9,410212,5.1
Georgia,2002,3,4317457,68.4,4086971,64.7,230486,5.3
Hawaii,2002,3,602580,66.0,576317,63.1,26263,4.4
Idaho,2002,3,684479,69.7,644545,65.6,39934,5.8
Illinois,2002,3,6383575,67.6,5967568,63.2,416007,6.5
Indiana,2002,3,3159593,68.0,2987734,64.3,171859,5.4
Iowa,2002,3,1626062,72.5,1561775,69.6,64287,4.0
Kansas,2002,3,1411086,69.7,1339444,66.2,71642,5.1
Kentucky,2002,3,1942129,62.2,1828895,58.6,113234,5.8
Louisiana,2002,3,2012432,60.9,1889767,57.2,122665,6.1
Maine,2002,3,675390,66.7,646342,63.8,29048,4.3
Maryland,2002,3,2872651,70.2,2729044,66.7,143607,5.0
Massachusetts,2002,3,3429354,68.6,3256605,65.2,172749,5.0
Michigan,2002,3,5047529,66.4,4727781,62.2,319748,6.3
Minnesota,2002,3,2863548,75.1,2730645,71.7,132903,4.6
Mississippi,2002,3,1289263,61.1,1204384,57.1,84879,6.6
Missouri,2002,3,2981929,69.4,2824193,65.7,157736,5.3
Montana,2002,3,465070,66.6,443095,63.5,21975,4.7
Nebraska,2002,3,948270,73.2,913155,70.4,35115,3.7
Nevada,2002,3,1130577,69.8,1064062,65.7,66515,5.9
New Hampshire,2002,3,695102,71.2,665019,68.1,30083,4.3
New Jersey,2002,3,4341726,66.6,4094231,62.8,247495,5.7
New Mexico,2002,3,862173,63.1,815014,59.6,47159,5.5
New York,2002,3,9265302,63.0,8679350,59.0,585952,6.3
New York city,2002,3,3714604,59.2,3416217,54.5,298387,8.0
North Carolina,2002,3,4217044,67.3,3913489,62.5,303555,7.2
North Dakota,2002,3,341599,70.5,330136,68.1,11463,3.4
Ohio,2002,3,5827892,67.0,5490075,63.1,337817,5.8
Oklahoma,2002,3,1689328,64.8,1610915,61.8,78413,4.6
Oregon,2002,3,1828427,67.5,1686101,62.2,142326,7.8
Pennsylvania,2002,3,6217942,65.2,5869958,61.5,347984,5.6
Rhode Island,2002,3,544960,66.0,519022,62.9,25938,4.8
South Carolina,2002,3,1940022,62.8,1816714,58.8,123308,6.4
South Dakota,2002,3,415466,72.9,401370,70.5,14096,3.4
Tennessee,2002,3,2883280,65.1,2726126,61.5,157154,5.5
Texas,2002,3,10674926,68.0,10006541,63.7,668385,6.3
Utah,2002,3,1173064,71.3,1108928,67.4,64136,5.5
Vermont,2002,3,341559,70.9,329266,68.3,12293,3.6
Virginia,2002,3,3722814,68.5,3558238,65.5,164576,4.4
Washington,2002,3,3087034,67.4,2867218,62.6,219816,7.1
West Virginia,2002,3,799722,56.0,748514,52.4,51208,6.4
Wisconsin,2002,3,3012899,72.5,2848653,68.5,164246,5.5
Wyoming,2002,3,268700,71.1,257864,68.2,10836,4.0
Alabama,2002,4,2107382,62.0,1981979,58.3,125403,6.0
Alaska,2002,4,325811,72.4,302703,67.2,23108,7.1
Arizona,2002,4,2672076,66.1,2505719,62.0,166357,6.2
Arkansas,2002,4,1275392,62.2,1206255,58.9,69137,5.4
California,2002,4,17236951,66.8,16073530,62.3,1163421,6.7
Los Angeles County,2002,4,4740950,65.8,4410070,61.2,330880,7.0
Colorado,2002,4,2445804,72.1,2305382,67.9,140422,5.7
Connecticut,2002,4,1769952,67.4,1698245,64.6,71707,4.1
Delaware,2002,4,418664,68.5,400248,65.5,18416,4.4
District of Columbia,2002,4,310029,67.2,288055,62.4,21974,7.1
Florida,2002,4,8024970,62.0,7617735,58.9,407235,5.1
Georgia,2002,4,4325366,68.4,4093644,64.7,231722,5.4
Hawaii,2002,4,601922,65.9,576688,63.1,25234,4.2
Idaho,2002,4,684753,69.6,645116,65.6,39637,5.8
Illinois,2002,4,6368422,67.4,5949351,62.9,419071,6.6
Indiana,2002,4,3160170,68.0,2990511,64.3,169659,5.4
Iowa,2002,4,1629632,72.6,1564963,69.7,64669,4.0
Kansas,2002,4,1413886,69.8,1341873,66.3,72013,5.1
Kentucky,2002,4,1941430,62.2,1829467,58.6,111963,5.8
Louisiana,2002,4,2011560,60.9,1890066,57.2,121494,6.0
Maine,2002,4,676912,66.8,647467,63.9,29445,4.3
Maryland,2002,4,2875219,70.2,2733014,66.7,142205,4.9
Massachusetts,2002,4,3436229,68.7,3260976,65.2,175253,5.1
Michigan,2002,4,5041205,66.2,4723168,62.1,318037,6.3
Minnesota,2002,4,2866169,75.2,2733848,71.7,132321,4.6
Mississippi,2002,4,1288839,61.1,1204581,57.1,84258,6.5
Missouri,2002,4,2982422,69.3,2823829,65.6,158593,5.3
Montana,2002,4,465289,66.6,443450,63.5,21839,4.7
Nebraska,2002,4,949620,73.2,914323,70.5,35297,3.7
Nevada,2002,4,1131648,69.7,1065636,65.7,66012,5.8
New Hampshire,2002,4,696876,71.3,666082,68.2,30794,4.4
New Jersey,2002,4,4344213,66.6,4093689,62.7,250524,5.8
New Mexico,2002,4,864036,63.2,816381,59.7,47655,5.5
New York,2002,4,9281975,63.1,8695207,59.1,586768,6.3
New York city,2002,4,3720704,59.3,3420589,54.5,300115,8.1
North Carolina,2002,4,4216396,67.3,3916865,62.5,299531,7.1
North Dakota,2002,4,341904,70.6,330284,68.2,11620,3.4
Ohio,2002,4,5823063,66.9,5482432,63.0,340631,5.8
Oklahoma,2002,4,1688588,64.8,1610736,61.8,77852,4.6
Oregon,2002,4,1830284,67.5,1690967,62.4,139317,7.6
Pennsylvania,2002,4,6223297,65.2,5876225,61.6,347072,5.6
Rhode Island,2002,4,545889,66.1,519925,62.9,25964,4.8
South Carolina,2002,4,1944196,62.9,1820487,58.9,123709,6.4
South Dakota,2002,4,415832,73.0,401988,70.5,13844,3.3
Tennessee,2002,4,2888581,65.1,2734191,61.7,154390,5.3
Texas,2002,4,10695524,68.0,10020652,63.7,674872,6.3
Utah,2002,4,1175078,71.3,1109675,67.3,65403,5.6
Vermont,2002,4,342300,71.0,329847,68.4,12453,3.6
Virginia,2002,4,3730064,68.6,3565303,65.6,164761,4.4
Washington,2002,4,3091399,67.4,2871449,62.6,219950,7.1
West Virginia,2002,4,800377,56.1,748401,52.4,51976,6.5
Wisconsin,2002,4,3011789,72.4,2848650,68.5,163139,5.4
Wyoming,2002,4,268859,71.1,257984,68.2,10875,4.0
Alabama,2002,5,2108221,62.0,1982996,58.3,125225,5.9
Alaska,2002,5,326413,72.4,303052,67.2,23361,7.2
Arizona,2002,5,2679893,66.2,2512557,62.0,167336,6.2
Arkansas,2002,5,1277481,62.3,1209000,59.0,68481,5.4
California,2002,5,17246156,66.8,16079713,62.2,1166443,6.8
Los Angeles County,2002,5,4738319,65.7,4408592,61.1,329727,7.0
Colorado,2002,5,2446512,72.0,2307558,67.9,138954,5.7
Connecticut,2002,5,1774362,67.5,1699923,64.7,74439,4.2
Delaware,2002,5,418337,68.4,399979,65.4,18358,4.4
District of Columbia,2002,5,309818,67.1,288036,62.4,21782,7.0
Florida,2002,5,8036185,62.0,7632061,58.9,404124,5.0
Georgia,2002,5,4333843,68.4,4101879,64.8,231964,5.4
Hawaii,2002,5,601851,65.9,577294,63.2,24557,4.1
Idaho,2002,5,685086,69.5,646021,65.5,39065,5.7
Illinois,2002,5,6353351,67.2,5933361,62.7,419990,6.6
Indiana,2002,5,3161568,68.0,2994729,64.4,166839,5.3
Iowa,2002,5,1632129,72.7,1567238,69.8,64891,4.0
Kansas,2002,5,1416809,69.9,1344642,66.4,72167,5.1
Kentucky,2002,5,1941560,62.1,1830478,58.6,111082,5.7
Louisiana,2002,5,2012044,60.8,1891573,57.2,120471,6.0
Maine,2002,5,678458,66.9,648669,64.0,29789,4.4
Maryland,2002,5,2877225,70.2,2737013,66.8,140212,4.9
Massachusetts,2002,5,3441058,68.8,3263768,65.3,177290,5.2
Michigan,2002,5,5037273,66.2,4721769,62.0,315504,6.3
Minnesota,2002,5,2869777,75.2,2738822,71.7,130955,4.6
Mississippi,2002,5,1288593,61.1,1205341,57.1,83252,6.5
Missouri,2002,5,2982808,69.3,2823997,65.6,158811,5.3
Montana,2002,5,465503,66.6,443942,63.5,21561,4.6
Nebraska,2002,5,951090,73.3,915764,70.6,35326,3.7
Nevada,2002,5,1132733,69.6,1067427,65.6,65306,5.8
New Hampshire,2002,5,698748,71.4,667395,68.2,31353,4.5
New Jersey,2002,5,4345866,66.6,4094177,62.7,251689,5.8
New Mexico,2002,5,865839,63.2,817847,59.7,47992,5.5
New York,2002,5,9297067,63.2,8713553,59.2,583514,6.3
New York city,2002,5,3725508,59.3,3425866,54.6,299642,8.0
North Carolina,2002,5,4215058,67.2,3920385,62.5,294673,7.0
North Dakota,2002,5,342200,70.6,330496,68.2,11704,3.4
Ohio,2002,5,5820418,66.9,5479111,63.0,341307,5.9
Oklahoma,2002,5,1687674,64.7,1610573,61.7,77101,4.6
Oregon,2002,5,1832213,67.5,1695980,62.5,136233,7.4
Pennsylvania,2002,5,6227212,65.2,5882425,61.6,344787,5.5
Rhode Island,2002,5,547089,66.2,520855,63.0,26234,4.8
South Carolina,2002,5,1948752,63.0,1825051,59.0,123701,6.3
South Dakota,2002,5,416266,73.0,402732,70.6,13534,3.3
Tennessee,2002,5,2894186,65.2,2743111,61.8,151075,5.2
Texas,2002,5,10717572,68.1,10037909,63.8,679663,6.3
Utah,2002,5,1177223,71.3,1110738,67.3,66485,5.6
Vermont,2002,5,343007,71.1,330354,68.4,12653,3.7
Virginia,2002,5,3737322,68.6,3572609,65.6,164713,4.4
Washington,2002,5,3096484,67.4,2876853,62.6,219631,7.1
West Virginia,2002,5,800723,56.1,748402,52.4,52321,6.5
Wisconsin,2002,5,3011225,72.3,2849894,68.4,161331,5.4
Wyoming,2002,5,269012,71.0,258203,68.2,10809,4.0
Alabama,2002,6,2110206,62.0,1985266,58.3,124940,5.9
Alaska,2002,6,327004,72.4,303460,67.2,23544,7.2
Arizona,2002,6,2686901,66.2,2519224,62.1,167677,6.2
Arkansas,2002,6,1279123,62.3,1211468,59.0,67655,5.3
California,2002,6,17254392,66.7,16088050,62.2,1166342,6.8
Los Angeles County,2002,6,4737902,65.6,4410780,61.1,327122,6.9
Colorado,2002,6,2447907,71.9,2310088,67.9,137819,5.6
Connecticut,2002,6,1778355,67.6,1701245,64.7,77110,4.3
Delaware,2002,6,417966,68.2,399841,65.3,18125,4.3
District of Columbia,2002,6,309390,67.0,287871,62.4,21519,7.0
Florida,2002,6,8048829,62.0,7648435,58.9,400394,5.0
Georgia,2002,6,4342259,68.4,4111004,64.8,231255,5.3
Hawaii,2002,6,602060,65.8,577963,63.2,24097,4.0
Idaho,2002,6,685432,69.4,647086,65.5,38346,5.6
Illinois,2002,6,6339698,67.0,5920394,62.6,419304,6.6
Indiana,2002,6,3163193,68.0,2999422,64.4,163771,5.2
Iowa,2002,6,1633682,72.7,1568717,69.9,64965,4.0
Kansas,2002,6,1419829,70.0,1347595,66.5,72234,5.1
Kentucky,2002,6,1942475,62.1,1832009,58.6,110466,5.7
Louisiana,2002,6,2013274,60.9,1893725,57.2,119549,5.9
Maine,2002,6,679698,67.0,649682,64.0,30016,4.4
Maryland,2002,6,2878361,70.1,2740615,66.8,137746,4.8
Massachusetts,2002,6,3444134,68.8,3265227,65.2,178907,5.2
Michigan,2002,6,5034600,66.1,4722820,62.0,311780,6.2
Minnesota,2002,6,2874032,75.2,2744983,71.8,129049,4.5
Mississippi,2002,6,1288848,61.1,1206658,57.2,82190,6.4
Missouri,2002,6,2982883,69.2,2824655,65.6,158228,5.3
Montana,2002,6,465763,66.6,444586,63.6,21177,4.5
Nebraska,2002,6,952567,73.4,917366,70.7,35201,3.7
Nevada,2002,6,1133856,69.5,1069391,65.5,64465,5.7
New Hampshire,2002,6,700645,71.5,668864,68.3,31781,4.5
New Jersey,2002,6,4347286,66.5,4095562,62.7,251724,5.8
New Mexico,2002,6,867430,63.2,819377,59.7,48053,5.5
New York,2002,6,9309180,63.2,8731635,59.3,577545,6.2
New York city,2002,6,3728352,59.4,3430638,54.6,297714,8.0
North Carolina,2002,6,4213354,67.1,3923522,62.5,289832,6.9
North Dakota,2002,6,342478,70.7,330748,68.3,11730,3.4
Ohio,2002,6,5820023,66.9,5479885,62.9,340138,5.8
Oklahoma,2002,6,1686526,64.6,1610231,61.7,76295,4.5
Oregon,2002,6,1834422,67.5,1700621,62.5,133801,7.3
Pennsylvania,2002,6,6229197,65.2,5887715,61.6,341482,5.5
Rhode Island,2002,6,548638,66.3,521835,63.1,26803,4.9
South Carolina,2002,6,1953306,63.1,1829824,59.1,123482,6.3
South Dakota,2002,6,416770,73.0,403533,70.7,13237,3.2
Tennessee,2002,6,2900132,65.3,2752527,62.0,147605,5.1
Texas,2002,6,10739964,68.1,10057469,63.8,682495,6.4
Utah,2002,6,1179393,71.3,1112082,67.2,67311,5.7
Vermont,2002,6,343619,71.1,330746,68.4,12873,3.7
Virginia,2002,6,3743911,68.7,3579785,65.7,164126,4.4
Washington,2002,6,3101726,67.4,2882720,62.7,219006,7.1
West Virginia,2002,6,800690,56.1,748416,52.4,52274,6.5
Wisconsin,2002,6,3011622,72.3,2852461,68.4,159161,5.3
Wyoming,2002,6,269166,71.0,258506,68.2,10660,4.0
Alabama,2002,7,2112596,62.1,1987969,58.4,124627,5.9
Alaska,2002,7,327506,72.4,303837,67.1,23669,7.2
Arizona,2002,7,2692591,66.2,2524962,62.1,167629,6.2
Arkansas,2002,7,1280081,62.4,1213231,59.1,66850,5.2
California,2002,7,17260607,66.7,16095366,62.2,1165241,6.8
Los Angeles County,2002,7,4739287,65.6,4415545,61.1,323742,6.8
Colorado,2002,7,2449523,71.9,2312334,67.8,137189,5.6
Connecticut,2002,7,1781679,67.7,1701951,64.7,79728,4.5
Delaware,2002,7,417436,68.1,399636,65.2,17800,4.3
District of Columbia,2002,7,308821,66.9,287582,62.3,21239,6.9
Florida,2002,7,8060559,62.0,7664361,58.9,396198,4.9
Georgia,2002,7,4349470,68.4,4119340,64.8,230130,5.3
Hawaii,2002,7,602074,65.8,578420,63.2,23654,3.9
Idaho,2002,7,685732,69.3,647998,65.5,37734,5.5
Illinois,2002,7,6327972,66.8,5910199,62.4,417773,6.6
Indiana,2002,7,3164269,68.0,3003252,64.5,161017,5.1
Iowa,2002,7,1634265,72.8,1569350,69.9,64915,4.0
Kansas,2002,7,1422571,70.1,1350263,66.6,72308,5.1
Kentucky,2002,7,1943823,62.1,1833625,58.6,110198,5.7
Louisiana,2002,7,2014218,60.9,1895402,57.3,118816,5.9
Maine,2002,7,680428,67.0,650251,64.0,30177,4.4
Maryland,2002,7,2878111,70.0,2742834,66.8,135277,4.7
Massachusetts,2002,7,3445684,68.8,3265298,65.2,180386,5.2
Michigan,2002,7,5031493,66.0,4724391,62.0,307102,6.1
Minnesota,2002,7,2877941,75.2,2750961,71.9,126980,4.4
Mississippi,2002,7,1289511,61.1,1208173,57.2,81338,6.3
Missouri,2002,7,2982468,69.2,2825178,65.5,157290,5.3
Montana,2002,7,466129,66.6,445329,63.6,20800,4.5
Nebraska,2002,7,953908,73.4,918901,70.7,35007,3.7
Nevada,2002,7,1134916,69.3,1071236,65.4,63680,5.6
New Hampshire,2002,7,702400,71.6,670254,68.3,32146,4.6
New Jersey,2002,7,4348403,66.5,4096784,62.7,251619,5.8
New Mexico,2002,7,868654,63.2,820771,59.8,47883,5.5
New York,2002,7,9316834,63.2,8745647,59.4,571187,6.1
New York city,2002,7,3728998,59.4,3433393,54.7,295605,7.9
North Carolina,2002,7,4211222,67.0,3925405,62.4,285817,6.8
North Dakota,2002,7,342714,70.7,330995,68.3,11719,3.4
Ohio,2002,7,5820692,66.8,5482728,63.0,337964,5.8
Oklahoma,2002,7,1684995,64.5,1609314,61.6,75681,4.5
Oregon,2002,7,1836586,67.5,1704155,62.6,132431,7.2
Pennsylvania,2002,7,6228505,65.2,5889692,61.6,338813,5.4
Rhode Island,2002,7,550443,66.5,522801,63.1,27642,5.0
South Carolina,2002,7,1957403,63.2,1833814,59.2,123589,6.3
South Dakota,2002,7,417242,73.0,404233,70.8,13009,3.1
Tennessee,2002,7,2905747,65.4,2761269,62.1,144478,5.0
Texas,2002,7,10760392,68.1,10076730,63.8,683662,6.4
Utah,2002,7,1181394,71.3,1113419,67.2,67975,5.8
Vermont,2002,7,344083,71.1,330964,68.4,13119,3.8
Virginia,2002,7,3748794,68.7,3585682,65.7,163112,4.4
Washington,2002,7,3106198,67.5,2887777,62.7,218421,7.0
West Virginia,2002,7,800216,56.0,748192,52.4,52024,6.5
Wisconsin,2002,7,3012919,72.2,2855666,68.5,157253,5.2
Wyoming,2002,7,269315,70.9,258805,68.2,10510,3.9
Alabama,2002,8,2114858,62.1,1990399,58.4,124459,5.9
Alaska,2002,8,327961,72.4,304190,67.1,23771,7.2
Arizona,2002,8,2696958,66.1,2529718,62.0,167240,6.2
Arkansas,2002,8,1280510,62.3,1214201,59.1,66309,5.2
California,2002,8,17265303,66.6,16099903,62.1,1165400,6.7
Los Angeles County,2002,8,4741694,65.6,4421144,61.2,320550,6.8
Colorado,2002,8,2451231,71.8,2314156,67.8,137075,5.6
Connecticut,2002,8,1784019,67.7,1701698,64.6,82321,4.6
Delaware,2002,8,416806,67.9,399339,65.0,17467,4.2
District of Columbia,2002,8,308179,66.7,287151,62.2,21028,6.8
Florida,2002,8,8070560,62.0,7678422,58.9,392138,4.9
Georgia,2002,8,4355484,68.4,4126146,64.8,229338,5.3
Hawaii,2002,8,601792,65.7,578604,63.2,23188,3.9
Idaho,2002,8,686082,69.3,648680,65.5,37402,5.5
Illinois,2002,8,6318598,66.7,5902542,62.3,416056,6.6
Indiana,2002,8,3164621,67.9,3005770,64.5,158851,5.0
Iowa,2002,8,1633924,72.7,1569033,69.8,64891,4.0
Kansas,2002,8,1424813,70.2,1352395,66.6,72418,5.1
Kentucky,2002,8,1945275,62.1,1834920,58.6,110355,5.7
Louisiana,2002,8,2014494,60.8,1896156,57.3,118338,5.9
Maine,2002,8,680726,66.9,650354,63.9,30372,4.5
Maryland,2002,8,2876523,69.9,2743404,66.7,133119,4.6
Massachusetts,2002,8,3446164,68.8,3264164,65.2,182000,5.3
Michigan,2002,8,5027686,65.9,4725022,62.0,302664,6.0
Minnesota,2002,8,2880766,75.2,2755464,72.0,125302,4.3
Mississippi,2002,8,1290526,61.1,1209520,57.2,81006,6.3
Missouri,2002,8,2981884,69.1,2825233,65.5,156651,5.3
Montana,2002,8,466655,66.6,446100,63.6,20555,4.4
Nebraska,2002,8,955197,73.5,920328,70.8,34869,3.7
Nevada,2002,8,1135935,69.2,1072869,65.4,63066,5.6
New Hampshire,2002,8,703906,71.7,671392,68.4,32514,4.6
New Jersey,2002,8,4349635,66.5,4097490,62.6,252145,5.8
New Mexico,2002,8,869625,63.2,821972,59.8,47653,5.5
New York,2002,8,9320911,63.2,8753883,59.4,567028,6.1
New York city,2002,8,3728231,59.3,3433403,54.6,294828,7.9
North Carolina,2002,8,4208708,66.8,3925526,62.3,283182,6.7
North Dakota,2002,8,342929,70.7,331234,68.3,11695,3.4
Ohio,2002,8,5822931,66.8,5486972,63.0,335959,5.8
Oklahoma,2002,8,1683619,64.4,1607957,61.5,75662,4.5
Oregon,2002,8,1838336,67.4,1706157,62.6,132179,7.2
Pennsylvania,2002,8,6224755,65.1,5886632,61.6,338123,5.4
Rhode Island,2002,8,552358,66.6,523718,63.2,28640,5.2
South Carolina,2002,8,1961175,63.2,1836626,59.2,124549,6.4
South Dakota,2002,8,417650,73.1,404766,70.8,12884,3.1
Tennessee,2002,8,2910334,65.4,2768269,62.2,142065,4.9
Texas,2002,8,10778290,68.1,10093709,63.8,684581,6.4
Utah,2002,8,1183190,71.3,1114653,67.1,68537,5.8
Vermont,2002,8,344417,71.2,331009,68.4,13408,3.9
Virginia,2002,8,3752059,68.7,3589982,65.7,162077,4.3
Washington,2002,8,3109557,67.5,2891346,62.7,218211,7.0
West Virginia,2002,8,799397,56.0,747631,52.3,51766,6.5
Wisconsin,2002,8,3015304,72.2,2858986,68.5,156318,5.2
Wyoming,2002,8,269529,70.9,259072,68.2,10457,3.9
Alabama,2002,9,2116974,62.1,1992438,58.5,124536,5.9
Alaska,2002,9,328484,72.4,304566,67.1,23918,7.3
Arizona,2002,9,2700112,66.0,2533571,62.0,166541,6.2
Arkansas,2002,9,1280684,62.3,1214407,59.1,66277,5.2
California,2002,9,17268697,66.5,16099890,62.0,1168807,6.8
Los Angeles County,2002,9,4743787,65.6,4425115,61.2,318672,6.7
Colorado,2002,9,2453132,71.8,2315596,67.8,137536,5.6
Connecticut,2002,9,1785478,67.7,1700557,64.5,84921,4.8
Delaware,2002,9,416098,67.7,398862,64.9,17236,4.1
District of Columbia,2002,9,307590,66.6,286635,62.1,20955,6.8
Florida,2002,9,8078773,61.9,7689746,58.9,389027,4.8
Georgia,2002,9,4360866,68.4,4131553,64.8,229313,5.3
Hawaii,2002,9,601409,65.6,578670,63.1,22739,3.8
Idaho,2002,9,686570,69.2,649216,65.4,37354,5.4
Illinois,2002,9,6311232,66.6,5896080,62.2,415152,6.6
Indiana,2002,9,3164383,67.9,3006927,64.5,157456,5.0
Iowa,2002,9,1632768,72.6,1567716,69.7,65052,4.0
Kansas,2002,9,1426508,70.2,1353983,66.6,72525,5.1
Kentucky,2002,9,1946797,62.1,1835666,58.6,111131,5.7
Louisiana,2002,9,2014574,60.8,1896307,57.2,118267,5.9
Maine,2002,9,680833,66.9,650081,63.8,30752,4.5
Maryland,2002,9,2874021,69.8,2742430,66.6,131591,4.6
Massachusetts,2002,9,3445655,68.7,3261712,65.1,183943,5.3
Michigan,2002,9,5024354,65.8,4723612,61.9,300742,6.0
Minnesota,2002,9,2882351,75.2,2757782,72.0,124569,4.3
Mississippi,2002,9,1291902,61.1,1210628,57.3,81274,6.3
Missouri,2002,9,2981296,69.0,2824655,65.4,156641,5.3
Montana,2002,9,467314,66.6,446788,63.7,20526,4.4
Nebraska,2002,9,956546,73.5,921663,70.9,34883,3.6
Nevada,2002,9,1136979,69.1,1074275,65.3,62704,5.5
New Hampshire,2002,9,705044,71.7,672216,68.4,32828,4.7
New Jersey,2002,9,4351051,66.5,4097334,62.6,253717,5.8
New Mexico,2002,9,870467,63.2,822944,59.8,47523,5.5
New York,2002,9,9323265,63.2,8756201,59.3,567064,6.1
New York city,2002,9,3727239,59.3,3430614,54.6,296625,8.0
North Carolina,2002,9,4205732,66.7,3923440,62.2,282292,6.7
North Dakota,2002,9,343133,70.8,331433,68.4,11700,3.4
Ohio,2002,9,5827378,66.8,5491953,63.0,335425,5.8
Oklahoma,2002,9,1682961,64.4,1606327,61.4,76634,4.6
Oregon,2002,9,1839579,67.4,1706691,62.5,132888,7.2
Pennsylvania,2002,9,6217593,65.0,5877648,61.4,339945,5.5
Rhode Island,2002,9,554301,66.8,524618,63.2,29683,5.4
South Carolina,2002,9,1965167,63.3,1838476,59.2,126691,6.4
South Dakota,2002,9,418040,73.1,405120,70.8,12920,3.1
Tennessee,2002,9,2913326,65.4,2772574,62.2,140752,4.8
Texas,2002,9,10794488,68.1,10106672,63.8,687816,6.4
Utah,2002,9,1184766,71.2,1115744,67.1,69022,5.8
Vermont,2002,9,344668,71.1,330912,68.3,13756,4.0
Virginia,2002,9,3754158,68.6,3592628,65.7,161530,4.3
Washington,2002,9,3112187,67.4,2893420,62.7,218767,7.0
West Virginia,2002,9,798413,55.9,746718,52.2,51695,6.5
Wisconsin,2002,9,3018972,72.2,2862220,68.5,156752,5.2
Wyoming,2002,9,269879,71.0,259292,68.2,10587,3.9
Alabama,2002,10,2118563,62.1,1993897,58.5,124666,5.9
Alaska,2002,10,329033,72.4,304907,67.1,24126,7.3
Arizona,2002,10,2701676,65.9,2536063,61.9,165613,6.1
Arkansas,2002,10,1280542,62.2,1213757,59.0,66785,5.2
California,2002,10,17268118,66.4,16092890,61.9,1175228,6.8
Los Angeles County,2002,10,4744031,65.5,4425519,61.1,318512,6.7
Colorado,2002,10,2454819,71.7,2316185,67.7,138634,5.6
Connecticut,2002,10,1786092,67.7,1698628,64.4,87464,4.9
Delaware,2002,10,415257,67.4,398035,64.6,17222,4.1
District of Columbia,2002,10,307187,66.5,286158,62.0,21029,6.8
Florida,2002,10,8084293,61.8,7697494,58.9,386799,4.8
Georgia,2002,10,4365598,68.4,4135682,64.8,229916,5.3
Hawaii,2002,10,601047,65.5,578693,63.1,22354,3.7
Idaho,2002,10,687096,69.1,649596,65.4,37500,5.5
Illinois,2002,10,6304651,66.5,5888844,62.1,415807,6.6
Indiana,2002,10,3163767,67.8,3006965,64.4,156802,5.0
Iowa,2002,10,1630876,72.5,1565447,69.6,65429,4.0
Kansas,2002,10,1427543,70.2,1354925,66.6,72618,5.1
Kentucky,2002,10,1948234,62.1,1835707,58.5,112527,5.8
Louisiana,2002,10,2014905,60.8,1896063,57.2,118842,5.9
Maine,2002,10,680949,66.8,649562,63.7,31387,4.6
Maryland,2002,10,2870999,69.6,2739807,66.4,131192,4.6
Massachusetts,2002,10,3443173,68.6,3257011,64.9,186162,5.4
Michigan,2002,10,5021939,65.8,4719012,61.8,302927,6.0
Minnesota,2002,10,2882473,75.1,2757696,71.9,124777,4.3
Mississippi,2002,10,1293356,61.2,1211458,57.3,81898,6.3
Missouri,2002,10,2980257,68.9,2823047,65.3,157210,5.3
Montana,2002,10,467923,66.6,447239,63.7,20684,4.4
Nebraska,2002,10,957799,73.6,922727,70.9,35072,3.7
Nevada,2002,10,1137876,68.9,1075294,65.1,62582,5.5
New Hampshire,2002,10,705730,71.7,672737,68.3,32993,4.7
New Jersey,2002,10,4351294,66.4,4095429,62.5,255865,5.9
New Mexico,2002,10,871124,63.2,823547,59.7,47577,5.5
New York,2002,10,9323293,63.1,8752564,59.3,570729,6.1
New York city,2002,10,3725730,59.2,3425147,54.4,300583,8.1
North Carolina,2002,10,4201693,66.6,3918854,62.1,282839,6.7
North Dakota,2002,10,343309,70.8,331563,68.4,11746,3.4
Ohio,2002,10,5833088,66.9,5495762,63.0,337326,5.8
Oklahoma,2002,10,1682784,64.3,1604244,61.3,78540,4.7
Oregon,2002,10,1840350,67.3,1706094,62.4,134256,7.3
Pennsylvania,2002,10,6206961,64.8,5862924,61.2,344037,5.5
Rhode Island,2002,10,556138,67.0,525470,63.3,30668,5.5
South Carolina,2002,10,1969136,63.3,1839593,59.2,129543,6.6
South Dakota,2002,10,418334,73.0,405260,70.8,13074,3.1
Tennessee,2002,10,2914147,65.3,2773397,62.2,140750,4.8
Texas,2002,10,10808640,68.1,10114032,63.7,694608,6.4
Utah,2002,10,1185876,71.2,1116475,67.0,69401,5.9
Vermont,2002,10,344833,71.1,330700,68.2,14133,4.1
Virginia,2002,10,3755197,68.6,3593456,65.6,161741,4.3
Washington,2002,10,3114211,67.4,2894005,62.6,220206,7.1
West Virginia,2002,10,797321,55.8,745416,52.1,51905,6.5
Wisconsin,2002,10,3023489,72.3,2865025,68.5,158464,5.2
Wyoming,2002,10,270285,71.0,259390,68.2,10895,4.0
Alabama,2002,11,2119803,62.1,1995132,58.5,124671,5.9
Alaska,2002,11,329561,72.4,305214,67.1,24347,7.4
Arizona,2002,11,2702200,65.8,2537727,61.8,164473,6.1
Arkansas,2002,11,1280124,62.2,1212489,58.9,67635,5.3
California,2002,11,17264788,66.4,16082472,61.8,1182316,6.8
Los Angeles County,2002,11,4742725,65.4,4423119,61.0,319606,6.7
Colorado,2002,11,2456738,71.7,2316466,67.6,140272,5.7
Connecticut,2002,11,1786347,67.6,1696550,64.2,89797,5.0
Delaware,2002,11,414331,67.2,396891,64.4,17440,4.2
District of Columbia,2002,11,306977,66.5,285763,61.9,21214,6.9
Florida,2002,11,8087760,61.8,7702971,58.8,384789,4.8
Georgia,2002,11,4370581,68.3,4139819,64.7,230762,5.3
Hawaii,2002,11,600874,65.5,578794,63.1,22080,3.7
Idaho,2002,11,687674,69.1,649955,65.3,37719,5.5
Illinois,2002,11,6299115,66.4,5881874,62.0,417241,6.6
Indiana,2002,11,3163560,67.7,3006919,64.4,156641,5.0
Iowa,2002,11,1628403,72.4,1562380,69.4,66023,4.1
Kansas,2002,11,1428217,70.2,1355511,66.6,72706,5.1
Kentucky,2002,11,1949751,62.1,1835512,58.4,114239,5.9
Louisiana,2002,11,2016048,60.8,1895925,57.2,120123,6.0
Maine,2002,11,681308,66.8,649075,63.6,32233,4.7
Maryland,2002,11,2868616,69.5,2736752,66.3,131864,4.6
Massachusetts,2002,11,3438660,68.5,3250328,64.8,188332,5.5
Michigan,2002,11,5020648,65.7,4711670,61.7,308978,6.2
Minnesota,2002,11,2881948,75.1,2756295,71.8,125653,4.4
Mississippi,2002,11,1294795,61.2,1212275,57.3,82520,6.4
Missouri,2002,11,2978936,68.9,2820955,65.2,157981,5.3
Montana,2002,11,468428,66.6,447486,63.6,20942,4.5
Nebraska,2002,11,959078,73.6,923669,70.9,35409,3.7
Nevada,2002,11,1138723,68.8,1076155,65.0,62568,5.5
New Hampshire,2002,11,706117,71.6,673172,68.3,32945,4.7
New Jersey,2002,11,4350014,66.4,4092385,62.4,257629,5.9
New Mexico,2002,11,871788,63.1,823924,59.7,47864,5.5
New York,2002,11,9321908,63.1,8745900,59.2,576008,6.2
New York city,2002,11,3723731,59.2,3418640,54.3,305091,8.2
North Carolina,2002,11,4196729,66.4,3912687,61.9,284042,6.8
North Dakota,2002,11,343503,70.8,331699,68.4,11804,3.4
Ohio,2002,11,5840339,66.9,5498811,63.0,341528,5.8
Oklahoma,2002,11,1682745,64.3,1601941,61.2,80804,4.8
Oregon,2002,11,1840953,67.3,1704920,62.3,136033,7.4
Pennsylvania,2002,11,6194252,64.7,5845199,61.0,349053,5.6
Rhode Island,2002,11,557845,67.1,526423,63.3,31422,5.6
South Carolina,2002,11,1973023,63.4,1840700,59.1,132323,6.7
South Dakota,2002,11,418553,73.0,405298,70.7,13255,3.2
Tennessee,2002,11,2913309,65.3,2771330,62.1,141979,4.9
Texas,2002,11,10822271,68.1,10118547,63.7,703724,6.5
Utah,2002,11,1186629,71.1,1117065,66.9,69564,5.9
Vermont,2002,11,344987,71.1,330485,68.1,14502,4.2
Virginia,2002,11,3756070,68.5,3593538,65.6,162532,4.3
Washington,2002,11,3115768,67.4,2893803,62.6,221965,7.1
West Virginia,2002,11,796306,55.7,743992,52.0,52314,6.6
Wisconsin,2002,11,3028698,72.3,2867607,68.5,161091,5.3
Wyoming,2002,11,270700,71.1,259405,68.1,11295,4.2
Alabama,2002,12,2120743,62.1,1996169,58.5,124574,5.9
Alaska,2002,12,330077,72.4,305512,67.0,24565,7.4
Arizona,2002,12,2702525,65.7,2539424,61.7,163101,6.0
Arkansas,2002,12,1279487,62.1,1210881,58.8,68606,5.4
California,2002,12,17259702,66.3,16072079,61.7,1187623,6.9
Los Angeles County,2002,12,4740471,65.4,4419310,60.9,321161,6.8
Colorado,2002,12,2459550,71.7,2317145,67.6,142405,5.8
Connecticut,2002,12,1786393,67.6,1694632,64.1,91761,5.1
Delaware,2002,12,413430,67.0,395638,64.1,17792,4.3
District of Columbia,2002,12,306942,66.5,285518,61.9,21424,7.0
Florida,2002,12,8089532,61.7,7707195,58.8,382337,4.7
Georgia,2002,12,4376391,68.3,4144964,64.7,231427,5.3
Hawaii,2002,12,600976,65.5,579036,63.1,21940,3.7
Idaho,2002,12,688330,69.0,650391,65.2,37939,5.5
Illinois,2002,12,6293961,66.3,5876027,61.9,417934,6.6
Indiana,2002,12,3163872,67.7,3007178,64.4,156694,5.0
Iowa,2002,12,1625147,72.2,1558284,69.2,66863,4.1
Kansas,2002,12,1428762,70.2,1355925,66.6,72837,5.1
Kentucky,2002,12,1951266,62.1,1835308,58.4,115958,5.9
Louisiana,2002,12,2017967,60.8,1896200,57.1,121767,6.0
Maine,2002,12,681961,66.8,648763,63.5,33198,4.9
Maryland,2002,12,2867840,69.4,2734613,66.2,133227,4.6
Massachusetts,2002,12,3432610,68.4,3242442,64.6,190168,5.5
Michigan,2002,12,5020290,65.7,4702396,61.5,317894,6.3
Minnesota,2002,12,2881762,75.0,2754830,71.7,126932,4.4
Mississippi,2002,12,1295935,61.2,1213122,57.3,82813,6.4
Missouri,2002,12,2977790,68.8,2818837,65.1,158953,5.3
Montana,2002,12,468847,66.6,447631,63.6,21216,4.5
Nebraska,2002,12,960489,73.7,924626,70.9,35863,3.7
Nevada,2002,12,1139620,68.6,1077130,64.9,62490,5.5
New Hampshire,2002,12,706267,71.6,673609,68.3,32658,4.6
New Jersey,2002,12,4347659,66.3,4089383,62.4,258276,5.9
New Mexico,2002,12,872538,63.1,824239,59.6,48299,5.5
New York,2002,12,9318783,63.0,8737938,59.1,580845,6.2
New York city,2002,12,3720991,59.1,3412427,54.2,308564,8.3
North Carolina,2002,12,4191631,66.3,3906217,61.8,285414,6.8
North Dakota,2002,12,343702,70.9,331857,68.4,11845,3.4
Ohio,2002,12,5848913,67.0,5501775,63.0,347138,5.9
Oklahoma,2002,12,1682720,64.2,1599750,61.1,82970,4.9
Oregon,2002,12,1841458,67.2,1703299,62.2,138159,7.5
Pennsylvania,2002,12,6180604,64.5,5827257,60.8,353347,5.7
Rhode Island,2002,12,559341,67.3,527524,63.4,31817,5.7
South Carolina,2002,12,1976735,63.4,1842271,59.1,134464,6.8
South Dakota,2002,12,418758,73.0,405317,70.7,13441,3.2
Tennessee,2002,12,2911657,65.2,2767381,61.9,144276,5.0
Texas,2002,12,10836094,68.1,10123165,63.6,712929,6.6
Utah,2002,12,1187177,71.0,1117801,66.9,69376,5.8
Vermont,2002,12,345139,71.1,330307,68.0,14832,4.3
Virginia,2002,12,3757075,68.5,3593715,65.5,163360,4.3
Washington,2002,12,3116864,67.3,2893327,62.5,223537,7.2
West Virginia,2002,12,795339,55.6,742609,51.9,52730,6.6
Wisconsin,2002,12,3033987,72.4,2869859,68.5,164128,5.4
Wyoming,2002,12,271097,71.1,259410,68.1,11687,4.3
Alabama,2003,1,2121823,62.1,1997102,58.5,124721,5.9
Alaska,2003,1,330628,72.4,305820,67.0,24808,7.5
Arizona,2003,1,2703900,65.6,2542108,61.6,161792,6.0
Arkansas,2003,1,1278953,62.0,1209257,58.6,69696,5.4
California,2003,1,17257209,66.2,16065489,61.6,1191720,6.9
Los Angeles County,2003,1,4738998,65.3,4415953,60.8,323045,6.8
Colorado,2003,1,2463721,71.8,2318615,67.5,145106,5.9
Connecticut,2003,1,1786460,67.6,1693003,64.0,93457,5.2
Delaware,2003,1,412823,66.8,394645,63.8,18178,4.4
District of Columbia,2003,1,307188,66.6,285534,61.9,21654,7.0
Florida,2003,1,8090994,61.6,7711130,58.7,379864,4.7
Georgia,2003,1,4383758,68.3,4151643,64.7,232115,5.3
Hawaii,2003,1,601347,65.5,579331,63.1,22016,3.7
Idaho,2003,1,689165,69.0,650994,65.2,38171,5.5
Illinois,2003,1,6290665,66.2,5872615,61.8,418050,6.6
Indiana,2003,1,3165387,67.7,3008223,64.3,157164,5.0
Iowa,2003,1,1621262,72.0,1553269,69.0,67993,4.2
Kansas,2003,1,1429715,70.2,1356442,66.6,73273,5.1
Kentucky,2003,1,1953079,62.1,1835364,58.4,117715,6.0
Louisiana,2003,1,2020780,60.9,1897054,57.1,123726,6.1
Maine,2003,1,682795,66.8,648641,63.5,34154,5.0
Maryland,2003,1,2869408,69.4,2734262,66.1,135146,4.7
Massachusetts,2003,1,3426342,68.2,3234426,64.4,191916,5.6
Michigan,2003,1,5022005,65.6,4693211,61.4,328794,6.5
Minnesota,2003,1,2883046,75.0,2754332,71.6,128714,4.5
Mississippi,2003,1,1296920,61.3,1214017,57.3,82903,6.4
Missouri,2003,1,2977841,68.8,2817329,65.0,160512,5.4
Montana,2003,1,469189,66.6,447718,63.5,21471,4.6
Nebraska,2003,1,962142,73.8,925697,71.0,36445,3.8
Nevada,2003,1,1140824,68.5,1078469,64.8,62355,5.5
New Hampshire,2003,1,706325,71.5,674118,68.2,32207,4.6
New Jersey,2003,1,4345192,66.2,4087182,62.3,258010,5.9
New Mexico,2003,1,873471,63.1,824651,59.6,48820,5.6
New York,2003,1,9315785,63.0,8730879,59.0,584906,6.3
New York city,2003,1,3717970,59.0,3407428,54.1,310542,8.4
North Carolina,2003,1,4241568,67.0,3954671,62.5,286897,6.8
North Dakota,2003,1,343950,70.9,332079,68.5,11871,3.5
Ohio,2003,1,5859072,67.1,5505111,63.0,353961,6.0
Oklahoma,2003,1,1683263,64.2,1598051,61.0,85212,5.1
Oregon,2003,1,1842347,67.2,1701450,62.1,140897,7.6
Pennsylvania,2003,1,6168386,64.3,5812280,60.6,356106,5.8
Rhode Island,2003,1,560658,67.4,528706,63.5,31952,5.7
South Carolina,2003,1,1980591,63.5,1844461,59.1,136130,6.9
South Dakota,2003,1,419064,73.0,405409,70.6,13655,3.3
Tennessee,2003,1,2910775,65.1,2763203,61.8,147572,5.1
Texas,2003,1,10852761,68.1,10130478,63.6,722283,6.7
Utah,2003,1,1187935,71.0,1118968,66.8,68967,5.8
Vermont,2003,1,345314,71.0,330207,67.9,15107,4.4
Virginia,2003,1,3758558,68.5,3594457,65.5,164101,4.4
Washington,2003,1,3118244,67.3,2893139,62.4,225105,7.2
West Virginia,2003,1,794434,55.5,741370,51.8,53064,6.7
Wisconsin,2003,1,3039340,72.5,2871983,68.5,167357,5.5
Wyoming,2003,1,271487,71.2,259482,68.1,12005,4.4
Alabama,2003,2,2123538,62.2,1998284,58.5,125254,5.9
Alaska,2003,2,331210,72.5,306142,67.0,25068,7.6
Arizona,2003,2,2707087,65.5,2546216,61.6,160871,5.9
Arkansas,2003,2,1278812,62.0,1207914,58.6,70898,5.5
California,2003,2,17260877,66.1,16065354,61.6,1195523,6.9
Los Angeles County,2003,2,4739584,65.2,4414316,60.8,325268,6.9
Colorado,2003,2,2469409,71.9,2321211,67.6,148198,6.0
Connecticut,2003,2,1786818,67.6,1691836,64.0,94982,5.3
Delaware,2003,2,412703,66.7,394190,63.7,18513,4.5
District of Columbia,2003,2,307752,66.7,285839,62.0,21913,7.1
Florida,2003,2,8093533,61.5,7715910,58.7,377623,4.7
Georgia,2003,2,4392942,68.4,4159791,64.8,233151,5.3
Hawaii,2003,2,601953,65.5,579595,63.1,22358,3.7
Idaho,2003,2,690153,69.0,651733,65.2,38420,5.6
Illinois,2003,2,6291417,66.2,5873456,61.8,417961,6.6
Indiana,2003,2,3168763,67.8,3010266,64.4,158497,5.0
Iowa,2003,2,1617184,71.9,1547884,68.8,69300,4.3
Kansas,2003,2,1431658,70.3,1357353,66.6,74305,5.2
Kentucky,2003,2,1955720,62.2,1836063,58.3,119657,6.1
Louisiana,2003,2,2024386,61.0,1898235,57.2,126151,6.2
Maine,2003,2,683619,66.8,648651,63.4,34968,5.1
Maryland,2003,2,2873220,69.4,2735901,66.1,137319,4.8
Massachusetts,2003,2,3421546,68.1,3227814,64.3,193732,5.7
Michigan,2003,2,5026534,65.7,4686189,61.2,340345,6.8
Minnesota,2003,2,2886146,75.0,2755130,71.6,131016,4.5
Mississippi,2003,2,1298228,61.3,1215235,57.4,82993,6.4
Missouri,2003,2,2979689,68.8,2817042,65.0,162647,5.5
Montana,2003,2,469389,66.6,447712,63.5,21677,4.6
Nebraska,2003,2,963983,73.9,926878,71.1,37105,3.8
Nevada,2003,2,1142496,68.5,1080294,64.7,62202,5.4
New Hampshire,2003,2,706553,71.5,674794,68.2,31759,4.5
New Jersey,2003,2,4343809,66.2,4086276,62.3,257533,5.9
New Mexico,2003,2,874696,63.1,825275,59.6,49421,5.7
New York,2003,2,9314431,63.0,8726174,59.0,588257,6.3
New York city,2003,2,3715386,58.9,3404304,54.0,311082,8.4
North Carolina,2003,2,4267936,67.4,3979346,62.8,288590,6.8
North Dakota,2003,2,344287,71.0,332403,68.5,11884,3.5
Ohio,2003,2,5870822,67.2,5509218,63.1,361604,6.2
Oklahoma,2003,2,1684854,64.3,1597145,60.9,87709,5.2
Oregon,2003,2,1843851,67.2,1699566,62.0,144285,7.8
Pennsylvania,2003,2,6159680,64.2,5802424,60.5,357256,5.8
Rhode Island,2003,2,561835,67.5,529842,63.6,31993,5.7
South Carolina,2003,2,1984829,63.6,1847031,59.2,137798,6.9
South Dakota,2003,2,419559,73.1,405668,70.6,13891,3.3
Tennessee,2003,2,2911211,65.1,2759640,61.7,151571,5.2
Texas,2003,2,10873455,68.2,10141790,63.6,731665,6.7
Utah,2003,2,1189174,70.9,1120709,66.9,68465,5.8
Vermont,2003,2,345555,71.1,330229,67.9,15326,4.4
Virginia,2003,2,3760778,68.5,3595995,65.5,164783,4.4
Washington,2003,2,3120445,67.3,2893714,62.4,226731,7.3
West Virginia,2003,2,793737,55.5,740435,51.8,53302,6.7
Wisconsin,2003,2,3044768,72.6,2874343,68.5,170425,5.6
Wyoming,2003,2,271871,71.3,259674,68.1,12197,4.5
Alabama,2003,3,2125759,62.2,1999675,58.6,126084,5.9
Alaska,2003,3,331713,72.5,306393,67.0,25320,7.6
Arizona,2003,3,2711777,65.5,2551211,61.6,160566,5.9
Arkansas,2003,3,1279094,62.0,1206946,58.5,72148,5.6
California,2003,3,17269010,66.1,16069800,61.5,1199210,6.9
Los Angeles County,2003,3,4741813,65.2,4414087,60.7,327726,6.9
Colorado,2003,3,2476117,72.0,2324818,67.6,151299,6.1
Connecticut,2003,3,1787321,67.6,1690969,63.9,96352,5.4
Delaware,2003,3,413055,66.7,394290,63.7,18765,4.5
District of Columbia,2003,3,308418,66.9,286238,62.1,22180,7.2
Florida,2003,3,8096655,61.5,7721190,58.6,375465,4.6
Georgia,2003,3,4402771,68.5,4168351,64.8,234420,5.3
Hawaii,2003,3,602598,65.6,579724,63.1,22874,3.8
Idaho,2003,3,691062,69.0,652351,65.2,38711,5.6
Illinois,2003,3,6296371,66.3,5877884,61.9,418487,6.6
Indiana,2003,3,3173810,67.8,3012924,64.4,160886,5.1
Iowa,2003,3,1613222,71.7,1542602,68.5,70620,4.4
Kansas,2003,3,1434427,70.4,1358496,66.7,75931,5.3
Kentucky,2003,3,1959031,62.2,1837422,58.4,121609,6.2
Louisiana,2003,3,2027988,61.1,1898999,57.2,128989,6.4
Maine,2003,3,684207,66.9,648663,63.4,35544,5.2
Maryland,2003,3,2877933,69.5,2738709,66.1,139224,4.8
Massachusetts,2003,3,3418751,68.1,3223170,64.2,195581,5.7
Michigan,2003,3,5032775,65.8,4681665,61.2,351110,7.0
Minnesota,2003,3,2890205,75.1,2756587,71.6,133618,4.6
Mississippi,2003,3,1300092,61.4,1216916,57.5,83176,6.4
Missouri,2003,3,2982773,68.8,2817521,65.0,165252,5.5
Montana,2003,3,469459,66.5,447617,63.4,21842,4.7
Nebraska,2003,3,965709,74.0,927963,71.1,37746,3.9
Nevada,2003,3,1144406,68.4,1082404,64.7,62002,5.4
New Hampshire,2003,3,707050,71.5,675577,68.3,31473,4.5
New Jersey,2003,3,4343670,66.2,4086303,62.3,257367,5.9
New Mexico,2003,3,876127,63.2,826028,59.6,50099,5.7
New York,2003,3,9312793,62.9,8721904,58.9,590889,6.3
New York city,2003,3,3713282,58.9,3402767,53.9,310515,8.4
North Carolina,2003,3,4282717,67.6,3992020,63.0,290697,6.8
North Dakota,2003,3,344718,71.1,332815,68.6,11903,3.5
Ohio,2003,3,5881930,67.3,5513335,63.1,368595,6.3
Oklahoma,2003,3,1686997,64.3,1596735,60.9,90262,5.4
Oregon,2003,3,1845493,67.2,1697569,61.8,147924,8.0
Pennsylvania,2003,3,6154613,64.2,5797686,60.4,356927,5.8
Rhode Island,2003,3,562696,67.6,530704,63.7,31992,5.7
South Carolina,2003,3,1989137,63.7,1849451,59.2,139686,7.0
South Dakota,2003,3,420182,73.1,406051,70.7,14131,3.4
Tennessee,2003,3,2911978,65.0,2756243,61.6,155735,5.3
Texas,2003,3,10895560,68.2,10155181,63.6,740379,6.8
Utah,2003,3,1190721,70.9,1122826,66.9,67895,5.7
Vermont,2003,3,345800,71.1,330347,67.9,15453,4.5
Virginia,2003,3,3763269,68.5,3598178,65.5,165091,4.4
Washington,2003,3,3123196,67.3,2894938,62.4,228258,7.3
West Virginia,2003,3,793272,55.5,739820,51.7,53452,6.7
Wisconsin,2003,3,3049303,72.6,2876330,68.5,172973,5.7
Wyoming,2003,3,272209,71.3,259961,68.1,12248,4.5
Alabama,2003,4,2127689,62.3,2000568,58.6,127121,6.0
Alaska,2003,4,332007,72.5,306473,66.9,25534,7.7
Arizona,2003,4,2717061,65.5,2556062,61.6,160999,5.9
Arkansas,2003,4,1279520,62.0,1206122,58.4,73398,5.7
California,2003,4,17276048,66.1,16072953,61.5,1203095,7.0
Los Angeles County,2003,4,4744147,65.2,4413713,60.7,330434,7.0
Colorado,2003,4,2482465,72.1,2328555,67.6,153910,6.2
Connecticut,2003,4,1787410,67.5,1689813,63.8,97597,5.5
Delaware,2003,4,413703,66.7,394764,63.7,18939,4.6
District of Columbia,2003,4,308932,67.0,286494,62.2,22438,7.3
Florida,2003,4,8099233,61.4,7725653,58.6,373580,4.6
Georgia,2003,4,4411122,68.5,4175537,64.8,235585,5.3
Hawaii,2003,4,603039,65.6,579580,63.0,23459,3.9
Idaho,2003,4,691574,69.0,652536,65.1,39038,5.6
Illinois,2003,4,6303732,66.3,5882376,61.9,421356,6.7
Indiana,2003,4,3178702,67.9,3014768,64.4,163934,5.2
Iowa,2003,4,1609268,71.5,1537462,68.3,71806,4.5
Kansas,2003,4,1437328,70.5,1359347,66.7,77981,5.4
Kentucky,2003,4,1962327,62.3,1838964,58.4,123363,6.3
Louisiana,2003,4,2030239,61.1,1898379,57.2,131860,6.5
Maine,2003,4,684459,66.8,648585,63.3,35874,5.2
Maryland,2003,4,2881713,69.5,2741220,66.1,140493,4.9
Massachusetts,2003,4,3417530,68.0,3220113,64.1,197417,5.8
Michigan,2003,4,5038479,65.8,4678151,61.1,360328,7.2
Minnesota,2003,4,2893808,75.1,2757485,71.6,136323,4.7
Mississippi,2003,4,1302002,61.5,1218670,57.6,83332,6.4
Missouri,2003,4,2985771,68.9,2817464,65.0,168307,5.6
Montana,2003,4,469443,66.5,447423,63.4,22020,4.7
Nebraska,2003,4,966889,74.1,928577,71.2,38312,4.0
Nevada,2003,4,1146247,68.3,1084395,64.7,61852,5.4
New Hampshire,2003,4,707646,71.4,676210,68.3,31436,4.4
New Jersey,2003,4,4343742,66.2,4085977,62.2,257765,5.9
New Mexico,2003,4,877542,63.2,826643,59.6,50899,5.8
New York,2003,4,9307352,62.9,8713651,58.9,593701,6.4
New York city,2003,4,3710944,58.8,3401028,53.9,309916,8.4
North Carolina,2003,4,4290346,67.6,3997097,63.0,293249,6.8
North Dakota,2003,4,345191,71.2,333238,68.7,11953,3.5
Ohio,2003,4,5888502,67.4,5514713,63.1,373789,6.3
Oklahoma,2003,4,1688823,64.4,1596225,60.9,92598,5.5
Oregon,2003,4,1846465,67.2,1695149,61.7,151316,8.2
Pennsylvania,2003,4,6151610,64.1,5795712,60.4,355898,5.8
Rhode Island,2003,4,563002,67.6,531074,63.7,31928,5.7
South Carolina,2003,4,1992972,63.8,1851119,59.2,141853,7.1
South Dakota,2003,4,420765,73.2,406384,70.7,14381,3.4
Tennessee,2003,4,2911558,65.0,2751937,61.4,159621,5.5
Texas,2003,4,10914382,68.3,10166243,63.6,748139,6.9
Utah,2003,4,1192248,70.9,1124891,66.9,67357,5.6
Vermont,2003,4,345952,71.1,330449,67.9,15503,4.5
Virginia,2003,4,3765173,68.5,3600147,65.5,165026,4.4
Washington,2003,4,3125925,67.3,2896270,62.4,229655,7.3
West Virginia,2003,4,792908,55.4,739378,51.7,53530,6.8
Wisconsin,2003,4,3051560,72.6,2876683,68.5,174877,5.7
Wyoming,2003,4,272451,71.4,260258,68.2,12193,4.5
Alabama,2003,5,2128612,62.3,2000426,58.5,128186,6.0
Alaska,2003,5,332068,72.4,306377,66.8,25691,7.7
Arizona,2003,5,2722263,65.5,2560450,61.6,161813,5.9
Arkansas,2003,5,1279954,62.0,1205338,58.4,74616,5.8
California,2003,5,17277573,66.0,16070128,61.4,1207445,7.0
Los Angeles County,2003,5,4744639,65.2,4411077,60.6,333562,7.0
Colorado,2003,5,2487392,72.2,2331724,67.7,155668,6.3
Connecticut,2003,5,1786680,67.4,1687977,63.7,98703,5.5
Delaware,2003,5,414471,66.7,395441,63.7,19030,4.6
District of Columbia,2003,5,309174,67.1,286508,62.2,22666,7.3
Florida,2003,5,8101013,61.4,7729028,58.5,371985,4.6
Georgia,2003,5,4416278,68.5,4180089,64.8,236189,5.3
Hawaii,2003,5,603185,65.6,579162,62.9,24023,4.0
Idaho,2003,5,691579,68.9,652227,65.0,39352,5.7
Illinois,2003,5,6310771,66.4,5884178,61.9,426593,6.8
Indiana,2003,5,3181578,67.9,3014778,64.4,166800,5.2
Iowa,2003,5,1605585,71.3,1532841,68.1,72744,4.5
Kansas,2003,5,1439617,70.6,1359507,66.7,80110,5.6
Kentucky,2003,5,1965019,62.3,1840231,58.4,124788,6.4
Louisiana,2003,5,2030426,61.1,1896284,57.1,134142,6.6
Maine,2003,5,684413,66.8,648376,63.2,36037,5.3
Maryland,2003,5,2883328,69.5,2742266,66.1,141062,4.9
Massachusetts,2003,5,3417015,68.0,3217898,64.0,199117,5.8
Michigan,2003,5,5041951,65.8,4673980,61.0,367971,7.3
Minnesota,2003,5,2895878,75.1,2756921,71.5,138957,4.8
Mississippi,2003,5,1303461,61.5,1220150,57.6,83311,6.4
Missouri,2003,5,2987377,68.8,2815900,64.9,171477,5.7
Montana,2003,5,469424,66.4,447206,63.3,22218,4.7
Nebraska,2003,5,967308,74.1,928510,71.1,38798,4.0
Nevada,2003,5,1147822,68.3,1086007,64.6,61815,5.4
New Hampshire,2003,5,708115,71.4,676477,68.2,31638,4.5
New Jersey,2003,5,4343145,66.1,4084554,62.2,258591,6.0
New Mexico,2003,5,878786,63.2,826965,59.5,51821,5.9
New York,2003,5,9296497,62.8,8699109,58.7,597388,6.4
New York city,2003,5,3707827,58.7,3397724,53.8,310103,8.4
North Carolina,2003,5,4292857,67.6,3997084,62.9,295773,6.9
North Dakota,2003,5,345689,71.3,333663,68.8,12026,3.5
Ohio,2003,5,5887473,67.3,5511232,63.0,376241,6.4
Oklahoma,2003,5,1689767,64.4,1595331,60.8,94436,5.6
Oregon,2003,5,1846543,67.1,1692712,61.5,153831,8.3
Pennsylvania,2003,5,6149152,64.1,5794052,60.4,355100,5.8
Rhode Island,2003,5,562647,67.5,530878,63.7,31769,5.6
South Carolina,2003,5,1996123,63.8,1851811,59.2,144312,7.2
South Dakota,2003,5,421147,73.2,406517,70.7,14630,3.5
Tennessee,2003,5,2909176,64.9,2746286,61.2,162890,5.6
Texas,2003,5,10925861,68.2,10171387,63.5,754474,6.9
Utah,2003,5,1193559,70.9,1126613,66.9,66946,5.6
Vermont,2003,5,345974,71.0,330456,67.8,15518,4.5
Virginia,2003,5,3766108,68.4,3601264,65.4,164844,4.4
Washington,2003,5,3128353,67.3,2897598,62.3,230755,7.4
West Virginia,2003,5,792489,55.4,738969,51.6,53520,6.8
Wisconsin,2003,5,3050805,72.6,2874680,68.4,176125,5.8
Wyoming,2003,5,272567,71.3,260498,68.2,12069,4.4
Alabama,2003,6,2128804,62.3,1999701,58.5,129103,6.1
Alaska,2003,6,332043,72.3,306239,66.7,25804,7.8
Arizona,2003,6,2727006,65.5,2564885,61.6,162121,5.9
Arkansas,2003,6,1280646,62.0,1204963,58.3,75683,5.9
California,2003,6,17275195,66.0,16063917,61.3,1211278,7.0
Los Angeles County,2003,6,4742709,65.1,4405791,60.5,336918,7.1
Colorado,2003,6,2491025,72.2,2334532,67.7,156493,6.3
Connecticut,2003,6,1785544,67.4,1685978,63.6,99566,5.6
Delaware,2003,6,415324,66.8,396290,63.7,19034,4.6
District of Columbia,2003,6,309276,67.1,286430,62.2,22846,7.4
Florida,2003,6,8104217,61.3,7734089,58.5,370128,4.6
Georgia,2003,6,4418916,68.4,4183266,64.8,235650,5.3
Hawaii,2003,6,603222,65.5,578749,62.9,24473,4.1
Idaho,2003,6,691330,68.8,651775,64.8,39555,5.7
Illinois,2003,6,6316222,66.4,5883562,61.9,432660,6.8
Indiana,2003,6,3181931,67.9,3013693,64.3,168238,5.3
Iowa,2003,6,1602990,71.2,1529681,67.9,73309,4.6
Kansas,2003,6,1441198,70.6,1359313,66.6,81885,5.7
Kentucky,2003,6,1967061,62.3,1841327,58.4,125734,6.4
Louisiana,2003,6,2028933,61.0,1893949,57.0,134984,6.7
Maine,2003,6,684333,66.7,648247,63.2,36086,5.3
Maryland,2003,6,2883042,69.4,2742191,66.0,140851,4.9
Massachusetts,2003,6,3417145,68.0,3216757,64.0,200388,5.9
Michigan,2003,6,5043417,65.8,4669927,60.9,373490,7.4
Minnesota,2003,6,2896560,75.1,2755275,71.4,141285,4.9
Mississippi,2003,6,1304538,61.6,1221716,57.7,82822,6.3
Missouri,2003,6,2987369,68.8,2813329,64.8,174040,5.8
Montana,2003,6,469560,66.4,447142,63.2,22418,4.8
Nebraska,2003,6,967242,74.0,928079,71.0,39163,4.0
Nevada,2003,6,1149241,68.2,1087432,64.5,61809,5.4
New Hampshire,2003,6,708502,71.4,676544,68.1,31958,4.5
New Jersey,2003,6,4342314,66.1,4083150,62.1,259164,6.0
New Mexico,2003,6,879944,63.3,827182,59.5,52762,6.0
New York,2003,6,9283664,62.6,8682191,58.6,601473,6.5
New York city,2003,6,3705063,58.7,3394238,53.7,310825,8.4
North Carolina,2003,6,4292764,67.5,3995247,62.8,297517,6.9
North Dakota,2003,6,346291,71.4,334185,68.9,12106,3.5
Ohio,2003,6,5879773,67.2,5504397,62.9,375376,6.4
Oklahoma,2003,6,1689877,64.4,1594367,60.7,95510,5.7
Oregon,2003,6,1846252,67.0,1691406,61.4,154846,8.4
Pennsylvania,2003,6,6147708,64.0,5793050,60.3,354658,5.8
Rhode Island,2003,6,561802,67.3,530275,63.5,31527,5.6
South Carolina,2003,6,1998903,63.9,1852154,59.2,146749,7.3
South Dakota,2003,6,421372,73.2,406517,70.6,14855,3.5
Tennessee,2003,6,2905614,64.7,2740213,61.0,165401,5.7
Texas,2003,6,10929937,68.2,10172062,63.4,757875,6.9
Utah,2003,6,1194843,70.8,1128161,66.9,66682,5.6
Vermont,2003,6,345951,70.9,330455,67.8,15496,4.5
Virginia,2003,6,3767138,68.4,3602525,65.4,164613,4.4
Washington,2003,6,3131155,67.3,2899925,62.3,231230,7.4
West Virginia,2003,6,792012,55.3,738670,51.6,53342,6.7
Wisconsin,2003,6,3048023,72.4,2871404,68.2,176619,5.8
Wyoming,2003,6,272638,71.3,260714,68.2,11924,4.4
Alabama,2003,7,2128750,62.2,1999284,58.4,129466,6.1
Alaska,2003,7,332097,72.2,306247,66.6,25850,7.8
Arizona,2003,7,2731033,65.4,2569956,61.5,161077,5.9
Arkansas,2003,7,1281653,62.0,1205346,58.3,76307,6.0
California,2003,7,17270209,65.9,16059225,61.2,1210984,7.0
Los Angeles County,2003,7,4737837,65.0,4398584,60.3,339253,7.2
Colorado,2003,7,2493863,72.2,2337595,67.7,156268,6.3
Connecticut,2003,7,1784434,67.3,1684501,63.5,99933,5.6
Delaware,2003,7,416187,66.9,397233,63.8,18954,4.6
District of Columbia,2003,7,309166,67.1,286255,62.2,22911,7.4
Florida,2003,7,8110290,61.2,7743475,58.5,366815,4.5
Georgia,2003,7,4420118,68.3,4186992,64.7,233126,5.3
Hawaii,2003,7,603389,65.5,578677,62.8,24712,4.1
Idaho,2003,7,691170,68.6,651690,64.7,39480,5.7
Illinois,2003,7,6319227,66.4,5881948,61.8,437279,6.9
Indiana,2003,7,3184984,67.9,3012381,64.2,172603,5.4
Iowa,2003,7,1601794,71.1,1528425,67.8,73369,4.6
Kansas,2003,7,1442340,70.6,1359351,66.6,82989,5.8
Kentucky,2003,7,1968616,62.3,1842812,58.3,125804,6.4
Louisiana,2003,7,2026467,60.9,1892790,56.9,133677,6.6
Maine,2003,7,684502,66.6,648501,63.1,36001,5.3
Maryland,2003,7,2881933,69.3,2742022,65.9,139911,4.9
Massachusetts,2003,7,3417448,67.9,3216813,64.0,200635,5.9
Michigan,2003,7,5042857,65.8,4667405,60.9,375452,7.4
Minnesota,2003,7,2896186,75.0,2753315,71.3,142871,4.9
Mississippi,2003,7,1305402,61.6,1223833,57.7,81569,6.2
Missouri,2003,7,2986021,68.7,2810931,64.7,175090,5.9
Montana,2003,7,469905,66.3,447344,63.1,22561,4.8
Nebraska,2003,7,967005,74.0,927760,71.0,39245,4.1
Nevada,2003,7,1150665,68.1,1089097,64.4,61568,5.4
New Hampshire,2003,7,708904,71.3,676713,68.1,32191,4.5
New Jersey,2003,7,4341700,66.0,4083332,62.1,258368,6.0
New Mexico,2003,7,881050,63.3,827585,59.4,53465,6.1
New York,2003,7,9271586,62.5,8667803,58.4,603783,6.5
New York city,2003,7,3703123,58.6,3392326,53.7,310797,8.4
North Carolina,2003,7,4291674,67.4,3994656,62.8,297018,6.9
North Dakota,2003,7,347018,71.5,334863,69.0,12155,3.5
Ohio,2003,7,5868132,67.0,5496831,62.8,371301,6.3
Oklahoma,2003,7,1689067,64.3,1593599,60.7,95468,5.7
Oregon,2003,7,1846103,67.0,1692219,61.4,153884,8.3
Pennsylvania,2003,7,6147794,64.0,5794429,60.3,353365,5.7
Rhode Island,2003,7,560764,67.1,529557,63.4,31207,5.6
South Carolina,2003,7,2001431,63.9,1853069,59.1,148362,7.4
South Dakota,2003,7,421567,73.2,406551,70.6,15016,3.6
Tennessee,2003,7,2901590,64.6,2734779,60.9,166811,5.7
Texas,2003,7,10927994,68.1,10172127,63.3,755867,6.9
Utah,2003,7,1196359,70.8,1129956,66.9,66403,5.6
Vermont,2003,7,346000,70.9,330591,67.7,15409,4.5
Virginia,2003,7,3769197,68.4,3605103,65.4,164094,4.4
Washington,2003,7,3134825,67.3,2904280,62.3,230545,7.4
West Virginia,2003,7,791471,55.3,738606,51.6,52865,6.7
Wisconsin,2003,7,3044763,72.3,2868700,68.1,176063,5.8
Wyoming,2003,7,272733,71.3,260963,68.2,11770,4.3
Alabama,2003,8,2129017,62.2,1999855,58.4,129162,6.1
Alaska,2003,8,332332,72.1,306517,66.5,25815,7.8
Arizona,2003,8,2734633,65.3,2575892,61.5,158741,5.8
Arkansas,2003,8,1282903,62.0,1206566,58.3,76337,6.0
California,2003,8,17265087,65.8,16060723,61.2,1204364,7.0
Los Angeles County,2003,8,4731146,64.8,4391702,60.2,339444,7.2
Colorado,2003,8,2496348,72.2,2341278,67.7,155070,6.2
Connecticut,2003,8,1783860,67.2,1684158,63.5,99702,5.6
Delaware,2003,8,416949,66.9,398144,63.9,18805,4.5
District of Columbia,2003,8,308856,67.0,286020,62.1,22836,7.4
Florida,2003,8,8119870,61.2,7758518,58.4,361352,4.5
Georgia,2003,8,4420604,68.2,4192012,64.7,228592,5.2
Hawaii,2003,8,603776,65.4,579109,62.7,24667,4.1
Idaho,2003,8,691271,68.5,652165,64.6,39106,5.7
Illinois,2003,8,6319651,66.4,5881117,61.8,438534,6.9
Indiana,2003,8,3185326,67.9,3011148,64.2,174178,5.5
Iowa,2003,8,1601957,71.1,1529011,67.8,72946,4.6
Kansas,2003,8,1443351,70.7,1360039,66.6,83312,5.8
Kentucky,2003,8,1969986,62.3,1845195,58.4,124791,6.3
Louisiana,2003,8,2023769,60.8,1893321,56.9,130448,6.4
Maine,2003,8,684986,66.6,649213,63.1,35773,5.2
Maryland,2003,8,2881078,69.2,2742425,65.9,138653,4.8
Massachusetts,2003,8,3417555,67.9,3217956,64.0,199599,5.8
Michigan,2003,8,5040339,65.7,4667414,60.8,372925,7.4
Minnesota,2003,8,2895313,74.9,2751827,71.2,143486,5.0
Mississippi,2003,8,1306240,61.6,1226606,57.8,79634,6.1
Missouri,2003,8,2983820,68.6,2809610,64.6,174210,5.8
Montana,2003,8,470428,66.3,447793,63.1,22635,4.8
Nebraska,2003,8,966945,73.9,927921,70.9,39024,4.0
Nevada,2003,8,1152200,67.9,1091261,64.3,60939,5.3
New Hampshire,2003,8,709392,71.3,677202,68.0,32190,4.5
New Jersey,2003,8,4341525,66.0,4085725,62.1,255800,5.9
New Mexico,2003,8,882066,63.2,828296,59.4,53770,6.1
New York,2003,8,9261573,62.4,8658414,58.3,603159,6.5
New York city,2003,8,3701762,58.5,3392700,53.6,309062,8.3
North Carolina,2003,8,4290714,67.3,3997152,62.7,293562,6.8
North Dakota,2003,8,347858,71.6,335700,69.1,12158,3.5
Ohio,2003,8,5854949,66.9,5489480,62.7,365469,6.2
Oklahoma,2003,8,1687374,64.2,1593130,60.6,94244,5.6
Oregon,2003,8,1846248,66.9,1694882,61.4,151366,8.2
Pennsylvania,2003,8,6149847,64.0,5799235,60.3,350612,5.7
Rhode Island,2003,8,559845,67.0,528989,63.3,30856,5.5
South Carolina,2003,8,2003774,63.9,1855097,59.1,148677,7.4
South Dakota,2003,8,421817,73.1,406729,70.5,15088,3.6
Tennessee,2003,8,2897894,64.4,2731083,60.7,166811,5.8
Texas,2003,8,10922719,67.9,10174868,63.3,747851,6.8
Utah,2003,8,1198297,70.8,1132248,66.9,66049,5.5
Vermont,2003,8,346211,70.9,330950,67.8,15261,4.4
Virginia,2003,8,3772572,68.3,3609338,65.3,163234,4.3
Washington,2003,8,3139210,67.3,2910556,62.4,228654,7.3
West Virginia,2003,8,790895,55.2,738822,51.6,52073,6.6
Wisconsin,2003,8,3042098,72.2,2867777,68.0,174321,5.7
Wyoming,2003,8,272882,71.3,261257,68.2,11625,4.3
Alabama,2003,9,2129622,62.2,2001329,58.4,128293,6.0
Alaska,2003,9,332691,72.0,306977,66.5,25714,7.7
Arizona,2003,9,2738684,65.2,2583001,61.5,155683,5.7
Arkansas,2003,9,1284302,62.0,1208502,58.3,75800,5.9
California,2003,9,17263667,65.7,16072530,61.2,1191137,6.9
Los Angeles County,2003,9,4724959,64.7,4388016,60.1,336943,7.1
Colorado,2003,9,2499159,72.2,2345933,67.8,153226,6.1
Connecticut,2003,9,1784048,67.2,1685164,63.5,98884,5.5
Delaware,2003,9,417632,66.9,399074,63.9,18558,4.4
District of Columbia,2003,9,308559,66.9,285904,62.0,22655,7.3
Florida,2003,9,8133676,61.1,7779744,58.5,353932,4.4
Georgia,2003,9,4421083,68.1,4198374,64.7,222709,5.0
Hawaii,2003,9,604305,65.3,579989,62.7,24316,4.0
Idaho,2003,9,691656,68.4,653166,64.6,38490,5.6
Illinois,2003,9,6318480,66.3,5883328,61.8,435152,6.9
Indiana,2003,9,3183267,67.8,3009839,64.1,173428,5.4
Iowa,2003,9,1603110,71.1,1530971,67.9,72139,4.5
Kansas,2003,9,1444510,70.7,1361564,66.6,82946,5.7
Kentucky,2003,9,1970945,62.3,1848250,58.5,122695,6.2
Louisiana,2003,9,2021343,60.7,1895184,56.9,126159,6.2
Maine,2003,9,685706,66.6,650325,63.2,35381,5.2
Maryland,2003,9,2881086,69.1,2743719,65.8,137367,4.8
Massachusetts,2003,9,3417557,67.9,3220236,64.0,197321,5.8
Michigan,2003,9,5036588,65.6,4670668,60.8,365920,7.3
Minnesota,2003,9,2894312,74.8,2751315,71.1,142997,4.9
Mississippi,2003,9,1307127,61.6,1229625,57.9,77502,5.9
Missouri,2003,9,2981706,68.5,2809905,64.5,171801,5.8
Montana,2003,9,471079,66.3,448428,63.1,22651,4.8
Nebraska,2003,9,967363,73.9,928751,71.0,38612,4.0
Nevada,2003,9,1153973,67.8,1094058,64.3,59915,5.2
New Hampshire,2003,9,709982,71.2,678044,68.0,31938,4.5
New Jersey,2003,9,4341886,66.0,4090296,62.2,251590,5.8
New Mexico,2003,9,882966,63.2,829357,59.4,53609,6.1
New York,2003,9,9254717,62.3,8655456,58.3,599261,6.5
New York city,2003,9,3700676,58.5,3395454,53.7,305222,8.2
North Carolina,2003,9,4290415,67.2,4002858,62.7,287557,6.7
North Dakota,2003,9,348757,71.7,336655,69.3,12102,3.5
Ohio,2003,9,5842700,66.7,5483261,62.6,359439,6.2
Oklahoma,2003,9,1685365,64.1,1593198,60.6,92167,5.5
Oregon,2003,9,1846243,66.9,1698110,61.5,148133,8.0
Pennsylvania,2003,9,6154445,64.0,5807656,60.4,346789,5.6
Rhode Island,2003,9,559136,66.9,528618,63.2,30518,5.5
South Carolina,2003,9,2005973,63.8,1858304,59.1,147669,7.4
South Dakota,2003,9,422173,73.1,407130,70.5,15043,3.6
Tennessee,2003,9,2895997,64.3,2730811,60.7,165186,5.7
Texas,2003,9,10917190,67.8,10182968,63.2,734222,6.7
Utah,2003,9,1200793,70.8,1135187,66.9,65606,5.5
Vermont,2003,9,346597,70.9,331542,67.8,15055,4.3
Virginia,2003,9,3777038,68.3,3615047,65.3,161991,4.3
Washington,2003,9,3143660,67.3,2917929,62.4,225731,7.2
West Virginia,2003,9,790347,55.2,739317,51.6,51030,6.5
Wisconsin,2003,9,3040587,72.1,2869153,68.0,171434,5.6
Wyoming,2003,9,273101,71.3,261603,68.3,11498,4.2
Alabama,2003,10,2130528,62.1,2003261,58.4,127267,6.0
Alaska,2003,10,333167,72.0,307559,66.4,25608,7.7
Arizona,2003,10,2744026,65.2,2591421,61.6,152605,5.6
Arkansas,2003,10,1285880,62.0,1210857,58.4,75023,5.8
California,2003,10,17269193,65.6,16094450,61.2,1174743,6.8
Los Angeles County,2003,10,4721042,64.6,4388531,60.1,332511,7.0
Colorado,2003,10,2502946,72.2,2351616,67.9,151330,6.0
Connecticut,2003,10,1784796,67.2,1687054,63.5,97742,5.5
Delaware,2003,10,418372,66.9,400154,64.0,18218,4.4
District of Columbia,2003,10,308421,66.8,285936,62.0,22485,7.3
Florida,2003,10,8151977,61.1,7805958,58.5,346019,4.2
Georgia,2003,10,4422206,68.0,4205499,64.7,216707,4.9
Hawaii,2003,10,604988,65.3,581186,62.7,23802,3.9
Idaho,2003,10,692353,68.4,654562,64.6,37791,5.5
Illinois,2003,10,6317462,66.3,5889487,61.8,427975,6.8
Indiana,2003,10,3179816,67.7,3008157,64.0,171659,5.4
Iowa,2003,10,1604550,71.1,1533278,68.0,71272,4.4
Kansas,2003,10,1446147,70.7,1363822,66.7,82325,5.7
Kentucky,2003,10,1971376,62.3,1851332,58.5,120044,6.1
Louisiana,2003,10,2019694,60.6,1897863,57.0,121831,6.0
Maine,2003,10,686502,66.7,651594,63.3,34908,5.1
Maryland,2003,10,2882205,69.1,2745964,65.8,136241,4.7
Massachusetts,2003,10,3418074,67.9,3223709,64.0,194365,5.7
Michigan,2003,10,5033675,65.5,4676707,60.9,356968,7.1
Minnesota,2003,10,2894068,74.8,2751990,71.1,142078,4.9
Mississippi,2003,10,1308109,61.6,1232402,58.0,75707,5.8
Missouri,2003,10,2980658,68.4,2811647,64.5,169011,5.7
Montana,2003,10,471769,66.3,449135,63.1,22634,4.8
Nebraska,2003,10,968311,73.9,930113,71.0,38198,3.9
Nevada,2003,10,1156108,67.7,1097432,64.2,58676,5.1
New Hampshire,2003,10,710636,71.2,679123,68.1,31513,4.4
New Jersey,2003,10,4343300,66.0,4096725,62.2,246575,5.7
New Mexico,2003,10,883848,63.2,830729,59.4,53119,6.0
New York,2003,10,9253604,62.3,8659302,58.3,594302,6.4
New York city,2003,10,3701015,58.5,3400704,53.7,300311,8.1
North Carolina,2003,10,4291171,67.2,4010621,62.8,280550,6.5
North Dakota,2003,10,349629,71.9,337607,69.4,12022,3.4
Ohio,2003,10,5834868,66.6,5479949,62.5,354919,6.1
Oklahoma,2003,10,1683879,64.0,1593970,60.6,89909,5.3
Oregon,2003,10,1846070,66.8,1700683,61.5,145387,7.9
Pennsylvania,2003,10,6161444,64.0,5818505,60.5,342939,5.6
Rhode Island,2003,10,558645,66.8,528362,63.2,30283,5.4
South Carolina,2003,10,2008572,63.8,1862378,59.2,146194,7.3
South Dakota,2003,10,422653,73.1,407708,70.5,14945,3.5
Tennessee,2003,10,2897192,64.3,2734732,60.7,162460,5.6
Texas,2003,10,10914620,67.7,10196142,63.2,718478,6.6
Utah,2003,10,1203895,70.8,1138743,67.0,65152,5.4
Vermont,2003,10,347093,70.9,332278,67.9,14815,4.3
Virginia,2003,10,3782228,68.2,3621422,65.3,160806,4.3
Washington,2003,10,3148255,67.2,2925796,62.5,222459,7.1
West Virginia,2003,10,789951,55.1,740009,51.7,49942,6.3
Wisconsin,2003,10,3040588,72.0,2872503,68.0,168085,5.5
Wyoming,2003,10,273397,71.3,261989,68.3,11408,4.2
Alabama,2003,11,2131842,62.1,2005331,58.5,126511,5.9
Alaska,2003,11,333763,71.9,308198,66.4,25565,7.7
Arizona,2003,11,2750731,65.2,2600436,61.6,150295,5.5
Arkansas,2003,11,1287593,62.0,1213244,58.4,74349,5.8
California,2003,11,17281265,65.6,16121723,61.2,1159542,6.7
Los Angeles County,2003,11,4720225,64.6,4392558,60.1,327667,6.9
Colorado,2003,11,2507509,72.3,2357816,68.0,149693,6.0
Connecticut,2003,11,1785439,67.2,1688882,63.5,96557,5.4
Delaware,2003,11,419202,66.9,401340,64.1,17862,4.3
District of Columbia,2003,11,308580,66.8,286110,62.0,22470,7.3
Florida,2003,11,8174013,61.2,7834864,58.6,339149,4.1
Georgia,2003,11,4423796,67.9,4212058,64.7,211738,4.8
Hawaii,2003,11,605792,65.2,582527,62.7,23265,3.8
Idaho,2003,11,693226,68.3,656127,64.7,37099,5.4
Illinois,2003,11,6317719,66.3,5898467,61.9,419252,6.6
Indiana,2003,11,3176445,67.6,3006203,64.0,170242,5.4
Iowa,2003,11,1605690,71.1,1535107,68.0,70583,4.4
Kansas,2003,11,1448307,70.8,1366448,66.8,81859,5.7
Kentucky,2003,11,1971533,62.3,1853982,58.6,117551,6.0
Louisiana,2003,11,2019200,60.6,1900665,57.0,118535,5.9
Maine,2003,11,687101,66.7,652696,63.3,34405,5.0
Maryland,2003,11,2883747,69.0,2748357,65.8,135390,4.7
Massachusetts,2003,11,3419070,67.9,3227750,64.1,191320,5.6
Michigan,2003,11,5032945,65.5,4684308,60.9,348637,6.9
Minnesota,2003,11,2894698,74.7,2753577,71.1,141121,4.9
Mississippi,2003,11,1309185,61.6,1234681,58.1,74504,5.7
Missouri,2003,11,2980796,68.3,2813972,64.5,166824,5.6
Montana,2003,11,472455,66.3,449865,63.2,22590,4.8
Nebraska,2003,11,969517,74.0,931612,71.1,37905,3.9
Nevada,2003,11,1158519,67.6,1101069,64.2,57450,5.0
New Hampshire,2003,11,711282,71.2,680303,68.1,30979,4.4
New Jersey,2003,11,4345766,66.0,4103933,62.3,241833,5.6
New Mexico,2003,11,884742,63.2,832222,59.4,52520,5.9
New York,2003,11,9259003,62.3,8668362,58.3,590641,6.4
New York city,2003,11,3703418,58.5,3407734,53.8,295684,8.0
North Carolina,2003,11,4292416,67.1,4018331,62.8,274085,6.4
North Dakota,2003,11,350382,72.0,338434,69.5,11948,3.4
Ohio,2003,11,5832832,66.5,5479600,62.5,353232,6.1
Oklahoma,2003,11,1683396,64.0,1595323,60.6,88073,5.2
Oregon,2003,11,1845891,66.7,1702166,61.5,143725,7.8
Pennsylvania,2003,11,6169696,64.1,5829763,60.6,339933,5.5
Rhode Island,2003,11,558358,66.8,528080,63.1,30278,5.4
South Carolina,2003,11,2011915,63.9,1866661,59.3,145254,7.2
South Dakota,2003,11,423194,73.1,408340,70.6,14854,3.5
Tennessee,2003,11,2901005,64.3,2741593,60.8,159412,5.5
Texas,2003,11,10916509,67.6,10211768,63.2,704741,6.5
Utah,2003,11,1207415,70.8,1142603,67.0,64812,5.4
Vermont,2003,11,347579,71.0,333022,68.0,14557,4.2
Virginia,2003,11,3787379,68.2,3627313,65.3,160066,4.2
Washington,2003,11,3153213,67.2,2933779,62.6,219434,7.0
West Virginia,2003,11,789732,55.1,740708,51.7,49024,6.2
Wisconsin,2003,11,3041626,72.0,2876787,68.1,164839,5.4
Wyoming,2003,11,273715,71.3,262374,68.3,11341,4.1
Alabama,2003,12,2133454,62.2,2007337,58.5,126117,5.9
Alaska,2003,12,334331,71.9,308764,66.4,25567,7.6
Arizona,2003,12,2757982,65.2,2608899,61.7,149083,5.4
Arkansas,2003,12,1289246,62.1,1215325,58.5,73921,5.7
California,2003,12,17296238,65.6,16148787,61.3,1147451,6.6
Los Angeles County,2003,12,4722306,64.6,4398760,60.2,323546,6.9
Colorado,2003,12,2512316,72.4,2364038,68.1,148278,5.9
Connecticut,2003,12,1785366,67.1,1689903,63.6,95463,5.3
Delaware,2003,12,419970,67.0,402384,64.2,17586,4.2
District of Columbia,2003,12,309063,66.9,286398,62.0,22665,7.3
Florida,2003,12,8198317,61.2,7864381,58.7,333936,4.1
Georgia,2003,12,4425357,67.9,4216858,64.7,208499,4.7
Hawaii,2003,12,606630,65.2,583854,62.7,22776,3.8
Idaho,2003,12,694026,68.3,657598,64.7,36428,5.2
Illinois,2003,12,6320242,66.3,5908710,61.9,411532,6.5
Indiana,2003,12,3173945,67.5,3003831,63.9,170114,5.4
Iowa,2003,12,1606085,71.1,1535920,68.0,70165,4.4
Kansas,2003,12,1450811,70.9,1369067,66.9,81744,5.6
Kentucky,2003,12,1971526,62.3,1855980,58.6,115546,5.9
Louisiana,2003,12,2019717,60.6,1902785,57.1,116932,5.8
Maine,2003,12,687266,66.6,653415,63.4,33851,4.9
Maryland,2003,12,2884706,69.0,2749938,65.8,134768,4.7
Massachusetts,2003,12,3419585,67.9,3231161,64.1,188424,5.5
Michigan,2003,12,5034154,65.5,4691877,61.0,342277,6.8
Minnesota,2003,12,2895470,74.7,2755484,71.1,139986,4.8
Mississippi,2003,12,1310365,61.6,1236306,58.1,74059,5.7
Missouri,2003,12,2981753,68.3,2816016,64.5,165737,5.6
Montana,2003,12,473096,66.4,450588,63.2,22508,4.8
Nebraska,2003,12,970633,74.0,932873,71.2,37760,3.9
Nevada,2003,12,1160955,67.5,1104598,64.2,56357,4.9
New Hampshire,2003,12,711874,71.2,681460,68.1,30414,4.3
New Jersey,2003,12,4348412,66.0,4110622,62.4,237790,5.5
New Mexico,2003,12,885581,63.2,833627,59.5,51954,5.9
New York,2003,12,9267759,62.3,8679731,58.4,588028,6.3
New York city,2003,12,3706556,58.5,3415025,53.9,291531,7.9
North Carolina,2003,12,4292468,67.0,4023662,62.8,268806,6.3
North Dakota,2003,12,350976,72.0,339091,69.6,11885,3.4
Ohio,2003,12,5834737,66.5,5480533,62.5,354204,6.1
Oklahoma,2003,12,1683573,64.0,1596931,60.7,86642,5.1
Oregon,2003,12,1845845,66.7,1702937,61.5,142908,7.7
Pennsylvania,2003,12,6177952,64.2,5840068,60.6,337884,5.5
Rhode Island,2003,12,558181,66.7,527660,63.1,30521,5.5
South Carolina,2003,12,2015724,63.9,1870495,59.3,145229,7.2
South Dakota,2003,12,423707,73.1,408926,70.6,14781,3.5
Tennessee,2003,12,2905059,64.3,2748669,60.9,156390,5.4
Texas,2003,12,10921845,67.5,10227213,63.2,694632,6.4
Utah,2003,12,1210983,70.9,1146380,67.1,64603,5.3
Vermont,2003,12,347928,71.0,333636,68.1,14292,4.1
Virginia,2003,12,3791774,68.2,3631928,65.3,159846,4.2
Washington,2003,12,3158238,67.3,2941507,62.6,216731,6.9
West Virginia,2003,12,789730,55.1,741389,51.7,48341,6.1
Wisconsin,2003,12,3042705,72.0,2880690,68.1,162015,5.3
Wyoming,2003,12,273956,71.3,262705,68.4,11251,4.1
Alabama,2004,1,2135079,62.2,2009233,58.5,125846,5.9
Alaska,2004,1,334741,71.9,309147,66.4,25594,7.6
Arizona,2004,1,2764569,65.2,2615971,61.7,148598,5.4
Arkansas,2004,1,1290641,62.1,1216905,58.5,73736,5.7
California,2004,1,17309407,65.6,16171157,61.3,1138250,6.6
Los Angeles County,2004,1,4725753,64.6,4405105,60.2,320648,6.8
Colorado,2004,1,2516896,72.5,2369974,68.2,146922,5.8
Connecticut,2004,1,1784241,67.1,1689747,63.5,94494,5.3
Delaware,2004,1,420491,67.0,403050,64.2,17441,4.1
District of Columbia,2004,1,309714,67.0,286683,62.0,23031,7.4
Florida,2004,1,8222986,61.3,7892825,58.9,330161,4.0
Georgia,2004,1,4426692,67.8,4219452,64.6,207240,4.7
Hawaii,2004,1,607403,65.1,585087,62.7,22316,3.7
Idaho,2004,1,694609,68.2,658773,64.7,35836,5.2
Illinois,2004,1,6323763,66.3,5918111,62.0,405652,6.4
Indiana,2004,1,3169561,67.4,3000682,63.8,168879,5.3
Iowa,2004,1,1605504,71.1,1535411,68.0,70093,4.4
Kansas,2004,1,1453222,71.0,1371321,67.0,81901,5.6
Kentucky,2004,1,1971320,62.2,1857263,58.6,114057,5.8
Louisiana,2004,1,2020598,60.6,1903715,57.1,116883,5.8
Maine,2004,1,686975,66.6,653703,63.4,33272,4.8
Maryland,2004,1,2884243,68.9,2750195,65.7,134048,4.6
Massachusetts,2004,1,3418790,67.9,3233088,64.2,185702,5.4
Michigan,2004,1,5035899,65.5,4697353,61.1,338546,6.7
Minnesota,2004,1,2895742,74.7,2757083,71.1,138659,4.8
Mississippi,2004,1,1311475,61.6,1237222,58.1,74253,5.7
Missouri,2004,1,2982863,68.3,2817084,64.5,165779,5.6
Montana,2004,1,473764,66.4,451372,63.3,22392,4.7
Nebraska,2004,1,971430,74.1,933710,71.2,37720,3.9
Nevada,2004,1,1163180,67.4,1107754,64.2,55426,4.8
New Hampshire,2004,1,712319,71.1,682435,68.2,29884,4.2
New Jersey,2004,1,4350255,66.0,4116056,62.5,234199,5.4
New Mexico,2004,1,886226,63.1,834760,59.5,51466,5.8
New York,2004,1,9275669,62.3,8690232,58.4,585437,6.3
New York city,2004,1,3709110,58.5,3421307,53.9,287803,7.8
North Carolina,2004,1,4290148,66.9,4024940,62.8,265208,6.2
North Dakota,2004,1,351391,72.1,339557,69.6,11834,3.4
Ohio,2004,1,5837546,66.6,5481118,62.5,356428,6.1
Oklahoma,2004,1,1683822,64.0,1598419,60.7,85403,5.1
Oregon,2004,1,1845768,66.7,1703314,61.5,142454,7.7
Pennsylvania,2004,1,6184757,64.2,5847893,60.7,336864,5.4
Rhode Island,2004,1,557920,66.7,527037,63.0,30883,5.5
South Carolina,2004,1,2019819,64.0,1873761,59.4,146058,7.2
South Dakota,2004,1,424134,73.2,409384,70.6,14750,3.5
Tennessee,2004,1,2907164,64.3,2753587,60.9,153577,5.3
Texas,2004,1,10928063,67.5,10240704,63.2,687359,6.3
Utah,2004,1,1214258,71.0,1149805,67.2,64453,5.3
Vermont,2004,1,348063,71.0,334025,68.2,14038,4.0
Virginia,2004,1,3794851,68.1,3634949,65.3,159902,4.2
Washington,2004,1,3163028,67.3,2948817,62.7,214211,6.8
West Virginia,2004,1,789914,55.1,742050,51.8,47864,6.1
Wisconsin,2004,1,3042711,71.9,2882994,68.1,159717,5.2
Wyoming,2004,1,274065,71.3,262943,68.4,11122,4.1
Alabama,2004,2,2136691,62.2,2011207,58.6,125484,5.9
Alaska,2004,2,335025,71.8,309418,66.3,25607,7.6
Arizona,2004,2,2770136,65.2,2621950,61.7,148186,5.3
Arkansas,2004,2,1291843,62.1,1218111,58.6,73732,5.7
California,2004,2,17319192,65.6,16188165,61.3,1131027,6.5
Los Angeles County,2004,2,4729619,64.6,4410619,60.3,319000,6.7
Colorado,2004,2,2521021,72.5,2375527,68.4,145494,5.8
Connecticut,2004,2,1782166,67.0,1688517,63.5,93649,5.3
Delaware,2004,2,420727,66.9,403296,64.2,17431,4.1
District of Columbia,2004,2,310335,67.1,286818,62.1,23517,7.6
Florida,2004,2,8247628,61.4,7920060,59.0,327568,4.0
Georgia,2004,2,4428141,67.7,4220186,64.5,207955,4.7
Hawaii,2004,2,608045,65.1,586207,62.7,21838,3.6
Idaho,2004,2,695078,68.2,659740,64.7,35338,5.1
Illinois,2004,2,6326743,66.3,5925269,62.1,401474,6.3
Indiana,2004,2,3171522,67.4,2997382,63.7,174140,5.5
Iowa,2004,2,1604405,71.0,1534065,67.9,70340,4.4
Kansas,2004,2,1455058,71.1,1373033,67.1,82025,5.6
Kentucky,2004,2,1971186,62.2,1858197,58.7,112989,5.7
Louisiana,2004,2,2021542,60.6,1903786,57.1,117756,5.8
Maine,2004,2,686333,66.5,653662,63.3,32671,4.8
Maryland,2004,2,2882230,68.8,2749114,65.6,133116,4.6
Massachusetts,2004,2,3416688,67.8,3233494,64.2,183194,5.4
Michigan,2004,2,5037351,65.5,4699682,61.1,337669,6.7
Minnesota,2004,2,2895200,74.6,2758035,71.1,137165,4.7
Mississippi,2004,2,1312472,61.6,1237618,58.1,74854,5.7
Missouri,2004,2,2983993,68.3,2816937,64.5,167056,5.6
Montana,2004,2,474629,66.5,452382,63.3,22247,4.7
Nebraska,2004,2,971902,74.1,934181,71.2,37721,3.9
Nevada,2004,2,1165251,67.3,1110585,64.2,54666,4.7
New Hampshire,2004,2,712598,71.1,683191,68.2,29407,4.1
New Jersey,2004,2,4351073,66.0,4120200,62.5,230873,5.3
New Mexico,2004,2,886622,63.1,835637,59.5,50985,5.8
New York,2004,2,9281530,62.4,8699403,58.4,582127,6.3
New York city,2004,2,3711083,58.5,3426487,54.0,284596,7.7
North Carolina,2004,2,4286058,66.8,4023462,62.7,262596,6.1
North Dakota,2004,2,351736,72.1,339935,69.7,11801,3.4
Ohio,2004,2,5839665,66.6,5481024,62.5,358641,6.1
Oklahoma,2004,2,1684158,64.0,1599873,60.8,84285,5.0
Oregon,2004,2,1845673,66.6,1703875,61.5,141798,7.7
Pennsylvania,2004,2,6189449,64.3,5852887,60.8,336562,5.4
Rhode Island,2004,2,557513,66.6,526300,62.9,31213,5.6
South Carolina,2004,2,2024324,64.1,1876802,59.4,147522,7.3
South Dakota,2004,2,424452,73.2,409666,70.6,14786,3.5
Tennessee,2004,2,2907162,64.3,2756040,61.0,151122,5.2
Texas,2004,2,10934073,67.4,10252267,63.2,681806,6.2
Utah,2004,2,1217238,71.0,1152913,67.3,64325,5.3
Vermont,2004,2,347989,71.0,334196,68.2,13793,4.0
Virginia,2004,2,3796863,68.1,3636925,65.2,159938,4.2
Washington,2004,2,3167586,67.3,2955903,62.8,211683,6.7
West Virginia,2004,2,790085,55.2,742605,51.9,47480,6.0
Wisconsin,2004,2,3041271,71.8,2883526,68.1,157745,5.2
Wyoming,2004,2,274060,71.2,263110,68.4,10950,4.0
Alabama,2004,3,2138605,62.2,2013596,58.6,125009,5.8
Alaska,2004,3,335316,71.7,309738,66.2,25578,7.6
Arizona,2004,3,2775047,65.1,2627781,61.7,147266,5.3
Arkansas,2004,3,1293256,62.1,1219410,58.6,73846,5.7
California,2004,3,17329131,65.6,16204247,61.3,1124884,6.5
Los Angeles County,2004,3,4734045,64.6,4415789,60.3,318256,6.7
Colorado,2004,3,2525009,72.6,2380909,68.5,144100,5.7
Connecticut,2004,3,1779987,66.9,1687010,63.4,92977,5.2
Delaware,2004,3,420756,66.9,403235,64.1,17521,4.2
District of Columbia,2004,3,310891,67.2,286794,62.0,24097,7.8
Florida,2004,3,8273038,61.5,7947207,59.0,325831,3.9
Georgia,2004,3,4431236,67.7,4220519,64.4,210717,4.8
Hawaii,2004,3,608704,65.0,587346,62.7,21358,3.5
Idaho,2004,3,695801,68.1,660870,64.7,34931,5.0
Illinois,2004,3,6329748,66.3,5930867,62.1,398881,6.3
Indiana,2004,3,3167017,67.3,2994955,63.6,172062,5.4
Iowa,2004,3,1603910,71.0,1533044,67.9,70866,4.4
Kansas,2004,3,1456522,71.1,1374489,67.1,82033,5.6
Kentucky,2004,3,1971631,62.2,1859288,58.7,112343,5.7
Louisiana,2004,3,2022748,60.6,1904059,57.1,118689,5.9
Maine,2004,3,685653,66.4,653529,63.3,32124,4.7
Maryland,2004,3,2879702,68.7,2747423,65.5,132279,4.6
Massachusetts,2004,3,3414103,67.8,3233044,64.2,181059,5.3
Michigan,2004,3,5039531,65.5,4699967,61.1,339564,6.7
Minnesota,2004,3,2894398,74.5,2758479,71.0,135919,4.7
Mississippi,2004,3,1313652,61.7,1237802,58.1,75850,5.8
Missouri,2004,3,2985981,68.3,2816387,64.4,169594,5.7
Montana,2004,3,475728,66.5,453632,63.4,22096,4.6
Nebraska,2004,3,972345,74.1,934610,71.2,37735,3.9
Nevada,2004,3,1167541,67.2,1113440,64.1,54101,4.6
New Hampshire,2004,3,712917,71.1,683932,68.2,28985,4.1
New Jersey,2004,3,4351474,66.0,4123614,62.5,227860,5.2
New Mexico,2004,3,886992,63.1,836494,59.5,50498,5.7
New York,2004,3,9304365,62.5,8726537,58.6,577828,6.2
New York city,2004,3,3729646,58.7,3447837,54.3,281809,7.6
North Carolina,2004,3,4282643,66.7,4022544,62.6,260099,6.1
North Dakota,2004,3,352202,72.1,340405,69.7,11797,3.3
Ohio,2004,3,5841740,66.6,5481099,62.5,360641,6.2
Oklahoma,2004,3,1684796,64.0,1601607,60.8,83189,4.9
Oregon,2004,3,1846069,66.6,1705242,61.5,140827,7.6
Pennsylvania,2004,3,6193295,64.3,5856438,60.8,336857,5.4
Rhode Island,2004,3,557108,66.6,525705,62.8,31403,5.6
South Carolina,2004,3,2029650,64.1,1880173,59.4,149477,7.4
South Dakota,2004,3,424746,73.1,409847,70.6,14899,3.5
Tennessee,2004,3,2906276,64.2,2756818,60.9,149458,5.1
Texas,2004,3,10941915,67.4,10264447,63.2,677468,6.2
Utah,2004,3,1220277,71.0,1156051,67.3,64226,5.3
Vermont,2004,3,347863,70.9,334289,68.1,13574,3.9
Virginia,2004,3,3798909,68.0,3638949,65.1,159960,4.2
Washington,2004,3,3172374,67.3,2963181,62.9,209193,6.6
West Virginia,2004,3,790182,55.2,743066,51.9,47116,6.0
Wisconsin,2004,3,3039707,71.8,2883699,68.1,156008,5.1
Wyoming,2004,3,274053,71.2,263295,68.4,10758,3.9
Alabama,2004,4,2140692,62.3,2016465,58.7,124227,5.8
Alaska,2004,4,335671,71.6,310191,66.2,25480,7.6
Arizona,2004,4,2779124,65.0,2633732,61.6,145392,5.2
Arkansas,2004,4,1295055,62.2,1221231,58.6,73824,5.7
California,2004,4,17340053,65.6,16223005,61.3,1117048,6.4
Los Angeles County,2004,4,4738295,64.7,4421001,60.3,317294,6.7
Colorado,2004,4,2529027,72.7,2386328,68.6,142699,5.6
Connecticut,2004,4,1778337,66.8,1686019,63.3,92318,5.2
Delaware,2004,4,420683,66.8,403023,63.9,17660,4.2
District of Columbia,2004,4,311445,67.3,286761,62.0,24684,7.9
Florida,2004,4,8297196,61.5,7973417,59.1,323779,3.9
Georgia,2004,4,4436733,67.6,4221874,64.4,214859,4.8
Hawaii,2004,4,609424,65.0,588582,62.7,20842,3.4
Idaho,2004,4,697000,68.1,662386,64.8,34614,5.0
Illinois,2004,4,6332906,66.3,5936524,62.2,396382,6.3
Indiana,2004,4,3164103,67.2,2993722,63.6,170381,5.4
Iowa,2004,4,1604462,71.0,1532911,67.8,71551,4.5
Kansas,2004,4,1457910,71.2,1376040,67.2,81870,5.6
Kentucky,2004,4,1972417,62.2,1860709,58.7,111708,5.7
Louisiana,2004,4,2024070,60.6,1905177,57.1,118893,5.9
Maine,2004,4,685146,66.3,653463,63.2,31683,4.6
Maryland,2004,4,2877711,68.6,2746027,65.4,131684,4.6
Massachusetts,2004,4,3411106,67.7,3232101,64.1,179005,5.2
Michigan,2004,4,5042439,65.5,4699668,61.1,342771,6.8
Minnesota,2004,4,2893583,74.5,2758465,71.0,135118,4.7
Mississippi,2004,4,1315051,61.7,1237981,58.1,77070,5.9
Missouri,2004,4,2989077,68.3,2816352,64.4,172725,5.8
Montana,2004,4,476879,66.6,454943,63.6,21936,4.6
Nebraska,2004,4,972956,74.1,935234,71.2,37722,3.9
Nevada,2004,4,1170127,67.2,1116534,64.1,53593,4.6
New Hampshire,2004,4,713431,71.0,684882,68.2,28549,4.0
New Jersey,2004,4,4351656,66.0,4126937,62.6,224719,5.2
New Mexico,2004,4,887415,63.0,837413,59.5,50002,5.6
New York,2004,4,9325796,62.6,8754380,58.8,571416,6.1
New York city,2004,4,3745566,58.9,3467013,54.6,278553,7.4
North Carolina,2004,4,4281421,66.6,4024384,62.6,257037,6.0
North Dakota,2004,4,352790,72.2,340977,69.8,11813,3.3
Ohio,2004,4,5843709,66.6,5481800,62.5,361909,6.2
Oklahoma,2004,4,1685600,64.0,1603693,60.9,81907,4.9
Oregon,2004,4,1846876,66.6,1707383,61.5,139493,7.6
Pennsylvania,2004,4,6197231,64.3,5860184,60.8,337047,5.4
Rhode Island,2004,4,556738,66.5,525410,62.8,31328,5.6
South Carolina,2004,4,2035476,64.3,1884021,59.5,151455,7.4
South Dakota,2004,4,425099,73.1,410042,70.5,15057,3.5
Tennessee,2004,4,2904703,64.1,2755839,60.9,148864,5.1
Texas,2004,4,10951500,67.3,10279305,63.2,672195,6.1
Utah,2004,4,1223417,71.1,1159431,67.4,63986,5.2
Vermont,2004,4,347778,70.8,334426,68.1,13352,3.8
Virginia,2004,4,3801263,67.9,3641669,65.1,159594,4.2
Washington,2004,4,3177125,67.3,2970663,62.9,206462,6.5
West Virginia,2004,4,790085,55.2,743450,51.9,46635,5.9
Wisconsin,2004,4,3038689,71.7,2884436,68.0,154253,5.1
Wyoming,2004,4,274101,71.1,263530,68.4,10571,3.9
Alabama,2004,5,2142378,62.3,2019286,58.7,123092,5.7
Alaska,2004,5,336120,71.5,310799,66.1,25321,7.5
Arizona,2004,5,2782662,65.0,2639904,61.6,142758,5.1
Arkansas,2004,5,1297196,62.2,1223700,58.7,73496,5.7
California,2004,5,17351446,65.6,16245756,61.4,1105690,6.4
Los Angeles County,2004,5,4741762,64.7,4426584,60.4,315178,6.6
Colorado,2004,5,2533306,72.7,2391942,68.7,141364,5.6
Connecticut,2004,5,1777246,66.7,1685699,63.3,91547,5.2
Delaware,2004,5,420645,66.6,402806,63.8,17839,4.2
District of Columbia,2004,5,312003,67.4,286787,62.0,25216,8.1
Florida,2004,5,8318017,61.6,7997178,59.2,320839,3.9
Georgia,2004,5,4444641,67.7,4225018,64.3,219623,4.9
Hawaii,2004,5,610172,64.9,589865,62.8,20307,3.3
Idaho,2004,5,698687,68.2,664281,64.8,34406,4.9
Illinois,2004,5,6336758,66.3,5943302,62.2,393456,6.2
Indiana,2004,5,3162596,67.1,2993555,63.6,169041,5.3
Iowa,2004,5,1605634,71.0,1533356,67.8,72278,4.5
Kansas,2004,5,1459262,71.2,1377763,67.2,81499,5.6
Kentucky,2004,5,1972864,62.2,1862183,58.7,110681,5.6
Louisiana,2004,5,2025407,60.7,1907175,57.1,118232,5.8
Maine,2004,5,684872,66.2,653504,63.2,31368,4.6
Maryland,2004,5,2877036,68.5,2745676,65.4,131360,4.6
Massachusetts,2004,5,3407545,67.6,3230748,64.1,176797,5.2
Michigan,2004,5,5045752,65.5,4699968,61.0,345784,6.9
Minnesota,2004,5,2892939,74.4,2758324,70.9,134615,4.7
Mississippi,2004,5,1316291,61.7,1237915,58.0,78376,6.0
Missouri,2004,5,2992854,68.3,2817116,64.3,175738,5.9
Montana,2004,5,477899,66.7,456110,63.6,21789,4.6
Nebraska,2004,5,973713,74.1,936041,71.3,37672,3.9
Nevada,2004,5,1172939,67.1,1119945,64.1,52994,4.5
New Hampshire,2004,5,714159,71.0,686123,68.2,28036,3.9
New Jersey,2004,5,4351294,65.9,4130152,62.6,221142,5.1
New Mexico,2004,5,887934,63.0,838443,59.5,49491,5.6
New York,2004,5,9345424,62.7,8782986,58.9,562438,6.0
New York city,2004,5,3758689,59.1,3484524,54.8,274165,7.3
North Carolina,2004,5,4282195,66.5,4028961,62.6,253234,5.9
North Dakota,2004,5,353419,72.3,341568,69.8,11851,3.4
Ohio,2004,5,5845975,66.6,5483256,62.5,362719,6.2
Oklahoma,2004,5,1686500,64.0,1606078,60.9,80422,4.8
Oregon,2004,5,1847565,66.5,1709650,61.6,137915,7.5
Pennsylvania,2004,5,6201909,64.3,5865330,60.8,336579,5.4
Rhode Island,2004,5,556368,66.4,525455,62.7,30913,5.6
South Carolina,2004,5,2041125,64.4,1888265,59.5,152860,7.5
South Dakota,2004,5,425541,73.1,410309,70.5,15232,3.6
Tennessee,2004,5,2902053,64.0,2752673,60.7,149380,5.1
Texas,2004,5,10962640,67.3,10297656,63.2,664984,6.1
Utah,2004,5,1226615,71.1,1163120,67.4,63495,5.2
Vermont,2004,5,347714,70.8,334625,68.1,13089,3.8
Virginia,2004,5,3804208,67.9,3645645,65.1,158563,4.2
Washington,2004,5,3181517,67.3,2978056,63.0,203461,6.4
West Virginia,2004,5,789807,55.1,743795,51.9,46012,5.8
Wisconsin,2004,5,3038020,71.6,2885519,68.0,152501,5.0
Wyoming,2004,5,274229,71.1,263790,68.4,10439,3.8
Alabama,2004,6,2143069,62.3,2021471,58.7,121598,5.7
Alaska,2004,6,336707,71.5,311581,66.2,25126,7.5
Arizona,2004,6,2786277,64.9,2646350,61.6,139927,5.0
Arkansas,2004,6,1299548,62.3,1226676,58.8,72872,5.6
California,2004,6,17363109,65.5,16272306,61.4,1090803,6.3
Los Angeles County,2004,6,4744610,64.7,4432994,60.4,311616,6.6
Colorado,2004,6,2537859,72.8,2397607,68.8,140252,5.5
Connecticut,2004,6,1776345,66.7,1685705,63.3,90640,5.1
Delaware,2004,6,420730,66.6,402703,63.7,18027,4.3
District of Columbia,2004,6,312595,67.5,286944,62.0,25651,8.2
Florida,2004,6,8336128,61.6,8019091,59.2,317037,3.8
Georgia,2004,6,4454231,67.7,4229741,64.3,224490,5.0
Hawaii,2004,6,611002,64.9,591160,62.8,19842,3.2
Idaho,2004,6,700708,68.3,666437,64.9,34271,4.9
Illinois,2004,6,6341581,66.4,5950845,62.3,390736,6.2
Indiana,2004,6,3161918,67.1,2993593,63.5,168325,5.3
Iowa,2004,6,1606835,71.0,1533841,67.8,72994,4.5
Kansas,2004,6,1460394,71.2,1379416,67.3,80978,5.5
Kentucky,2004,6,1972555,62.2,1863418,58.7,109137,5.5
Louisiana,2004,6,2026903,60.7,1909929,57.2,116974,5.8
Maine,2004,6,684887,66.2,653682,63.1,31205,4.6
Maryland,2004,6,2878179,68.5,2746789,65.3,131390,4.6
Massachusetts,2004,6,3403327,67.5,3228938,64.0,174389,5.1
Michigan,2004,6,5049747,65.5,4701330,61.0,348417,6.9
Minnesota,2004,6,2892661,74.3,2758493,70.9,134168,4.6
Mississippi,2004,6,1316915,61.7,1237209,58.0,79706,6.1
Missouri,2004,6,2996620,68.4,2818440,64.3,178180,5.9
Montana,2004,6,478665,66.7,457011,63.7,21654,4.5
Nebraska,2004,6,974426,74.1,936811,71.3,37615,3.9
Nevada,2004,6,1175947,67.0,1123666,64.1,52281,4.4
New Hampshire,2004,6,714973,71.0,687556,68.3,27417,3.8
New Jersey,2004,6,4350248,65.9,4133100,62.6,217148,5.0
New Mexico,2004,6,888605,62.9,839647,59.5,48958,5.5
New York,2004,6,9362431,62.8,8811495,59.1,550936,5.9
New York city,2004,6,3768686,59.2,3500466,55.0,268220,7.1
North Carolina,2004,6,4283749,66.5,4034661,62.6,249088,5.8
North Dakota,2004,6,353982,72.3,342095,69.9,11887,3.4
Ohio,2004,6,5849182,66.6,5484934,62.5,364248,6.2
Oklahoma,2004,6,1687695,64.0,1608727,61.0,78968,4.7
Oregon,2004,6,1847646,66.5,1711208,61.6,136438,7.4
Pennsylvania,2004,6,6207464,64.4,5871779,60.9,335685,5.4
Rhode Island,2004,6,555925,66.4,525776,62.8,30149,5.4
South Carolina,2004,6,2046064,64.4,1892656,59.6,153408,7.5
South Dakota,2004,6,426016,73.1,410617,70.5,15399,3.6
Tennessee,2004,6,2898638,63.9,2747836,60.6,150802,5.2
Texas,2004,6,10975531,67.3,10318766,63.3,656765,6.0
Utah,2004,6,1229847,71.1,1167114,67.5,62733,5.1
Vermont,2004,6,347631,70.7,334829,68.1,12802,3.7
Virginia,2004,6,3807970,67.8,3650944,65.0,157026,4.1
Washington,2004,6,3185496,67.3,2985114,63.0,200382,6.3
West Virginia,2004,6,789437,55.1,744132,51.9,45305,5.7
Wisconsin,2004,6,3037358,71.5,2886459,68.0,150899,5.0
Wyoming,2004,6,274429,71.1,264047,68.4,10382,3.8
Alabama,2004,7,2142414,62.2,2022549,58.7,119865,5.6
Alaska,2004,7,337419,71.5,312484,66.2,24935,7.4
Arizona,2004,7,2790248,64.8,2652981,61.6,137267,4.9
Arkansas,2004,7,1302202,62.4,1229988,58.9,72214,5.5
California,2004,7,17376345,65.5,16301677,61.5,1074668,6.2
Los Angeles County,2004,7,4747981,64.7,4440781,60.5,307200,6.5
Colorado,2004,7,2542645,72.9,2402909,68.8,139736,5.5
Connecticut,2004,7,1775671,66.6,1685982,63.3,89689,5.1
Delaware,2004,7,420927,66.5,402739,63.6,18188,4.3
District of Columbia,2004,7,313379,67.6,287366,62.0,26013,8.3
Florida,2004,7,8353823,61.6,8040978,59.3,312845,3.7
Georgia,2004,7,4464814,67.7,4235369,64.3,229445,5.1
Hawaii,2004,7,611924,64.8,592411,62.8,19513,3.2
Idaho,2004,7,702889,68.3,668697,65.0,34192,4.9
Illinois,2004,7,6347448,66.4,5958454,62.3,388994,6.1
Indiana,2004,7,3161766,67.1,2993388,63.5,168378,5.3
Iowa,2004,7,1607946,71.0,1534316,67.8,73630,4.6
Kansas,2004,7,1461071,71.2,1380689,67.3,80382,5.5
Kentucky,2004,7,1971264,62.1,1864071,58.7,107193,5.4
Louisiana,2004,7,2028909,60.7,1913454,57.3,115455,5.7
Maine,2004,7,685158,66.1,653951,63.1,31207,4.6
Maryland,2004,7,2880951,68.4,2749214,65.3,131737,4.6
Massachusetts,2004,7,3398885,67.4,3226927,64.0,171958,5.1
Michigan,2004,7,5055411,65.6,4703673,61.0,351738,7.0
Minnesota,2004,7,2893170,74.3,2759581,70.9,133589,4.6
Mississippi,2004,7,1316784,61.7,1235652,57.9,81132,6.2
Missouri,2004,7,2999666,68.4,2819812,64.3,179854,6.0
Montana,2004,7,479201,66.7,457706,63.7,21495,4.5
Nebraska,2004,7,974888,74.1,937285,71.3,37603,3.9
Nevada,2004,7,1179137,67.0,1127564,64.1,51573,4.4
New Hampshire,2004,7,715751,71.0,689011,68.3,26740,3.7
New Jersey,2004,7,4348669,65.9,4135797,62.6,212872,4.9
New Mexico,2004,7,889518,62.9,841032,59.5,48486,5.5
New York,2004,7,9377918,62.8,8839205,59.2,538713,5.7
New York city,2004,7,3776005,59.3,3514876,55.2,261129,6.9
North Carolina,2004,7,4285523,66.4,4039842,62.6,245681,5.7
North Dakota,2004,7,354415,72.3,342488,69.9,11927,3.4
Ohio,2004,7,5853902,66.6,5487103,62.5,366799,6.3
Oklahoma,2004,7,1689415,64.1,1611650,61.1,77765,4.6
Oregon,2004,7,1847125,66.4,1711794,61.6,135331,7.3
Pennsylvania,2004,7,6213955,64.4,5879097,60.9,334858,5.4
Rhode Island,2004,7,555375,66.3,526216,62.8,29159,5.3
South Carolina,2004,7,2050092,64.5,1896676,59.7,153416,7.5
South Dakota,2004,7,426415,73.1,410892,70.5,15523,3.6
Tennessee,2004,7,2895791,63.8,2742822,60.4,152969,5.3
Texas,2004,7,10991436,67.3,10341395,63.3,650041,5.9
Utah,2004,7,1233083,71.2,1171302,67.6,61781,5.0
Vermont,2004,7,347484,70.6,334961,68.1,12523,3.6
Virginia,2004,7,3812653,67.8,3657321,65.1,155332,4.1
Washington,2004,7,3189546,67.3,2991920,63.1,197626,6.2
West Virginia,2004,7,789089,55.1,744432,52.0,44657,5.7
Wisconsin,2004,7,3036243,71.5,2886811,67.9,149432,4.9
Wyoming,2004,7,274680,71.1,264294,68.4,10386,3.8
Alabama,2004,8,2140490,62.1,2022542,58.7,117948,5.5
Alaska,2004,8,338166,71.6,313397,66.3,24769,7.3
Arizona,2004,8,2794295,64.7,2659587,61.6,134708,4.8
Arkansas,2004,8,1305072,62.4,1233356,59.0,71716,5.5
California,2004,8,17389930,65.5,16330923,61.5,1059007,6.1
Los Angeles County,2004,8,4751625,64.7,4449165,60.6,302460,6.4
Colorado,2004,8,2547078,72.9,2407412,68.9,139666,5.5
Connecticut,2004,8,1775120,66.6,1686356,63.2,88764,5.0
Delaware,2004,8,421158,66.4,402827,63.5,18331,4.4
District of Columbia,2004,8,314441,67.8,288139,62.1,26302,8.4
Florida,2004,8,8372814,61.6,8064221,59.3,308593,3.7
Georgia,2004,8,4475645,67.8,4241376,64.2,234269,5.2
Hawaii,2004,8,612844,64.9,593528,62.8,19316,3.2
Idaho,2004,8,705141,68.4,671045,65.1,34096,4.8
Illinois,2004,8,6354195,66.4,5966219,62.4,387976,6.1
Indiana,2004,8,3161814,67.0,2992678,63.4,169136,5.3
Iowa,2004,8,1608630,71.0,1534570,67.8,74060,4.6
Kansas,2004,8,1461198,71.2,1381424,67.3,79774,5.5
Kentucky,2004,8,1969188,62.0,1863931,58.6,105257,5.3
Louisiana,2004,8,2031535,60.8,1917672,57.4,113863,5.6
Maine,2004,8,685539,66.1,654211,63.1,31328,4.6
Maryland,2004,8,2884556,68.5,2752351,65.3,132205,4.6
Massachusetts,2004,8,3394330,67.3,3224738,63.9,169592,5.0
Michigan,2004,8,5061889,65.6,4706244,61.0,355645,7.0
Minnesota,2004,8,2893925,74.2,2761403,70.8,132522,4.6
Mississippi,2004,8,1316021,61.6,1233477,57.7,82544,6.3
Missouri,2004,8,3001647,68.3,2820934,64.2,180713,6.0
Montana,2004,8,479547,66.7,458244,63.7,21303,4.4
Nebraska,2004,8,974901,74.1,937248,71.2,37653,3.9
Nevada,2004,8,1182474,67.0,1131457,64.1,51017,4.3
New Hampshire,2004,8,716474,71.0,690386,68.4,26088,3.6
New Jersey,2004,8,4346522,65.8,4138418,62.6,208104,4.8
New Mexico,2004,8,890739,62.9,842556,59.5,48183,5.4
New York,2004,8,9391690,62.9,8864589,59.4,527101,5.6
New York city,2004,8,3780989,59.4,3527679,55.4,253310,6.7
North Carolina,2004,8,4287154,66.3,4043512,62.6,243642,5.7
North Dakota,2004,8,354658,72.4,342693,69.9,11965,3.4
Ohio,2004,8,5858754,66.7,5489638,62.5,369116,6.3
Oklahoma,2004,8,1691534,64.1,1614626,61.2,76908,4.5
Oregon,2004,8,1845970,66.3,1711747,61.5,134223,7.3
Pennsylvania,2004,8,6220769,64.4,5887051,61.0,333718,5.4
Rhode Island,2004,8,554720,66.2,526599,62.8,28121,5.1
South Carolina,2004,8,2052967,64.5,1899742,59.7,153225,7.5
South Dakota,2004,8,426675,73.1,411088,70.4,15587,3.7
Tennessee,2004,8,2893404,63.6,2737780,60.2,155624,5.4
Texas,2004,8,11010492,67.3,10364409,63.4,646083,5.9
Utah,2004,8,1236257,71.2,1175539,67.7,60718,4.9
Vermont,2004,8,347236,70.5,334965,68.0,12271,3.5
Virginia,2004,8,3817970,67.8,3664274,65.1,153696,4.0
Washington,2004,8,3194261,67.3,2998871,63.2,195390,6.1
West Virginia,2004,8,788801,55.0,744627,52.0,44174,5.6
Wisconsin,2004,8,3034311,71.4,2886205,67.9,148106,4.9
Wyoming,2004,8,274947,71.1,264529,68.4,10418,3.8
Alabama,2004,9,2137912,62.0,2021961,58.6,115951,5.4
Alaska,2004,9,338908,71.6,314260,66.4,24648,7.3
Arizona,2004,9,2797989,64.6,2665712,61.5,132277,4.7
Arkansas,2004,9,1308106,62.5,1236602,59.1,71504,5.5
California,2004,9,17401640,65.5,16356394,61.6,1045246,6.0
Los Angeles County,2004,9,4754558,64.7,4456724,60.7,297834,6.3
Colorado,2004,9,2550329,72.9,2410731,68.9,139598,5.5
Connecticut,2004,9,1774206,66.5,1686219,63.2,87987,5.0
Delaware,2004,9,421318,66.3,402828,63.4,18490,4.4
District of Columbia,2004,9,315608,68.0,289117,62.3,26491,8.4
Florida,2004,9,8393668,61.6,8089209,59.4,304459,3.6
Georgia,2004,9,4485994,67.8,4246915,64.2,239079,5.3
Hawaii,2004,9,613770,64.9,594526,62.9,19244,3.1
Idaho,2004,9,707505,68.5,673611,65.2,33894,4.8
Illinois,2004,9,6361016,66.5,5973680,62.4,387336,6.1
Indiana,2004,9,3162109,67.0,2991472,63.3,170637,5.4
Iowa,2004,9,1608698,71.0,1534430,67.7,74268,4.6
Kansas,2004,9,1460850,71.1,1381552,67.2,79298,5.4
Kentucky,2004,9,1967219,61.8,1863350,58.6,103869,5.3
Louisiana,2004,9,2034732,60.8,1922049,57.5,112683,5.5
Maine,2004,9,685894,66.1,654352,63.1,31542,4.6
Maryland,2004,9,2888178,68.5,2755412,65.3,132766,4.6
Massachusetts,2004,9,3389536,67.1,3222035,63.8,167501,4.9
Michigan,2004,9,5067304,65.7,4707661,61.0,359643,7.1
Minnesota,2004,9,2893676,74.2,2762929,70.8,130747,4.5
Mississippi,2004,9,1315041,61.5,1231164,57.6,83877,6.4
Missouri,2004,9,3002704,68.3,2821759,64.2,180945,6.0
Montana,2004,9,479803,66.6,458684,63.7,21119,4.4
Nebraska,2004,9,974455,74.0,936692,71.1,37763,3.9
Nevada,2004,9,1185922,67.0,1135183,64.1,50739,4.3
New Hampshire,2004,9,717147,71.0,691567,68.5,25580,3.6
New Jersey,2004,9,4344140,65.7,4141063,62.7,203077,4.7
New Mexico,2004,9,892264,62.9,844107,59.5,48157,5.4
New York,2004,9,9401360,62.9,8884406,59.5,516954,5.5
New York city,2004,9,3783200,59.3,3537858,55.5,245342,6.5
North Carolina,2004,9,4288791,66.3,4045635,62.5,243156,5.7
North Dakota,2004,9,354714,72.3,342724,69.9,11990,3.4
Ohio,2004,9,5861798,66.7,5491127,62.5,370671,6.3
Oklahoma,2004,9,1693664,64.1,1617221,61.2,76443,4.5
Oregon,2004,9,1844455,66.1,1711773,61.4,132682,7.2
Pennsylvania,2004,9,6226813,64.5,5895143,61.0,331670,5.3
Rhode Island,2004,9,554079,66.1,526847,62.9,27232,4.9
South Carolina,2004,9,2054662,64.4,1901467,59.6,153195,7.5
South Dakota,2004,9,426814,73.0,411197,70.4,15617,3.7
Tennessee,2004,9,2890258,63.5,2731743,60.0,158515,5.5
Texas,2004,9,11031545,67.3,10386154,63.4,645391,5.9
Utah,2004,9,1239371,71.2,1179706,67.8,59665,4.8
Vermont,2004,9,346887,70.4,334809,68.0,12078,3.5
Virginia,2004,9,3823527,67.8,3671229,65.1,152298,4.0
Washington,2004,9,3199823,67.3,3006002,63.2,193821,6.1
West Virginia,2004,9,788583,55.0,744676,52.0,43907,5.6
Wisconsin,2004,9,3031344,71.2,2884270,67.8,147074,4.9
Wyoming,2004,9,275180,71.1,264746,68.4,10434,3.8
Alabama,2004,10,2135435,61.8,2021520,58.5,113915,5.3
Alaska,2004,10,339619,71.6,315045,66.5,24574,7.2
Arizona,2004,10,2801087,64.4,2670776,61.4,130311,4.7
Arkansas,2004,10,1311214,62.6,1239659,59.2,71555,5.5
California,2004,10,17410849,65.5,16376888,61.6,1033961,5.9
Los Angeles County,2004,10,4756311,64.7,4462799,60.7,293512,6.2
Colorado,2004,10,2552184,72.8,2412847,68.8,139337,5.5
Connecticut,2004,10,1773072,66.4,1685602,63.2,87470,4.9
Delaware,2004,10,421353,66.2,402703,63.3,18650,4.4
District of Columbia,2004,10,316694,68.2,290153,62.5,26541,8.4
Florida,2004,10,8416258,61.6,8115866,59.4,300392,3.6
Georgia,2004,10,4495936,67.8,4251657,64.1,244279,5.4
Hawaii,2004,10,614700,65.0,595481,63.0,19219,3.1
Idaho,2004,10,709974,68.5,676484,65.3,33490,4.7
Illinois,2004,10,6366944,66.5,5980251,62.5,386693,6.1
Indiana,2004,10,3162880,66.9,2990119,63.3,172761,5.5
Iowa,2004,10,1608704,71.0,1534379,67.7,74325,4.6
Kansas,2004,10,1460286,71.0,1381290,67.2,78996,5.4
Kentucky,2004,10,1966154,61.8,1862742,58.5,103412,5.3
Louisiana,2004,10,2037986,60.9,1925636,57.5,112350,5.5
Maine,2004,10,686180,66.1,654358,63.0,31822,4.6
Maryland,2004,10,2891348,68.5,2757770,65.3,133578,4.6
Massachusetts,2004,10,3384634,67.0,3218714,63.7,165920,4.9
Michigan,2004,10,5070143,65.7,4707409,61.0,362734,7.2
Minnesota,2004,10,2891183,74.1,2762767,70.8,128416,4.4
Mississippi,2004,10,1314472,61.4,1229171,57.4,85301,6.5
Missouri,2004,10,3003305,68.2,2822567,64.1,180738,6.0
Montana,2004,10,480123,66.6,459133,63.7,20990,4.4
Nebraska,2004,10,973912,73.9,935937,71.0,37975,3.9
Nevada,2004,10,1189438,67.0,1138683,64.1,50755,4.3
New Hampshire,2004,10,717775,71.0,692436,68.5,25339,3.5
New Jersey,2004,10,4342064,65.7,4143380,62.7,198684,4.6
New Mexico,2004,10,893977,63.0,845498,59.5,48479,5.4
New York,2004,10,9404648,62.9,8896900,59.5,507748,5.4
New York city,2004,10,3782453,59.3,3544734,55.6,237719,6.3
North Carolina,2004,10,4291165,66.2,4047089,62.4,244076,5.7
North Dakota,2004,10,354665,72.3,342653,69.9,12012,3.4
Ohio,2004,10,5861874,66.6,5490021,62.4,371853,6.3
Oklahoma,2004,10,1695658,64.2,1619246,61.3,76412,4.5
Oregon,2004,10,1842831,66.0,1712380,61.3,130451,7.1
Pennsylvania,2004,10,6231696,64.5,5902258,61.1,329438,5.3
Rhode Island,2004,10,553691,66.1,527023,62.9,26668,4.8
South Carolina,2004,10,2055359,64.4,1901855,59.5,153504,7.5
South Dakota,2004,10,426933,73.0,411273,70.3,15660,3.7
Tennessee,2004,10,2885829,63.3,2724645,59.8,161184,5.6
Texas,2004,10,11052652,67.4,10405657,63.4,646995,5.9
Utah,2004,10,1242536,71.2,1183774,67.9,58762,4.7
Vermont,2004,10,346518,70.3,334548,67.9,11970,3.5
Virginia,2004,10,3829026,67.8,3677759,65.1,151267,4.0
Washington,2004,10,3205718,67.3,3012926,63.3,192792,6.0
West Virginia,2004,10,788520,55.0,744620,51.9,43900,5.6
Wisconsin,2004,10,3027357,71.1,2881043,67.6,146314,4.8
Wyoming,2004,10,275357,71.1,264960,68.4,10397,3.8
Alabama,2004,11,2133332,61.7,2021719,58.5,111613,5.2
Alaska,2004,11,340258,71.7,315753,66.5,24505,7.2
Arizona,2004,11,2804115,64.3,2675079,61.3,129036,4.6
Arkansas,2004,11,1314212,62.7,1242580,59.3,71632,5.5
California,2004,11,17417930,65.5,16394216,61.6,1023714,5.9
Los Angeles County,2004,11,4757226,64.7,4468070,60.8,289156,6.1
Colorado,2004,11,2553001,72.7,2414109,68.8,138892,5.4
Connecticut,2004,11,1772446,66.4,1685246,63.1,87200,4.9
Delaware,2004,11,421408,66.1,402655,63.2,18753,4.5
District of Columbia,2004,11,317617,68.4,291217,62.7,26400,8.3
Florida,2004,11,8440010,61.7,8143940,59.5,296070,3.5
Georgia,2004,11,4505826,67.8,4256148,64.0,249678,5.5
Hawaii,2004,11,615625,65.0,596478,63.0,19147,3.1
Idaho,2004,11,712525,68.6,679697,65.5,32828,4.6
Illinois,2004,11,6371477,66.5,5986076,62.5,385401,6.0
Indiana,2004,11,3164300,66.9,2989333,63.2,174967,5.5
Iowa,2004,11,1609289,71.0,1535112,67.7,74177,4.6
Kansas,2004,11,1459668,70.9,1380894,67.1,78774,5.4
Kentucky,2004,11,1966299,61.7,1862347,58.4,103952,5.3
Louisiana,2004,11,2040782,61.0,1928071,57.6,112711,5.5
Maine,2004,11,686474,66.1,654333,63.0,32141,4.7
Maryland,2004,11,2893990,68.5,2759355,65.3,134635,4.7
Massachusetts,2004,11,3380049,66.9,3215202,63.7,164847,4.9
Michigan,2004,11,5070334,65.7,4706109,61.0,364225,7.2
Minnesota,2004,11,2886465,73.9,2760586,70.7,125879,4.4
Mississippi,2004,11,1314607,61.4,1227778,57.3,86829,6.6
Missouri,2004,11,3003914,68.2,2823628,64.1,180286,6.0
Montana,2004,11,480537,66.6,459632,63.7,20905,4.4
Nebraska,2004,11,973503,73.8,935239,70.9,38264,3.9
Nevada,2004,11,1193034,67.0,1142139,64.1,50895,4.3
New Hampshire,2004,11,718416,71.0,693054,68.5,25362,3.5
New Jersey,2004,11,4340769,65.6,4145495,62.7,195274,4.5
New Mexico,2004,11,895749,63.0,846736,59.5,49013,5.5
New York,2004,11,9401294,62.9,8903284,59.5,498010,5.3
New York city,2004,11,3779204,59.2,3548576,55.6,230628,6.1
North Carolina,2004,11,4294700,66.1,4049112,62.4,245588,5.7
North Dakota,2004,11,354593,72.3,342570,69.8,12023,3.4
Ohio,2004,11,5859524,66.6,5487261,62.4,372263,6.4
Oklahoma,2004,11,1697444,64.2,1620792,61.3,76652,4.5
Oregon,2004,11,1841275,65.9,1713800,61.3,127475,6.9
Pennsylvania,2004,11,6235083,64.5,5907502,61.1,327581,5.3
Rhode Island,2004,11,553693,66.1,527242,62.9,26451,4.8
South Carolina,2004,11,2055188,64.3,1901297,59.5,153891,7.5
South Dakota,2004,11,427092,73.0,411374,70.3,15718,3.7
Tennessee,2004,11,2880946,63.1,2717840,59.5,163106,5.7
Texas,2004,11,11071593,67.4,10423472,63.4,648121,5.9
Utah,2004,11,1245923,71.3,1187918,68.0,58005,4.7
Vermont,2004,11,346241,70.2,334309,67.8,11932,3.4
Virginia,2004,11,3834654,67.8,3684017,65.2,150637,3.9
Washington,2004,11,3211380,67.4,3019465,63.3,191915,6.0
West Virginia,2004,11,788683,55.0,744583,51.9,44100,5.6
Wisconsin,2004,11,3022811,70.9,2877339,67.5,145472,4.8
Wyoming,2004,11,275494,71.1,265208,68.4,10286,3.7
Alabama,2004,12,2132075,61.7,2023018,58.5,109057,5.1
Alaska,2004,12,340858,71.7,316435,66.6,24423,7.2
Arizona,2004,12,2808145,64.2,2679413,61.2,128732,4.6
Arkansas,2004,12,1317182,62.8,1245566,59.4,71616,5.4
California,2004,12,17426935,65.5,16412579,61.6,1014356,5.8
Los Angeles County,2004,12,4758817,64.7,4474039,60.9,284778,6.0
Colorado,2004,12,2553668,72.7,2415136,68.7,138532,5.4
Connecticut,2004,12,1773105,66.4,1685851,63.1,87254,4.9
Delaware,2004,12,421836,66.1,403030,63.2,18806,4.5
District of Columbia,2004,12,318331,68.5,292225,62.9,26106,8.2
Florida,2004,12,8465429,61.7,8173938,59.6,291491,3.4
Georgia,2004,12,4516765,67.8,4261626,64.0,255139,5.6
Hawaii,2004,12,616613,65.1,597609,63.1,19004,3.1
Idaho,2004,12,715232,68.7,683201,65.7,32031,4.5
Illinois,2004,12,6375784,66.5,5991999,62.5,383785,6.0
Indiana,2004,12,3167353,66.9,2990614,63.2,176739,5.6
Iowa,2004,12,1611006,71.0,1537097,67.8,73909,4.6
Kansas,2004,12,1459201,70.9,1380607,67.1,78594,5.4
Kentucky,2004,12,1968075,61.7,1862538,58.4,105537,5.4
Louisiana,2004,12,2043263,61.0,1929847,57.6,113416,5.6
Maine,2004,12,687027,66.1,654455,63.0,32572,4.7
Maryland,2004,12,2896823,68.5,2760926,65.3,135897,4.7
Massachusetts,2004,12,3377131,66.8,3212696,63.6,164435,4.9
Michigan,2004,12,5069863,65.7,4705231,60.9,364632,7.2
Minnesota,2004,12,2881623,73.7,2757665,70.5,123958,4.3
Mississippi,2004,12,1315639,61.4,1227296,57.3,88343,6.7
Missouri,2004,12,3005007,68.2,2825149,64.1,179858,6.0
Montana,2004,12,481009,66.6,460157,63.7,20852,4.3
Nebraska,2004,12,973347,73.8,934740,70.9,38607,4.0
Nevada,2004,12,1196891,67.0,1145822,64.2,51069,4.3
New Hampshire,2004,12,719305,71.0,693703,68.5,25602,3.6
New Jersey,2004,12,4341309,65.6,4148246,62.7,193063,4.4
New Mexico,2004,12,897593,63.0,847970,59.6,49623,5.5
New York,2004,12,9396977,62.8,8907852,59.5,489125,5.2
New York city,2004,12,3776319,59.1,3551141,55.6,225178,6.0
North Carolina,2004,12,4300310,66.1,4053208,62.3,247102,5.7
North Dakota,2004,12,354612,72.3,342566,69.8,12046,3.4
Ohio,2004,12,5858060,66.6,5486004,62.3,372056,6.4
Oklahoma,2004,12,1699186,64.2,1622239,61.3,76947,4.5
Oregon,2004,12,1840401,65.7,1716027,61.3,124374,6.8
Pennsylvania,2004,12,6238050,64.5,5911684,61.1,326366,5.2
Rhode Island,2004,12,554184,66.2,527677,63.0,26507,4.8
South Carolina,2004,12,2054777,64.2,1900514,59.3,154263,7.5
South Dakota,2004,12,427349,72.9,411516,70.2,15833,3.7
Tennessee,2004,12,2877576,63.0,2713075,59.4,164501,5.7
Texas,2004,12,11089089,67.4,10441184,63.5,647905,5.8
Utah,2004,12,1249798,71.4,1192371,68.1,57427,4.6
Vermont,2004,12,346179,70.1,334240,67.7,11939,3.4
Virginia,2004,12,3841612,67.9,3690869,65.2,150743,3.9
Washington,2004,12,3217289,67.4,3026064,63.4,191225,5.9
West Virginia,2004,12,789023,55.0,744662,51.9,44361,5.6
Wisconsin,2004,12,3018970,70.8,2874349,67.4,144621,4.8
Wyoming,2004,12,275664,71.1,265528,68.5,10136,3.7
Alabama,2005,1,2131703,61.6,2025399,58.5,106304,5.0
Alaska,2005,1,341438,71.7,317165,66.6,24273,7.1
Arizona,2005,1,2813887,64.1,2684510,61.2,129377,4.6
Arkansas,2005,1,1320144,62.9,1248822,59.5,71322,5.4
California,2005,1,17439739,65.5,16435427,61.7,1004312,5.8
Los Angeles County,2005,1,4761864,64.8,4481838,60.9,280026,5.9
Colorado,2005,1,2554891,72.6,2416722,68.7,138169,5.4
Connecticut,2005,1,1775159,66.5,1687677,63.2,87482,4.9
Delaware,2005,1,422854,66.2,404007,63.2,18847,4.5
District of Columbia,2005,1,318752,68.5,293054,63.0,25698,8.1
Florida,2005,1,8492386,61.8,8206242,59.7,286144,3.4
Georgia,2005,1,4529287,67.9,4269353,64.0,259934,5.7
Hawaii,2005,1,617673,65.2,598918,63.2,18755,3.0
Idaho,2005,1,718063,68.9,686859,65.9,31204,4.3
Illinois,2005,1,6380668,66.6,5998455,62.6,382213,6.0
Indiana,2005,1,3172050,67.0,2994570,63.3,177480,5.6
Iowa,2005,1,1613752,71.1,1540278,67.9,73474,4.6
Kansas,2005,1,1458973,70.8,1380627,67.0,78346,5.4
Kentucky,2005,1,1971250,61.8,1863475,58.4,107775,5.5
Louisiana,2005,1,2045557,61.1,1931637,57.7,113920,5.6
Maine,2005,1,687951,66.2,654877,63.0,33074,4.8
Maryland,2005,1,2900672,68.5,2763621,65.3,137051,4.7
Massachusetts,2005,1,3376327,66.8,3211964,63.6,164363,4.9
Michigan,2005,1,5069412,65.6,4705996,60.9,363416,7.2
Minnesota,2005,1,2878253,73.6,2755477,70.4,122776,4.3
Mississippi,2005,1,1317464,61.5,1227658,57.3,89806,6.8
Missouri,2005,1,3006569,68.1,2827349,64.1,179220,6.0
Montana,2005,1,481501,66.6,460719,63.7,20782,4.3
Nebraska,2005,1,973373,73.8,934503,70.8,38870,4.0
Nevada,2005,1,1201124,67.1,1149962,64.2,51162,4.3
New Hampshire,2005,1,720535,71.1,694605,68.5,25930,3.6
New Jersey,2005,1,4344544,65.6,4152756,62.8,191788,4.4
New Mexico,2005,1,899441,63.1,849333,59.6,50108,5.6
New York,2005,1,9395352,62.8,8913873,59.6,481479,5.1
New York city,2005,1,3775349,59.1,3553989,55.6,221360,5.9
North Carolina,2005,1,4307787,66.2,4059887,62.3,247900,5.8
North Dakota,2005,1,354783,72.3,342697,69.8,12086,3.4
Ohio,2005,1,5859119,66.6,5488022,62.3,371097,6.3
Oklahoma,2005,1,1700922,64.3,1623958,61.3,76964,4.5
Oregon,2005,1,1840535,65.7,1719030,61.3,121505,6.6
Pennsylvania,2005,1,6241271,64.5,5916028,61.1,325243,5.2
Rhode Island,2005,1,555142,66.3,528431,63.1,26711,4.8
South Carolina,2005,1,2053990,64.1,1899758,59.2,154232,7.5
South Dakota,2005,1,427704,72.9,411732,70.2,15972,3.7
Tennessee,2005,1,2876208,62.9,2710731,59.2,165477,5.8
Texas,2005,1,11104720,67.4,10460250,63.5,644470,5.8
Utah,2005,1,1254218,71.5,1197310,68.2,56908,4.5
Vermont,2005,1,346365,70.2,334412,67.7,11953,3.5
Virginia,2005,1,3850656,68.0,3699201,65.3,151455,3.9
Washington,2005,1,3223554,67.4,3033132,63.5,190422,5.9
West Virginia,2005,1,789441,55.1,744992,52.0,44449,5.6
Wisconsin,2005,1,3016579,70.7,2872890,67.3,143689,4.8
Wyoming,2005,1,275949,71.1,265961,68.5,9988,3.6
Alabama,2005,2,2131888,61.6,2028403,58.6,103485,4.9
Alaska,2005,2,341972,71.7,317924,66.7,24048,7.0
Arizona,2005,2,2821319,64.1,2690651,61.1,130668,4.6
Arkansas,2005,2,1323041,62.9,1252355,59.6,70686,5.3
California,2005,2,17455416,65.5,16463071,61.7,992345,5.7
Los Angeles County,2005,2,4765810,64.8,4491117,61.1,274693,5.8
Colorado,2005,2,2556829,72.6,2419263,68.7,137566,5.4
Connecticut,2005,2,1778212,66.6,1690532,63.3,87680,4.9
Delaware,2005,2,424441,66.3,405516,63.3,18925,4.5
District of Columbia,2005,2,318917,68.6,293742,63.1,25175,7.9
Florida,2005,2,8519788,61.9,8240124,59.8,279664,3.3
Georgia,2005,2,4543128,68.0,4279783,64.0,263345,5.8
Hawaii,2005,2,618846,65.3,600440,63.3,18406,3.0
Idaho,2005,2,720965,69.0,690455,66.1,30510,4.2
Illinois,2005,2,6385992,66.6,6004806,62.6,381186,6.0
Indiana,2005,2,3177325,67.1,3000375,63.3,176950,5.6
Iowa,2005,2,1616939,71.2,1544054,68.0,72885,4.5
Kansas,2005,2,1458867,70.8,1380967,67.0,77900,5.3
Kentucky,2005,2,1975095,61.8,1864921,58.4,110174,5.6
Louisiana,2005,2,2047645,61.1,1933747,57.7,113898,5.6
Maine,2005,2,689243,66.3,655688,63.0,33555,4.9
Maryland,2005,2,2905808,68.6,2768164,65.3,137644,4.7
Massachusetts,2005,2,3377030,66.8,3212794,63.6,164236,4.9
Michigan,2005,2,5069092,65.6,4708726,61.0,360366,7.1
Minnesota,2005,2,2876919,73.5,2754981,70.4,121938,4.2
Mississippi,2005,2,1319560,61.5,1228513,57.3,91047,6.9
Missouri,2005,2,3008233,68.1,2830213,64.1,178020,5.9
Montana,2005,2,481942,66.6,461273,63.7,20669,4.3
Nebraska,2005,2,973423,73.7,934480,70.8,38943,4.0
Nevada,2005,2,1205680,67.2,1154565,64.3,51115,4.2
New Hampshire,2005,2,721899,71.1,695698,68.6,26201,3.6
New Jersey,2005,2,4350414,65.7,4159584,62.8,190830,4.4
New Mexico,2005,2,901136,63.1,850853,59.6,50283,5.6
New York,2005,2,9397267,62.8,8922290,59.6,474977,5.1
New York city,2005,2,3776384,59.0,3557877,55.6,218507,5.8
North Carolina,2005,2,4315872,66.2,4068033,62.4,247839,5.7
North Dakota,2005,2,355050,72.3,342924,69.9,12126,3.4
Ohio,2005,2,5861578,66.6,5493034,62.4,368544,6.3
Oklahoma,2005,2,1702422,64.3,1625949,61.4,76473,4.5
Oregon,2005,2,1841539,65.6,1722403,61.4,119136,6.5
Pennsylvania,2005,2,6244682,64.5,5921082,61.2,323600,5.2
Rhode Island,2005,2,556396,66.5,529447,63.2,26949,4.8
South Carolina,2005,2,2052650,63.9,1899188,59.1,153462,7.5
South Dakota,2005,2,428114,72.9,412033,70.2,16081,3.8
Tennessee,2005,2,2876117,62.8,2710274,59.2,165843,5.8
Texas,2005,2,11116844,67.4,10480729,63.5,636115,5.7
Utah,2005,2,1259004,71.6,1202700,68.4,56304,4.5
Vermont,2005,2,346736,70.2,334776,67.8,11960,3.4
Virginia,2005,2,3861571,68.1,3709239,65.4,152332,3.9
Washington,2005,2,3229985,67.5,3040798,63.5,189187,5.9
West Virginia,2005,2,789982,55.1,745710,52.0,44272,5.6
Wisconsin,2005,2,3015702,70.6,2872864,67.3,142838,4.7
Wyoming,2005,2,276375,71.2,266495,68.6,9880,3.6
Alabama,2005,3,2132542,61.5,2032012,58.6,100530,4.7
Alaska,2005,3,342453,71.7,318673,66.8,23780,6.9
Arizona,2005,3,2830147,64.1,2698108,61.1,132039,4.7
Arkansas,2005,3,1325810,63.0,1255998,59.7,69812,5.3
California,2005,3,17473771,65.5,16495869,61.8,977902,5.6
Los Angeles County,2005,3,4770352,64.8,4501662,61.2,268690,5.6
Colorado,2005,3,2559265,72.5,2422811,68.7,136454,5.3
Connecticut,2005,3,1781743,66.7,1694123,63.4,87620,4.9
Delaware,2005,3,426475,66.5,407433,63.6,19042,4.5
District of Columbia,2005,3,318932,68.5,294414,63.3,24518,7.7
Florida,2005,3,8548127,62.0,8276228,60.0,271899,3.2
Georgia,2005,3,4557632,68.1,4292843,64.1,264789,5.8
Hawaii,2005,3,620188,65.4,602193,63.5,17995,2.9
Idaho,2005,3,723846,69.1,693803,66.2,30043,4.2
Illinois,2005,3,6391368,66.6,6011404,62.7,379964,5.9
Indiana,2005,3,3182356,67.1,3007192,63.4,175164,5.5
Iowa,2005,3,1620079,71.3,1547950,68.2,72129,4.5
Kansas,2005,3,1458695,70.7,1381581,67.0,77114,5.3
Kentucky,2005,3,1979166,61.9,1867008,58.4,112158,5.7
Louisiana,2005,3,2049886,61.2,1936392,57.8,113494,5.5
Maine,2005,3,690827,66.4,656915,63.1,33912,4.9
Maryland,2005,3,2912173,68.7,2774885,65.5,137288,4.7
Massachusetts,2005,3,3378721,66.8,3215059,63.6,163662,4.8
Michigan,2005,3,5069101,65.6,4713415,61.0,355686,7.0
Minnesota,2005,3,2877593,73.5,2756754,70.4,120839,4.2
Mississippi,2005,3,1321680,61.6,1229790,57.3,91890,7.0
Missouri,2005,3,3009365,68.1,2833780,64.1,175585,5.8
Montana,2005,3,482380,66.5,461878,63.7,20502,4.3
Nebraska,2005,3,973356,73.7,934634,70.8,38722,4.0
Nevada,2005,3,1210546,67.2,1159620,64.4,50926,4.2
New Hampshire,2005,3,723194,71.2,696902,68.6,26292,3.6
New Jersey,2005,3,4358345,65.8,4168674,63.0,189671,4.4
New Mexico,2005,3,902610,63.2,852612,59.7,49998,5.5
New York,2005,3,9402641,62.8,8933249,59.6,469392,5.0
New York city,2005,3,3778828,59.0,3562929,55.7,215899,5.7
North Carolina,2005,3,4323537,66.2,4076344,62.4,247193,5.7
North Dakota,2005,3,355342,72.4,343219,69.9,12123,3.4
Ohio,2005,3,5864576,66.6,5500803,62.5,363773,6.2
Oklahoma,2005,3,1703928,64.3,1628305,61.5,75623,4.4
Oregon,2005,3,1843099,65.6,1725739,61.4,117360,6.4
Pennsylvania,2005,3,6248159,64.5,5927206,61.2,320953,5.1
Rhode Island,2005,3,557823,66.6,530675,63.4,27148,4.9
South Carolina,2005,3,2051178,63.8,1899305,59.1,151873,7.4
South Dakota,2005,3,428524,73.0,412436,70.2,16088,3.8
Tennessee,2005,3,2877240,62.7,2712037,59.1,165203,5.7
Texas,2005,3,11125846,67.3,10502785,63.6,623061,5.6
Utah,2005,3,1264021,71.7,1208513,68.6,55508,4.4
Vermont,2005,3,347219,70.3,335273,67.8,11946,3.4
Virginia,2005,3,3873810,68.2,3720949,65.5,152861,3.9
Washington,2005,3,3236835,67.6,3049422,63.7,187413,5.8
West Virginia,2005,3,790732,55.2,746873,52.1,43859,5.5
Wisconsin,2005,3,3016078,70.6,2873999,67.3,142079,4.7
Wyoming,2005,3,276936,71.3,267105,68.7,9831,3.5
Alabama,2005,4,2133797,61.5,2036225,58.7,97572,4.6
Alaska,2005,4,342940,71.7,319427,66.8,23513,6.9
Arizona,2005,4,2840229,64.1,2707135,61.1,133094,4.7
Arkansas,2005,4,1328586,63.1,1259507,59.8,69079,5.2
California,2005,4,17496205,65.5,16533791,61.9,962414,5.5
Los Angeles County,2005,4,4776010,64.9,4513748,61.3,262262,5.5
Colorado,2005,4,2562139,72.5,2427282,68.7,134857,5.3
Connecticut,2005,4,1785633,66.8,1698358,63.5,87275,4.9
Delaware,2005,4,428767,66.8,409590,63.8,19177,4.5
District of Columbia,2005,4,318871,68.5,295106,63.4,23765,7.5
Florida,2005,4,8579298,62.1,8316002,60.2,263296,3.1
Georgia,2005,4,4572349,68.1,4307651,64.2,264698,5.8
Hawaii,2005,4,621790,65.5,604188,63.6,17602,2.8
Idaho,2005,4,726623,69.2,696833,66.4,29790,4.1
Illinois,2005,4,6397182,66.7,6019020,62.7,378162,5.9
Indiana,2005,4,3187599,67.2,3014773,63.6,172826,5.4
Iowa,2005,4,1623189,71.5,1551978,68.3,71211,4.4
Kansas,2005,4,1458396,70.7,1382409,67.0,75987,5.2
Kentucky,2005,4,1983363,62.0,1869854,58.5,113509,5.7
Louisiana,2005,4,2052828,61.2,1939964,57.9,112864,5.5
Maine,2005,4,692602,66.5,658492,63.2,34110,4.9
Maryland,2005,4,2919397,68.8,2783419,65.6,135978,4.7
Massachusetts,2005,4,3381335,66.9,3218651,63.7,162684,4.8
Michigan,2005,4,5069995,65.6,4719678,61.1,350317,6.9
Minnesota,2005,4,2879816,73.5,2760555,70.4,119261,4.1
Mississippi,2005,4,1324117,61.7,1231424,57.3,92693,7.0
Missouri,2005,4,3009723,68.1,2838010,64.2,171713,5.7
Montana,2005,4,482966,66.6,462673,63.8,20293,4.2
Nebraska,2005,4,973129,73.6,934935,70.7,38194,3.9
Nevada,2005,4,1215779,67.3,1165081,64.5,50698,4.2
New Hampshire,2005,4,724404,71.3,698177,68.7,26227,3.6
New Jersey,2005,4,4367812,66.0,4179346,63.1,188466,4.3
New Mexico,2005,4,903984,63.2,854724,59.7,49260,5.4
New York,2005,4,9413319,62.8,8948092,59.7,465227,4.9
New York city,2005,4,3783190,59.1,3569734,55.7,213456,5.6
North Carolina,2005,4,4330675,66.2,4084487,62.5,246188,5.7
North Dakota,2005,4,355685,72.4,343627,70.0,12058,3.4
Ohio,2005,4,5868991,66.6,5511573,62.6,357418,6.1
Oklahoma,2005,4,1705764,64.3,1630999,61.5,74765,4.4
Oregon,2005,4,1845150,65.6,1729019,61.5,116131,6.3
Pennsylvania,2005,4,6252160,64.5,5934802,61.3,317358,5.1
Rhode Island,2005,4,559468,66.9,532093,63.6,27375,4.9
South Carolina,2005,4,2050227,63.7,1900329,59.0,149898,7.3
South Dakota,2005,4,428895,73.0,412936,70.3,15959,3.7
Tennessee,2005,4,2880139,62.7,2716883,59.2,163256,5.7
Texas,2005,4,11134783,67.3,10525682,63.6,609101,5.5
Utah,2005,4,1269262,71.9,1214708,68.8,54554,4.3
Vermont,2005,4,347780,70.3,335872,67.9,11908,3.4
Virginia,2005,4,3887264,68.4,3734204,65.7,153060,3.9
Washington,2005,4,3244311,67.6,3058875,63.8,185436,5.7
West Virginia,2005,4,791798,55.2,748412,52.2,43386,5.5
Wisconsin,2005,4,3017984,70.6,2876475,67.3,141509,4.7
Wyoming,2005,4,277618,71.4,267780,68.9,9838,3.5
Alabama,2005,5,2135881,61.5,2040891,58.8,94990,4.4
Alaska,2005,5,343476,71.7,320167,66.9,23309,6.8
Arizona,2005,5,2850925,64.2,2717283,61.2,133642,4.7
Arkansas,2005,5,1331576,63.2,1262763,59.9,68813,5.2
California,2005,5,17522524,65.6,16574980,62.0,947544,5.4
Los Angeles County,2005,5,4782599,65.0,4526952,61.5,255647,5.3
Colorado,2005,5,2565371,72.5,2432503,68.8,132868,5.2
Connecticut,2005,5,1789854,66.9,1703125,63.7,86729,4.8
Delaware,2005,5,431083,67.0,411764,64.0,19319,4.5
District of Columbia,2005,5,318779,68.4,295824,63.5,22955,7.2
Florida,2005,5,8613694,62.2,8359329,60.3,254365,3.0
Georgia,2005,5,4586838,68.2,4322968,64.3,263870,5.8
Hawaii,2005,5,623721,65.7,606410,63.8,17311,2.8
Idaho,2005,5,729260,69.3,699591,66.5,29669,4.1
Illinois,2005,5,6403350,66.7,6028017,62.8,375333,5.9
Indiana,2005,5,3193454,67.3,3022717,63.7,170737,5.3
Iowa,2005,5,1626381,71.6,1556181,68.5,70200,4.3
Kansas,2005,5,1458126,70.6,1383469,67.0,74657,5.1
Kentucky,2005,5,1987665,62.1,1873238,58.5,114427,5.8
Louisiana,2005,5,2055560,61.3,1943455,57.9,112105,5.5
Maine,2005,5,694480,66.7,660287,63.4,34193,4.9
Maryland,2005,5,2926886,68.9,2792868,65.8,134018,4.6
Massachusetts,2005,5,3384497,66.9,3222946,63.7,161551,4.8
Michigan,2005,5,5071335,65.6,4726752,61.1,344583,6.8
Minnesota,2005,5,2882721,73.5,2765257,70.5,117464,4.1
Mississippi,2005,5,1326831,61.8,1233270,57.4,93561,7.1
Missouri,2005,5,3009592,68.0,2842877,64.2,166715,5.5
Montana,2005,5,483804,66.6,463742,63.8,20062,4.1
Nebraska,2005,5,972854,73.6,935419,70.7,37435,3.8
Nevada,2005,5,1221363,67.5,1170797,64.7,50566,4.1
New Hampshire,2005,5,725551,71.3,699419,68.7,26132,3.6
New Jersey,2005,5,4378176,66.1,4190785,63.3,187391,4.3
New Mexico,2005,5,905359,63.2,857085,59.8,48274,5.3
New York,2005,5,9430767,62.9,8967742,59.8,463025,4.9
New York city,2005,5,3790065,59.1,3578591,55.8,211474,5.6
North Carolina,2005,5,4338048,66.2,4092837,62.5,245211,5.7
North Dakota,2005,5,356096,72.5,344144,70.1,11952,3.4
Ohio,2005,5,5874671,66.7,5524226,62.7,350445,6.0
Oklahoma,2005,5,1707881,64.4,1633746,61.6,74135,4.3
Oregon,2005,5,1847512,65.6,1732227,61.5,115285,6.2
Pennsylvania,2005,5,6256609,64.6,5943384,61.3,313225,5.0
Rhode Island,2005,5,561332,67.1,533579,63.8,27753,4.9
South Carolina,2005,5,2050371,63.6,1902110,59.0,148261,7.2
South Dakota,2005,5,429221,73.0,413517,70.3,15704,3.7
Tennessee,2005,5,2885126,62.7,2724760,59.3,160366,5.6
Texas,2005,5,11147039,67.3,10548719,63.7,598320,5.4
Utah,2005,5,1274652,72.0,1221155,69.0,53497,4.2
Vermont,2005,5,348442,70.4,336553,68.0,11889,3.4
Virginia,2005,5,3901019,68.5,3748057,65.8,152962,3.9
Washington,2005,5,3252288,67.7,3068571,63.9,183717,5.6
West Virginia,2005,5,793127,55.3,750104,52.3,43023,5.4
Wisconsin,2005,5,3021665,70.6,2880445,67.3,141220,4.7
Wyoming,2005,5,278399,71.6,268517,69.0,9882,3.5
Alabama,2005,6,2138558,61.6,2045463,58.9,93095,4.4
Alaska,2005,6,344040,71.7,320787,66.9,23253,6.8
Arizona,2005,6,2861177,64.2,2727304,61.2,133873,4.7
Arkansas,2005,6,1334725,63.3,1265578,60.0,69147,5.2
California,2005,6,17548901,65.6,16613194,62.1,935707,5.3
Los Angeles County,2005,6,4788948,65.0,4539286,61.6,249662,5.2
Colorado,2005,6,2568581,72.5,2437884,68.8,130697,5.1
Connecticut,2005,6,1793985,67.1,1707802,63.8,86183,4.8
Delaware,2005,6,433225,67.2,413740,64.2,19485,4.5
District of Columbia,2005,6,318597,68.3,296442,63.6,22155,7.0
Florida,2005,6,8648158,62.3,8402146,60.5,246012,2.8
Georgia,2005,6,4600177,68.3,4337087,64.4,263090,5.7
Hawaii,2005,6,625770,65.8,608578,64.0,17192,2.7
Idaho,2005,6,731642,69.4,702030,66.6,29612,4.0
Illinois,2005,6,6409402,66.7,6038327,62.9,371075,5.8
Indiana,2005,6,3199884,67.4,3030220,63.8,169664,5.3
Iowa,2005,6,1629285,71.7,1560026,68.6,69259,4.3
Kansas,2005,6,1458034,70.6,1384566,67.0,73468,5.0
Kentucky,2005,6,1991854,62.2,1876503,58.6,115351,5.8
Louisiana,2005,6,2056231,61.3,1944466,57.9,111765,5.4
Maine,2005,6,696234,66.8,661982,63.5,34252,4.9
Maryland,2005,6,2933604,69.0,2801630,65.9,131974,4.5
Massachusetts,2005,6,3387355,66.9,3226660,63.8,160695,4.7
Michigan,2005,6,5072040,65.6,4732938,61.2,339102,6.7
Minnesota,2005,6,2884875,73.5,2768925,70.5,115950,4.0
Mississippi,2005,6,1329527,61.8,1234991,57.4,94536,7.1
Missouri,2005,6,3009473,67.9,2847827,64.3,161646,5.4
Montana,2005,6,484873,66.7,465024,63.9,19849,4.1
Nebraska,2005,6,972611,73.5,935960,70.7,36651,3.8
Nevada,2005,6,1227044,67.6,1176365,64.8,50679,4.1
New Hampshire,2005,6,726590,71.3,700432,68.8,26158,3.6
New Jersey,2005,6,4388369,66.2,4201238,63.4,187131,4.3
New Mexico,2005,6,906611,63.2,859291,59.9,47320,5.2
New York,2005,6,9451917,63.0,8988295,59.9,463622,4.9
New York city,2005,6,3798390,59.2,3587594,55.9,210796,5.5
North Carolina,2005,6,4346067,66.2,4101399,62.5,244668,5.6
North Dakota,2005,6,356490,72.5,344643,70.1,11847,3.3
Ohio,2005,6,5880174,66.7,5536130,62.8,344044,5.9
Oklahoma,2005,6,1710037,64.4,1636192,61.6,73845,4.3
Oregon,2005,6,1849614,65.6,1735012,61.5,114602,6.2
Pennsylvania,2005,6,6260739,64.6,5951255,61.4,309484,4.9
Rhode Island,2005,6,563275,67.3,534939,63.9,28336,5.0
South Carolina,2005,6,2051815,63.5,1904122,59.0,147693,7.2
South Dakota,2005,6,429471,72.9,414094,70.3,15377,3.6
Tennessee,2005,6,2891389,62.8,2733867,59.4,157522,5.4
Texas,2005,6,11163389,67.3,10569961,63.7,593428,5.3
Utah,2005,6,1279876,72.1,1227458,69.2,52418,4.1
Vermont,2005,6,349161,70.5,337233,68.1,11928,3.4
Virginia,2005,6,3913106,68.6,3760577,66.0,152529,3.9
Washington,2005,6,3260163,67.8,3077493,64.0,182670,5.6
West Virginia,2005,6,794490,55.4,751601,52.4,42889,5.4
Wisconsin,2005,6,3026367,70.7,2884933,67.4,141434,4.7
Wyoming,2005,6,279173,71.7,269233,69.1,9940,3.6
Alabama,2005,7,2141446,61.6,2049425,59.0,92021,4.3
Alaska,2005,7,344616,71.7,321214,66.9,23402,6.8
Arizona,2005,7,2870449,64.2,2736262,61.2,134187,4.7
Arkansas,2005,7,1337609,63.3,1267612,60.0,69997,5.2
California,2005,7,17571326,65.7,16642343,62.2,928983,5.3
Los Angeles County,2005,7,4794160,65.1,4548680,61.7,245480,5.1
Colorado,2005,7,2571894,72.5,2443117,68.9,128777,5.0
Connecticut,2005,7,1797541,67.2,1711644,64.0,85897,4.8
Delaware,2005,7,435162,67.4,415453,64.4,19709,4.5
District of Columbia,2005,7,318296,68.2,296852,63.6,21444,6.7
Florida,2005,7,8679055,62.4,8440004,60.7,239051,2.8
Georgia,2005,7,4611806,68.3,4348844,64.4,262962,5.7
Hawaii,2005,7,627667,66.0,610383,64.2,17284,2.8
Idaho,2005,7,733547,69.4,704126,66.6,29421,4.0
Illinois,2005,7,6415103,66.8,6048748,62.9,366355,5.7
Indiana,2005,7,3206552,67.5,3036250,63.9,170302,5.3
Iowa,2005,7,1631666,71.7,1562922,68.7,68744,4.2
Kansas,2005,7,1458268,70.5,1385522,67.0,72746,5.0
Kentucky,2005,7,1995787,62.2,1878884,58.6,116903,5.9
Louisiana,2005,7,2053798,61.2,1941390,57.8,112408,5.5
Maine,2005,7,697669,66.9,663284,63.6,34385,4.9
Maryland,2005,7,2938910,69.1,2808520,66.0,130390,4.4
Massachusetts,2005,7,3389380,67.0,3228732,63.8,160648,4.7
Michigan,2005,7,5071751,65.6,4736805,61.2,334946,6.6
Minnesota,2005,7,2885243,73.4,2769965,70.5,115278,4.0
Mississippi,2005,7,1331761,61.9,1236213,57.5,95548,7.2
Missouri,2005,7,3009855,67.9,2852209,64.3,157646,5.2
Montana,2005,7,486068,66.7,466344,64.0,19724,4.1
Nebraska,2005,7,972543,73.4,936425,70.7,36118,3.7
Nevada,2005,7,1232503,67.7,1181486,64.9,51017,4.1
New Hampshire,2005,7,727494,71.4,701103,68.8,26391,3.6
New Jersey,2005,7,4397469,66.3,4208538,63.5,188931,4.3
New Mexico,2005,7,907701,63.2,861045,59.9,46656,5.1
New York,2005,7,9471800,63.1,9004782,60.0,467018,4.9
New York city,2005,7,3806317,59.3,3594394,56.0,211923,5.6
North Carolina,2005,7,4354216,66.3,4109401,62.5,244815,5.6
North Dakota,2005,7,356804,72.6,345038,70.2,11766,3.3
Ohio,2005,7,5885049,66.7,5544880,62.9,340169,5.8
Oklahoma,2005,7,1712048,64.5,1638056,61.7,73992,4.3
Oregon,2005,7,1851120,65.6,1737093,61.5,114027,6.2
Pennsylvania,2005,7,6263784,64.6,5956351,61.4,307433,4.9
Rhode Island,2005,7,565147,67.5,536047,64.1,29100,5.1
South Carolina,2005,7,2063723,63.8,1915173,59.2,148550,7.2
South Dakota,2005,7,429676,72.9,414593,70.3,15083,3.5
Tennessee,2005,7,2897898,62.9,2742168,59.5,155730,5.4
Texas,2005,7,11181941,67.3,10586526,63.7,595415,5.3
Utah,2005,7,1284707,72.3,1233299,69.4,51408,4.0
Vermont,2005,7,349868,70.6,337831,68.2,12037,3.4
Virginia,2005,7,3922403,68.7,3770468,66.0,151935,3.9
Washington,2005,7,3267255,67.8,3084845,64.0,182410,5.6
West Virginia,2005,7,795733,55.5,752689,52.5,43044,5.4
Wisconsin,2005,7,3031393,70.7,2888786,67.4,142607,4.7
Wyoming,2005,7,279863,71.8,269845,69.2,10018,3.6
Alabama,2005,8,2144070,61.6,2052511,59.0,91559,4.3
Alaska,2005,8,345128,71.7,321428,66.8,23700,6.9
Arizona,2005,8,2878393,64.2,2743723,61.2,134670,4.7
Arkansas,2005,8,1339765,63.3,1268919,60.0,70846,5.3
California,2005,8,17586567,65.7,16660840,62.2,925727,5.3
Los Angeles County,2005,8,4798037,65.1,4554681,61.8,243356,5.1
Colorado,2005,8,2575669,72.5,2448234,68.9,127435,4.9
Connecticut,2005,8,1800444,67.2,1714626,64.0,85818,4.8
Delaware,2005,8,436916,67.6,416994,64.5,19922,4.6
District of Columbia,2005,8,317895,68.1,297042,63.6,20853,6.6
Florida,2005,8,8704254,62.5,8470906,60.8,233348,2.7
Georgia,2005,8,4621335,68.3,4358286,64.4,263049,5.7
Hawaii,2005,8,629176,66.1,611695,64.3,17481,2.8
Idaho,2005,8,734841,69.4,705881,66.6,28960,3.9
Illinois,2005,8,6419959,66.8,6057981,63.0,361978,5.6
Indiana,2005,8,3212832,67.5,3040900,63.9,171932,5.4
Iowa,2005,8,1633524,71.8,1564894,68.7,68630,4.2
Kansas,2005,8,1458670,70.5,1386265,67.0,72405,5.0
Kentucky,2005,8,1999069,62.3,1880045,58.6,119024,6.0
Louisiana,2005,8,2048166,60.9,1934284,57.5,113882,5.6
Maine,2005,8,698645,66.9,664096,63.6,34549,4.9
Maryland,2005,8,2942753,69.1,2813495,66.1,129258,4.4
Massachusetts,2005,8,3390341,66.9,3229086,63.8,161255,4.8
Michigan,2005,8,5070878,65.5,4738218,61.2,332660,6.6
Minnesota,2005,8,2884095,73.3,2768586,70.4,115509,4.0
Mississippi,2005,8,1332744,61.8,1236730,57.4,96014,7.2
Missouri,2005,8,3010684,67.8,2855649,64.3,155035,5.1
Montana,2005,8,487195,66.8,467581,64.1,19614,4.0
Nebraska,2005,8,972541,73.4,936709,70.7,35832,3.7
Nevada,2005,8,1237385,67.8,1186098,65.0,51287,4.1
New Hampshire,2005,8,728165,71.3,701451,68.7,26714,3.7
New Jersey,2005,8,4404658,66.4,4211849,63.5,192809,4.4
New Mexico,2005,8,908444,63.1,862259,59.9,46185,5.1
New York,2005,8,9487602,63.2,9017089,60.1,470513,5.0
New York city,2005,8,3812776,59.4,3598938,56.0,213838,5.6
North Carolina,2005,8,4361901,66.3,4116952,62.5,244949,5.6
North Dakota,2005,8,357007,72.6,345323,70.2,11684,3.3
Ohio,2005,8,5889390,66.8,5550220,62.9,339170,5.8
Oklahoma,2005,8,1713560,64.4,1639307,61.6,74253,4.3
Oregon,2005,8,1852083,65.5,1738689,61.5,113394,6.1
Pennsylvania,2005,8,6265158,64.5,5957806,61.4,307352,4.9
Rhode Island,2005,8,566774,67.7,536885,64.2,29889,5.3
South Carolina,2005,8,2075567,64.1,1925332,59.4,150235,7.2
South Dakota,2005,8,429849,72.8,414985,70.3,14864,3.5
Tennessee,2005,8,2904849,62.9,2749511,59.5,155338,5.3
Texas,2005,8,11198913,67.2,10597585,63.6,601328,5.4
Utah,2005,8,1288990,72.3,1238581,69.5,50409,3.9
Vermont,2005,8,350538,70.7,338360,68.2,12178,3.5
Virginia,2005,8,3928582,68.7,3777612,66.1,150970,3.8
Washington,2005,8,3272992,67.8,3090829,64.1,182163,5.6
West Virginia,2005,8,796724,55.5,753416,52.5,43308,5.4
Wisconsin,2005,8,3036040,70.8,2891742,67.4,144298,4.8
Wyoming,2005,8,280397,71.9,270322,69.3,10075,3.6
Alabama,2005,9,2146009,61.6,2054667,59.0,91342,4.3
Alaska,2005,9,345532,71.7,321504,66.7,24028,7.0
Arizona,2005,9,2885335,64.1,2750192,61.1,135143,4.7
Arkansas,2005,9,1341047,63.2,1269841,59.8,71206,5.3
California,2005,9,17593070,65.6,16670184,62.2,922886,5.2
Los Angeles County,2005,9,4800718,65.1,4557811,61.8,242907,5.1
Colorado,2005,9,2580186,72.5,2453632,68.9,126554,4.9
Connecticut,2005,9,1803280,67.3,1717539,64.1,85741,4.8
Delaware,2005,9,438472,67.7,418445,64.6,20027,4.6
District of Columbia,2005,9,317511,68.0,297111,63.6,20400,6.4
Florida,2005,9,8723602,62.5,8495124,60.9,228478,2.6
Georgia,2005,9,4628993,68.3,4366401,64.4,262592,5.7
Hawaii,2005,9,630132,66.2,612523,64.3,17609,2.8
Idaho,2005,9,735658,69.3,707285,66.6,28373,3.9
Illinois,2005,9,6424089,66.8,6066490,63.1,357599,5.6
Indiana,2005,9,3218431,67.6,3045291,64.0,173140,5.4
Iowa,2005,9,1635007,71.8,1566429,68.8,68578,4.2
Kansas,2005,9,1458875,70.5,1386742,67.0,72133,4.9
Kentucky,2005,9,2001269,62.3,1880085,58.5,121184,6.1
Louisiana,2005,9,2173136,68.7,1924844,60.9,248292,11.4
Maine,2005,9,699076,66.9,664456,63.6,34620,5.0
Maryland,2005,9,2945531,69.1,2817311,66.1,128220,4.4
Massachusetts,2005,9,3390494,66.9,3228461,63.7,162033,4.8
Michigan,2005,9,5070043,65.5,4737551,61.2,332492,6.6
Minnesota,2005,9,2882897,73.2,2766312,70.3,116585,4.0
Mississippi,2005,9,1316504,61.0,1187304,55.0,129200,9.8
Missouri,2005,9,3011492,67.8,2857909,64.3,153583,5.1
Montana,2005,9,488098,66.8,468695,64.2,19403,4.0
Nebraska,2005,9,972334,73.3,936752,70.7,35582,3.7
Nevada,2005,9,1241575,67.8,1190337,65.0,51238,4.1
New Hampshire,2005,9,728538,71.3,701605,68.7,26933,3.7
New Jersey,2005,9,4409444,66.5,4211629,63.5,197815,4.5
New Mexico,2005,9,908796,63.1,863101,59.9,45695,5.0
New York,2005,9,9499119,63.2,9027253,60.1,471866,5.0
New York city,2005,9,3817709,59.4,3602440,56.0,215269,5.6
North Carolina,2005,9,4368733,66.2,4124674,62.5,244059,5.6
North Dakota,2005,9,357126,72.6,345520,70.2,11606,3.2
Ohio,2005,9,5893220,66.8,5553817,62.9,339403,5.8
Oklahoma,2005,9,1714235,64.3,1640181,61.5,74054,4.3
Oregon,2005,9,1852864,65.4,1740376,61.4,112488,6.1
Pennsylvania,2005,9,6264639,64.5,5956334,61.3,308305,4.9
Rhode Island,2005,9,567997,67.9,537478,64.2,30519,5.4
South Carolina,2005,9,2086459,64.3,1934643,59.6,151816,7.3
South Dakota,2005,9,429938,72.8,415245,70.3,14693,3.4
Tennessee,2005,9,2912507,63.0,2756425,59.6,156082,5.4
Texas,2005,9,11211963,67.0,10604917,63.4,607046,5.4
Utah,2005,9,1292779,72.3,1243398,69.5,49381,3.8
Vermont,2005,9,351183,70.8,338880,68.3,12303,3.5
Virginia,2005,9,3932245,68.7,3782825,66.1,149420,3.8
Washington,2005,9,3277523,67.8,3096373,64.1,181150,5.5
West Virginia,2005,9,797404,55.5,753972,52.5,43432,5.4
Wisconsin,2005,9,3039521,70.8,2893934,67.4,145587,4.8
Wyoming,2005,9,280752,71.8,270691,69.3,10061,3.6
Alabama,2005,10,2147374,61.5,2056388,58.9,90986,4.2
Alaska,2005,10,345831,71.6,321576,66.5,24255,7.0
Arizona,2005,10,2892105,64.0,2757019,61.0,135086,4.7
Arkansas,2005,10,1341579,63.2,1270710,59.9,70869,5.3
California,2005,10,17592258,65.5,16675256,62.1,917002,5.2
Los Angeles County,2005,10,4802898,65.2,4559845,61.9,243053,5.1
Colorado,2005,10,2585429,72.4,2460026,68.9,125403,4.9
Connecticut,2005,10,1806325,67.3,1720905,64.1,85420,4.7
Delaware,2005,10,439827,67.7,419873,64.7,19954,4.5
District of Columbia,2005,10,317260,67.8,297190,63.5,20070,6.3
Florida,2005,10,8739398,62.4,8515544,60.8,223854,2.6
Georgia,2005,10,4635374,68.2,4374745,64.3,260629,5.6
Hawaii,2005,10,630555,66.1,612996,64.2,17559,2.8
Idaho,2005,10,736264,69.1,708439,66.5,27825,3.8
Illinois,2005,10,6428364,66.7,6076025,63.1,352339,5.5
Indiana,2005,10,3223149,67.6,3050395,64.0,172754,5.4
Iowa,2005,10,1636188,71.7,1568012,68.7,68176,4.2
Kansas,2005,10,1458597,70.4,1386985,66.9,71612,4.9
Kentucky,2005,10,2002716,62.2,1879980,58.4,122736,6.1
Louisiana,2005,10,2163281,68.4,1915795,60.6,247486,11.4
Maine,2005,10,699035,66.8,664565,63.5,34470,4.9
Maryland,2005,10,2947984,69.0,2821340,66.1,126644,4.3
Massachusetts,2005,10,3390374,66.8,3227977,63.6,162397,4.8
Michigan,2005,10,5069227,65.4,4735206,61.1,334021,6.6
Minnesota,2005,10,2882961,73.1,2764955,70.1,118006,4.1
Mississippi,2005,10,1303895,61.4,1186924,55.9,116971,9.0
Missouri,2005,10,3012033,67.6,2859392,64.2,152641,5.1
Montana,2005,10,488697,66.8,469654,64.2,19043,3.9
Nebraska,2005,10,971736,73.2,936622,70.5,35114,3.6
Nevada,2005,10,1245346,67.7,1194538,65.0,50808,4.1
New Hampshire,2005,10,728681,71.2,701803,68.5,26878,3.7
New Jersey,2005,10,4412517,66.4,4210115,63.4,202402,4.6
New Mexico,2005,10,908872,62.9,863955,59.8,44917,4.9
New York,2005,10,9507494,63.2,9037183,60.1,470311,4.9
New York city,2005,10,3821311,59.4,3606061,56.1,215250,5.6
North Carolina,2005,10,4374131,66.1,4132785,62.5,241346,5.5
North Dakota,2005,10,357237,72.5,345720,70.2,11517,3.2
Ohio,2005,10,5896020,66.7,5557780,62.9,338240,5.7
Oklahoma,2005,10,1714020,64.3,1640951,61.5,73069,4.3
Oregon,2005,10,1853654,65.3,1742628,61.4,111026,6.0
Pennsylvania,2005,10,6262659,64.4,5954723,61.2,307936,4.9
Rhode Island,2005,10,568714,67.9,537884,64.2,30830,5.4
South Carolina,2005,10,2096077,64.4,1943514,59.7,152563,7.3
South Dakota,2005,10,429933,72.6,415423,70.2,14510,3.4
Tennessee,2005,10,2920508,63.0,2763210,59.6,157298,5.4
Texas,2005,10,11221201,67.0,10612285,63.4,608916,5.4
Utah,2005,10,1296320,72.2,1248068,69.6,48252,3.7
Vermont,2005,10,351830,70.8,339450,68.3,12380,3.5
Virginia,2005,10,3934813,68.6,3787789,66.0,147024,3.7
Washington,2005,10,3281368,67.7,3102575,64.0,178793,5.4
West Virginia,2005,10,797841,55.5,754692,52.5,43149,5.4
Wisconsin,2005,10,3041767,70.7,2895781,67.4,145986,4.8
Wyoming,2005,10,280982,71.8,271027,69.2,9955,3.5
Alabama,2005,11,2148494,61.5,2058020,58.9,90474,4.2
Alaska,2005,11,346027,71.5,321695,66.4,24332,7.0
Arizona,2005,11,2899289,64.0,2765037,61.0,134252,4.6
Arkansas,2005,11,1341840,63.1,1271732,59.8,70108,5.2
California,2005,11,17588199,65.4,16680410,62.0,907789,5.2
Los Angeles County,2005,11,4804682,65.2,4561783,61.9,242899,5.1
Colorado,2005,11,2591508,72.4,2467857,69.0,123651,4.8
Connecticut,2005,11,1809526,67.4,1724701,64.2,84825,4.7
Delaware,2005,11,440907,67.8,421211,64.8,19696,4.5
District of Columbia,2005,11,317081,67.7,297209,63.5,19872,6.3
Florida,2005,11,8754532,62.4,8534968,60.9,219564,2.5
Georgia,2005,11,4641476,68.1,4384358,64.3,257118,5.5
Hawaii,2005,11,630663,66.0,613292,64.2,17371,2.8
Idaho,2005,11,736969,69.0,709484,66.4,27485,3.7
Illinois,2005,11,6433630,66.7,6087174,63.1,346456,5.4
Indiana,2005,11,3226653,67.6,3056076,64.0,170577,5.3
Iowa,2005,11,1637386,71.7,1570143,68.8,67243,4.1
Kansas,2005,11,1457882,70.3,1387093,66.9,70789,4.9
Kentucky,2005,11,2003954,62.2,1880622,58.3,123332,6.2
Louisiana,2005,11,2153374,68.1,1909121,60.4,244253,11.3
Maine,2005,11,698711,66.8,664644,63.5,34067,4.9
Maryland,2005,11,2950992,69.1,2826553,66.1,124439,4.2
Massachusetts,2005,11,3390390,66.8,3228125,63.6,162265,4.8
Michigan,2005,11,5068822,65.4,4731389,61.0,337433,6.7
Minnesota,2005,11,2884450,73.1,2765204,70.1,119246,4.1
Mississippi,2005,11,1297935,61.1,1186645,55.9,111290,8.6
Missouri,2005,11,3012555,67.6,2860770,64.2,151785,5.0
Montana,2005,11,489065,66.7,470489,64.2,18576,3.8
Nebraska,2005,11,970846,73.1,936489,70.5,34357,3.5
Nevada,2005,11,1249182,67.7,1198920,65.0,50262,4.0
New Hampshire,2005,11,728637,71.1,702098,68.5,26539,3.6
New Jersey,2005,11,4415274,66.4,4209367,63.3,205907,4.7
New Mexico,2005,11,908755,62.8,865005,59.7,43750,4.8
New York,2005,11,9513815,63.2,9046842,60.1,466973,4.9
New York city,2005,11,3823659,59.4,3609917,56.1,213742,5.6
North Carolina,2005,11,4378685,66.1,4141686,62.5,236999,5.4
North Dakota,2005,11,357460,72.5,346030,70.2,11430,3.2
Ohio,2005,11,5897939,66.7,5562941,62.9,334998,5.7
Oklahoma,2005,11,1713063,64.2,1641639,61.5,71424,4.2
Oregon,2005,11,1854667,65.2,1745572,61.4,109095,5.9
Pennsylvania,2005,11,6260944,64.3,5955415,61.2,305529,4.9
Rhode Island,2005,11,568990,67.9,538164,64.2,30826,5.4
South Carolina,2005,11,2105023,64.5,1952528,59.9,152495,7.2
South Dakota,2005,11,429875,72.5,415594,70.1,14281,3.3
Tennessee,2005,11,2928930,63.1,2770270,59.7,158660,5.4
Texas,2005,11,11227907,67.0,10621632,63.4,606275,5.4
Utah,2005,11,1299869,72.2,1252829,69.6,47040,3.6
Vermont,2005,11,352432,70.9,340020,68.4,12412,3.5
Virginia,2005,11,3937586,68.6,3793610,66.1,143976,3.7
Washington,2005,11,3285007,67.7,3109758,64.0,175249,5.3
West Virginia,2005,11,798171,55.5,755752,52.6,42419,5.3
Wisconsin,2005,11,3043147,70.7,2897652,67.3,145495,4.8
Wyoming,2005,11,281156,71.7,271399,69.2,9757,3.5
Alabama,2005,12,2149633,61.4,2059843,58.9,89790,4.2
Alaska,2005,12,346169,71.4,321902,66.4,24267,7.0
Arizona,2005,12,2907204,63.9,2774501,61.0,132703,4.6
Arkansas,2005,12,1342120,63.1,1272820,59.8,69300,5.2
California,2005,12,17583772,65.3,16687569,62.0,896203,5.1
Los Angeles County,2005,12,4805470,65.2,4563673,61.9,241797,5.0
Colorado,2005,12,2598074,72.5,2476752,69.1,121322,4.7
Connecticut,2005,12,1812780,67.5,1728795,64.3,83985,4.6
Delaware,2005,12,441628,67.8,422333,64.8,19295,4.4
District of Columbia,2005,12,316887,67.6,297103,63.4,19784,6.2
Florida,2005,12,8770521,62.4,8554725,60.9,215796,2.5
Georgia,2005,12,4647812,68.1,4395233,64.4,252579,5.4
Hawaii,2005,12,630664,65.9,613526,64.1,17138,2.7
Idaho,2005,12,737865,68.9,710506,66.4,27359,3.7
Illinois,2005,12,6439468,66.7,6099998,63.2,339470,5.3
Indiana,2005,12,3228693,67.6,3061470,64.1,167223,5.2
Iowa,2005,12,1639110,71.8,1573366,68.9,65744,4.0
Kansas,2005,12,1456928,70.2,1387302,66.9,69626,4.8
Kentucky,2005,12,2005232,62.1,1882447,58.3,122785,6.1
Louisiana,2005,12,2035834,64.3,1905605,60.2,130229,6.4
Maine,2005,12,698259,66.7,664823,63.5,33436,4.8
Maryland,2005,12,2954859,69.1,2832771,66.2,122088,4.1
Massachusetts,2005,12,3390351,66.7,3228651,63.6,161700,4.8
Michigan,2005,12,5068366,65.3,4726467,60.9,341899,6.7
Minnesota,2005,12,2885850,73.1,2766158,70.0,119692,4.1
Mississippi,2005,12,1283148,60.4,1186761,55.8,96387,7.5
Missouri,2005,12,3013355,67.5,2862756,64.2,150599,5.0
Montana,2005,12,489365,66.7,471289,64.2,18076,3.7
Nebraska,2005,12,969870,73.0,936544,70.4,33326,3.4
Nevada,2005,12,1253457,67.7,1203581,65.0,49876,4.0
New Hampshire,2005,12,728390,71.0,702402,68.5,25988,3.6
New Jersey,2005,12,4418378,66.4,4209957,63.3,208421,4.7
New Mexico,2005,12,908570,62.6,866249,59.7,42321,4.7
New York,2005,12,9518216,63.2,9056031,60.1,462185,4.9
New York city,2005,12,3824950,59.4,3614303,56.1,210647,5.5
North Carolina,2005,12,4383727,66.0,4152043,62.5,231684,5.3
North Dakota,2005,12,357871,72.6,346528,70.3,11343,3.2
Ohio,2005,12,5898850,66.7,5568986,63.0,329864,5.6
Oklahoma,2005,12,1711566,64.0,1642007,61.4,69559,4.1
Oregon,2005,12,1856074,65.1,1749282,61.4,106792,5.8
Pennsylvania,2005,12,6260644,64.3,5958684,61.2,301960,4.8
Rhode Island,2005,12,569041,67.9,538397,64.3,30644,5.4
South Carolina,2005,12,2114205,64.7,1962317,60.0,151888,7.2
South Dakota,2005,12,429803,72.4,415844,70.1,13959,3.2
Tennessee,2005,12,2937905,63.2,2778144,59.7,159761,5.4
Texas,2005,12,11233098,67.0,10633045,63.4,600053,5.3
Utah,2005,12,1303593,72.2,1257816,69.7,45777,3.5
Vermont,2005,12,352929,70.9,340528,68.4,12401,3.5
Virginia,2005,12,3940662,68.5,3800223,66.1,140439,3.6
Washington,2005,12,3288548,67.6,3117441,64.1,171107,5.2
West Virginia,2005,12,798687,55.5,757175,52.7,41512,5.2
Wisconsin,2005,12,3043904,70.7,2899804,67.3,144100,4.7
Wyoming,2005,12,281322,71.6,271850,69.2,9472,3.4
Alabama,2006,1,2151174,61.4,2062219,58.9,88955,4.1
Alaska,2006,1,346388,71.3,322315,66.3,24073,6.9
Arizona,2006,1,2916314,63.9,2785456,61.1,130858,4.5
Arkansas,2006,1,1342700,63.0,1273915,59.8,68785,5.1
California,2006,1,17582550,65.3,16698861,62.0,883689,5.0
Los Angeles County,2006,1,4805672,65.2,4566203,61.9,239469,5.0
Colorado,2006,1,2605057,72.6,2486296,69.3,118761,4.6
Connecticut,2006,1,1816063,67.6,1733100,64.5,82963,4.6
Delaware,2006,1,442004,67.8,423215,64.9,18789,4.3
District of Columbia,2006,1,316908,67.6,297153,63.4,19755,6.2
Florida,2006,1,8789465,62.5,8576664,61.0,212801,2.4
Georgia,2006,1,4654813,68.0,4406965,64.4,247848,5.3
Hawaii,2006,1,630827,65.9,613850,64.1,16977,2.7
Idaho,2006,1,738902,68.8,711591,66.3,27311,3.7
Illinois,2006,1,6446086,66.8,6115270,63.4,330816,5.1
Indiana,2006,1,3230070,67.6,3066477,64.2,163593,5.1
Iowa,2006,1,1641849,71.9,1578060,69.1,63789,3.9
Kansas,2006,1,1455936,70.2,1387766,66.9,68170,4.7
Kentucky,2006,1,2006831,62.1,1885679,58.4,121152,6.0
Louisiana,2006,1,2003932,63.3,1905404,60.2,98528,4.9
Maine,2006,1,697917,66.6,665201,63.5,32716,4.7
Maryland,2006,1,2959519,69.1,2839370,66.3,120149,4.1
Massachusetts,2006,1,3390788,66.7,3229944,63.6,160844,4.7
Michigan,2006,1,5067923,65.3,4722032,60.9,345891,6.8
Minnesota,2006,1,2886377,73.0,2767467,70.0,118910,4.1
Mississippi,2006,1,1275110,59.9,1187661,55.8,87449,6.9
Missouri,2006,1,3014631,67.5,2865710,64.2,148921,4.9
Montana,2006,1,489832,66.7,472225,64.3,17607,3.6
Nebraska,2006,1,969001,72.9,936904,70.4,32097,3.3
Nevada,2006,1,1258441,67.8,1208656,65.1,49785,4.0
New Hampshire,2006,1,728153,70.9,702807,68.4,25346,3.5
New Jersey,2006,1,4421798,66.5,4211793,63.3,210005,4.7
New Mexico,2006,1,908699,62.6,867820,59.8,40879,4.5
New York,2006,1,9522997,63.2,9066533,60.2,456464,4.8
New York city,2006,1,3826331,59.4,3619980,56.2,206351,5.4
North Carolina,2006,1,4390556,66.0,4164193,62.6,226363,5.2
North Dakota,2006,1,358494,72.7,347249,70.4,11245,3.1
Ohio,2006,1,5900385,66.7,5577335,63.1,323050,5.5
Oklahoma,2006,1,1710025,63.9,1642205,61.4,67820,4.0
Oregon,2006,1,1858333,65.1,1753954,61.5,104379,5.6
Pennsylvania,2006,1,6262494,64.3,5964453,61.2,298041,4.8
Rhode Island,2006,1,569149,67.9,538717,64.3,30432,5.3
South Carolina,2006,1,2119855,64.7,1968705,60.1,151150,7.1
South Dakota,2006,1,429781,72.4,416242,70.1,13539,3.2
Tennessee,2006,1,2948616,63.3,2788197,59.9,160419,5.4
Texas,2006,1,11240453,67.0,10647444,63.4,593009,5.3
Utah,2006,1,1307644,72.3,1263185,69.8,44459,3.4
Vermont,2006,1,353344,71.0,340982,68.5,12362,3.5
Virginia,2006,1,3944531,68.5,3807796,66.2,136735,3.5
Washington,2006,1,3292718,67.6,3125422,64.1,167296,5.1
West Virginia,2006,1,799606,55.6,758886,52.8,40720,5.1
Wisconsin,2006,1,3044830,70.7,2902831,67.4,141999,4.7
Wyoming,2006,1,281549,71.6,272423,69.3,9126,3.2
Alabama,2006,2,2153411,61.4,2065225,58.9,88186,4.1
Alaska,2006,2,346742,71.2,322936,66.3,23806,6.9
Arizona,2006,2,2926379,64.0,2796970,61.1,129409,4.4
Arkansas,2006,2,1343722,63.0,1274911,59.8,68811,5.1
California,2006,2,17587038,65.3,16714377,62.0,872661,5.0
Los Angeles County,2006,2,4805566,65.2,4569340,62.0,236226,4.9
Colorado,2006,2,2612418,72.7,2495895,69.4,116523,4.5
Connecticut,2006,2,1819226,67.6,1737275,64.6,81951,4.5
Delaware,2006,2,442164,67.7,423908,64.9,18256,4.1
District of Columbia,2006,2,317249,67.6,297468,63.4,19781,6.2
Florida,2006,2,8812184,62.6,8601209,61.1,210975,2.4
Georgia,2006,2,4662900,68.0,4418947,64.5,243953,5.2
Hawaii,2006,2,631267,65.9,614296,64.1,16971,2.7
Idaho,2006,2,739890,68.8,712681,66.3,27209,3.7
Illinois,2006,2,6453903,66.8,6133097,63.5,320806,5.0
Indiana,2006,2,3231598,67.6,3070849,64.2,160749,5.0
Iowa,2006,2,1645442,72.0,1583664,69.3,61778,3.8
Kansas,2006,2,1455091,70.1,1388411,66.9,66680,4.6
Kentucky,2006,2,2008797,62.1,1889872,58.5,118925,5.9
Louisiana,2006,2,1998960,63.1,1907657,60.2,91303,4.6
Maine,2006,2,697805,66.6,665670,63.5,32135,4.6
Maryland,2006,2,2964849,69.2,2845544,66.4,119305,4.0
Massachusetts,2006,2,3392290,66.7,3232254,63.6,160036,4.7
Michigan,2006,2,5067483,65.3,4718738,60.8,348745,6.9
Minnesota,2006,2,2886107,72.9,2768846,70.0,117261,4.1
Mississippi,2006,2,1272806,59.8,1189293,55.8,83513,6.6
Missouri,2006,2,3016412,67.5,2869483,64.2,146929,4.9
Montana,2006,2,490715,66.7,473484,64.4,17231,3.5
Nebraska,2006,2,968388,72.8,937521,70.5,30867,3.2
Nevada,2006,2,1264123,67.9,1214044,65.2,50079,4.0
New Hampshire,2006,2,728227,70.8,703407,68.4,24820,3.4
New Jersey,2006,2,4425264,66.5,4214385,63.3,210879,4.8
New Mexico,2006,2,909312,62.5,869623,59.8,39689,4.4
New York,2006,2,9529175,63.2,9077960,60.2,451215,4.7
New York city,2006,2,3828293,59.4,3626316,56.2,201977,5.3
North Carolina,2006,2,4400107,66.0,4177906,62.7,222201,5.0
North Dakota,2006,2,359250,72.8,348085,70.6,11165,3.1
Ohio,2006,2,5904768,66.7,5588283,63.2,316485,5.4
Oklahoma,2006,2,1708921,63.8,1642490,61.3,66431,3.9
Oregon,2006,2,1861625,65.1,1759373,61.6,102252,5.5
Pennsylvania,2006,2,6267038,64.3,5972062,61.3,294976,4.7
Rhode Island,2006,2,569485,68.0,539189,64.4,30296,5.3
South Carolina,2006,2,2135776,65.1,1985178,60.5,150598,7.1
South Dakota,2006,2,429875,72.3,416765,70.1,13110,3.0
Tennessee,2006,2,2961842,63.5,2800802,60.1,161040,5.4
Texas,2006,2,11253367,67.0,10664814,63.4,588553,5.2
Utah,2006,2,1311981,72.3,1268854,69.9,43127,3.3
Vermont,2006,2,353706,71.0,341368,68.5,12338,3.5
Virginia,2006,2,3949380,68.5,3815798,66.2,133582,3.4
Washington,2006,2,3297951,67.6,3133200,64.2,164751,5.0
West Virginia,2006,2,800803,55.7,760564,52.9,40239,5.0
Wisconsin,2006,2,3046724,70.7,2906854,67.4,139870,4.6
Wyoming,2006,2,281877,71.6,273094,69.4,8783,3.1
Alabama,2006,3,2156335,61.4,2068505,58.9,87830,4.1
Alaska,2006,3,347278,71.2,323717,66.4,23561,6.8
Arizona,2006,3,2937047,64.0,2808195,61.2,128852,4.4
Arkansas,2006,3,1345046,63.0,1275609,59.8,69437,5.2
California,2006,3,17596774,65.3,16730993,62.1,865781,4.9
Los Angeles County,2006,3,4804153,65.2,4571095,62.0,233058,4.9
Colorado,2006,3,2620070,72.8,2504897,69.6,115173,4.4
Connecticut,2006,3,1822224,67.7,1741020,64.7,81204,4.5
Delaware,2006,3,442256,67.6,424429,64.9,17827,4.0
District of Columbia,2006,3,317859,67.7,297973,63.5,19886,6.3
Florida,2006,3,8837309,62.7,8626543,61.2,210766,2.4
Georgia,2006,3,4672236,68.0,4430502,64.5,241734,5.2
Hawaii,2006,3,631983,65.9,614874,64.1,17109,2.7
Idaho,2006,3,740751,68.7,713742,66.2,27009,3.6
Illinois,2006,3,6463382,66.9,6152425,63.7,310957,4.8
Indiana,2006,3,3233382,67.6,3073794,64.2,159588,4.9
Iowa,2006,3,1649127,72.1,1588911,69.5,60216,3.7
Kansas,2006,3,1454601,70.1,1389076,66.9,65525,4.5
Kentucky,2006,3,2011065,62.2,1894196,58.5,116869,5.8
Louisiana,2006,3,1995431,62.8,1910602,60.2,84829,4.3
Maine,2006,3,697986,66.6,666098,63.5,31888,4.6
Maryland,2006,3,2970542,69.3,2850446,66.5,120096,4.0
Massachusetts,2006,3,3394962,66.8,3235249,63.6,159713,4.7
Michigan,2006,3,5066385,65.3,4715647,60.8,350738,6.9
Minnesota,2006,3,2885094,72.9,2769722,70.0,115372,4.0
Mississippi,2006,3,1271087,59.5,1191197,55.8,79890,6.3
Missouri,2006,3,3019077,67.5,2873689,64.2,145388,4.8
Montana,2006,3,492075,66.8,475078,64.5,16997,3.5
Nebraska,2006,3,968167,72.7,938255,70.5,29912,3.1
Nevada,2006,3,1270318,68.1,1219558,65.4,50760,4.0
New Hampshire,2006,3,728692,70.8,704087,68.4,24605,3.4
New Jersey,2006,3,4428914,66.6,4217367,63.4,211547,4.8
New Mexico,2006,3,910354,62.5,871364,59.9,38990,4.3
New York,2006,3,9535839,63.2,9087985,60.3,447854,4.7
New York city,2006,3,3830542,59.4,3631926,56.3,198616,5.2
North Carolina,2006,3,4412606,66.1,4192361,62.8,220245,5.0
North Dakota,2006,3,360031,73.0,348880,70.7,11151,3.1
Ohio,2006,3,5912662,66.8,5599950,63.3,312712,5.3
Oklahoma,2006,3,1708593,63.7,1642958,61.3,65635,3.8
Oregon,2006,3,1865808,65.2,1765028,61.7,100780,5.4
Pennsylvania,2006,3,6273630,64.3,5979608,61.3,294022,4.7
Rhode Island,2006,3,570038,68.1,539718,64.4,30320,5.3
South Carolina,2006,3,2138279,65.1,1987777,60.5,150502,7.0
South Dakota,2006,3,430158,72.3,417367,70.1,12791,3.0
Tennessee,2006,3,2976996,63.7,2814715,60.3,162281,5.5
Texas,2006,3,11272128,66.9,10683983,63.4,588145,5.2
Utah,2006,3,1316509,72.4,1274637,70.1,41872,3.2
Vermont,2006,3,354035,71.0,341639,68.5,12396,3.5
Virginia,2006,3,3954870,68.6,3823250,66.3,131620,3.3
Washington,2006,3,3304104,67.6,3140073,64.2,164031,5.0
West Virginia,2006,3,802072,55.8,761818,53.0,40254,5.0
Wisconsin,2006,3,3049844,70.7,2911405,67.5,138439,4.5
Wyoming,2006,3,282331,71.6,273809,69.5,8522,3.0
Alabama,2006,4,2159713,61.5,2071802,59.0,87911,4.1
Alaska,2006,4,347940,71.2,324533,66.4,23407,6.7
Arizona,2006,4,2947857,64.1,2818660,61.3,129197,4.4
Arkansas,2006,4,1346255,63.0,1275834,59.7,70421,5.2
California,2006,4,17609415,65.3,16745349,62.1,864066,4.9
Los Angeles County,2006,4,4800479,65.1,4569479,62.0,231000,4.8
Colorado,2006,4,2627673,72.9,2512768,69.7,114905,4.4
Connecticut,2006,4,1824847,67.8,1743960,64.8,80887,4.4
Delaware,2006,4,442353,67.5,424748,64.8,17605,4.0
District of Columbia,2006,4,318547,67.8,298467,63.6,20080,6.3
Florida,2006,4,8863169,62.8,8650938,61.3,212231,2.4
Georgia,2006,4,4682594,68.1,4441462,64.5,241132,5.1
Hawaii,2006,4,632898,66.0,615623,64.2,17275,2.7
Idaho,2006,4,741494,68.6,714784,66.2,26710,3.6
Illinois,2006,4,6474739,67.0,6171881,63.9,302858,4.7
Indiana,2006,4,3234908,67.6,3074689,64.2,160219,5.0
Iowa,2006,4,1652328,72.2,1592837,69.6,59491,3.6
Kansas,2006,4,1457490,70.2,1392614,67.0,64876,4.5
Kentucky,2006,4,2013756,62.2,1898114,58.6,115642,5.7
Louisiana,2006,4,1992841,62.7,1912614,60.1,80227,4.0
Maine,2006,4,698519,66.6,666474,63.5,32045,4.6
Maryland,2006,4,2976119,69.4,2853647,66.6,122472,4.1
Massachusetts,2006,4,3398710,66.8,3238568,63.7,160142,4.7
Michigan,2006,4,5064429,65.3,4711722,60.7,352707,7.0
Minnesota,2006,4,2883712,72.8,2769949,69.9,113763,3.9
Mississippi,2006,4,1272591,59.5,1193090,55.7,79501,6.2
Missouri,2006,4,3022984,67.5,2877879,64.3,145105,4.8
Montana,2006,4,493679,67.0,476780,64.7,16899,3.4
Nebraska,2006,4,968417,72.7,939016,70.5,29401,3.0
Nevada,2006,4,1276714,68.2,1225043,65.5,51671,4.0
New Hampshire,2006,4,729434,70.8,704706,68.4,24728,3.4
New Jersey,2006,4,4432546,66.6,4220226,63.4,212320,4.8
New Mexico,2006,4,911689,62.6,872848,59.9,38841,4.3
New York,2006,4,9539977,63.3,9093660,60.3,446317,4.7
New York city,2006,4,3831774,59.3,3635415,56.3,196359,5.1
North Carolina,2006,4,4427027,66.2,4205992,62.9,221035,5.0
North Dakota,2006,4,360738,73.1,349549,70.8,11189,3.1
Ohio,2006,4,5923616,66.9,5610899,63.4,312717,5.3
Oklahoma,2006,4,1709125,63.7,1643647,61.2,65478,3.8
Oregon,2006,4,1870498,65.3,1770303,61.8,100195,5.4
Pennsylvania,2006,4,6281330,64.4,5985668,61.4,295662,4.7
Rhode Island,2006,4,570682,68.1,540218,64.5,30464,5.3
South Carolina,2006,4,2141052,65.1,1990230,60.5,150822,7.0
South Dakota,2006,4,430646,72.3,417991,70.2,12655,2.9
Tennessee,2006,4,2993120,64.0,2828835,60.5,164285,5.5
Texas,2006,4,11294298,66.8,10704340,63.3,589958,5.2
Utah,2006,4,1321063,72.4,1280361,70.2,40702,3.1
Vermont,2006,4,354370,71.1,341788,68.5,12582,3.6
Virginia,2006,4,3960510,68.6,3829433,66.3,131077,3.3
Washington,2006,4,3311209,67.6,3146142,64.3,165067,5.0
West Virginia,2006,4,803284,55.8,762471,53.0,40813,5.1
Wisconsin,2006,4,3054068,70.8,2915742,67.6,138326,4.5
Wyoming,2006,4,282905,71.7,274513,69.6,8392,3.0
Alabama,2006,5,2163359,61.5,2075386,59.0,87973,4.1
Alaska,2006,5,348562,71.2,325248,66.5,23314,6.7
Arizona,2006,5,2958210,64.1,2828396,61.3,129814,4.4
Arkansas,2006,5,1346847,62.9,1275583,59.6,71264,5.3
California,2006,5,17622725,65.3,16757871,62.1,864854,4.9
Los Angeles County,2006,5,4794967,65.0,4564967,61.9,230000,4.8
Colorado,2006,5,2634815,72.9,2519556,69.8,115259,4.4
Connecticut,2006,5,1826938,67.9,1746106,64.9,80832,4.4
Delaware,2006,5,442483,67.4,424936,64.8,17547,4.0
District of Columbia,2006,5,319246,68.0,298941,63.6,20305,6.4
Florida,2006,5,8888754,62.9,8674278,61.4,214476,2.4
Georgia,2006,5,4693623,68.1,4452478,64.6,241145,5.1
Hawaii,2006,5,633852,66.1,616564,64.3,17288,2.7
Idaho,2006,5,742127,68.5,715861,66.1,26266,3.5
Illinois,2006,5,6488248,67.1,6191538,64.1,296710,4.6
Indiana,2006,5,3235765,67.5,3073913,64.2,161852,5.0
Iowa,2006,5,1654729,72.3,1595166,69.7,59563,3.6
Kansas,2006,5,1460742,70.3,1396157,67.2,64585,4.4
Kentucky,2006,5,2017039,62.2,1901829,58.7,115210,5.7
Louisiana,2006,5,1991641,62.5,1913803,60.1,77838,3.9
Maine,2006,5,699299,66.6,666812,63.5,32487,4.6
Maryland,2006,5,2981172,69.5,2855605,66.6,125567,4.2
Massachusetts,2006,5,3403308,66.9,3242339,63.7,160969,4.7
Michigan,2006,5,5061963,65.2,4706902,60.6,355061,7.0
Minnesota,2006,5,2882539,72.7,2769759,69.8,112780,3.9
Mississippi,2006,5,1274797,59.4,1195081,55.7,79716,6.3
Missouri,2006,5,3028016,67.6,2882003,64.3,146013,4.8
Montana,2006,5,495157,67.1,478285,64.8,16872,3.4
Nebraska,2006,5,969109,72.7,939813,70.5,29296,3.0
Nevada,2006,5,1282975,68.4,1230505,65.6,52470,4.1
New Hampshire,2006,5,730385,70.8,705339,68.4,25046,3.4
New Jersey,2006,5,4435463,66.7,4222693,63.5,212770,4.8
New Mexico,2006,5,913119,62.6,874072,59.9,39047,4.3
New York,2006,5,9538316,63.2,9093999,60.3,444317,4.7
New York city,2006,5,3830823,59.3,3636814,56.3,194009,5.1
North Carolina,2006,5,4441640,66.3,4217778,62.9,223862,5.0
North Dakota,2006,5,361347,73.2,350121,70.9,11226,3.1
Ohio,2006,5,5936851,67.1,5621439,63.5,315412,5.3
Oklahoma,2006,5,1710449,63.7,1644742,61.2,65707,3.8
Oregon,2006,5,1875141,65.3,1774854,61.8,100287,5.3
Pennsylvania,2006,5,6288804,64.4,5990267,61.4,298537,4.7
Rhode Island,2006,5,571288,68.2,540727,64.6,30561,5.3
South Carolina,2006,5,2143551,65.0,1992605,60.4,150946,7.0
South Dakota,2006,5,431321,72.4,418628,70.2,12693,2.9
Tennessee,2006,5,3008468,64.2,2842377,60.7,166091,5.5
Texas,2006,5,11316310,66.8,10726117,63.3,590193,5.2
Utah,2006,5,1325529,72.5,1286032,70.3,39497,3.0
Vermont,2006,5,354749,71.1,341898,68.5,12851,3.6
Virginia,2006,5,3965991,68.6,3834431,66.4,131560,3.3
Washington,2006,5,3318875,67.7,3152061,64.3,166814,5.0
West Virginia,2006,5,804340,55.9,762671,53.0,41669,5.2
Wisconsin,2006,5,3059089,70.8,2919686,67.6,139403,4.6
Wyoming,2006,5,283567,71.8,275179,69.7,8388,3.0
Alabama,2006,6,2167159,61.6,2079399,59.1,87760,4.0
Alaska,2006,6,349037,71.2,325825,66.5,23212,6.7
Arizona,2006,6,2967768,64.2,2837632,61.3,130136,4.4
Arkansas,2006,6,1346705,62.9,1274991,59.5,71714,5.3
California,2006,6,17635569,65.3,16770248,62.1,865321,4.9
Los Angeles County,2006,6,4788555,64.9,4559158,61.8,229397,4.8
Colorado,2006,6,2641282,73.0,2525693,69.8,115589,4.4
Connecticut,2006,6,1828775,67.9,1747945,64.9,80830,4.4
Delaware,2006,6,442683,67.4,425140,64.7,17543,4.0
District of Columbia,2006,6,320029,68.1,299536,63.7,20493,6.4
Florida,2006,6,8913367,63.0,8696519,61.4,216848,2.4
Georgia,2006,6,4705063,68.1,4464013,64.6,241050,5.1
Hawaii,2006,6,634758,66.1,617722,64.3,17036,2.7
Idaho,2006,6,742774,68.4,717041,66.1,25733,3.5
Illinois,2006,6,6503286,67.3,6210984,64.2,292302,4.5
Indiana,2006,6,3235953,67.5,3072514,64.1,163439,5.1
Iowa,2006,6,1656339,72.3,1596192,69.7,60147,3.6
Kansas,2006,6,1464180,70.4,1399759,67.3,64421,4.4
Kentucky,2006,6,2020968,62.3,1905580,58.7,115388,5.7
Louisiana,2006,6,1992413,62.4,1915199,60.0,77214,3.9
Maine,2006,6,700153,66.7,667096,63.5,33057,4.7
Maryland,2006,6,2985290,69.6,2857042,66.6,128248,4.3
Massachusetts,2006,6,3408276,67.0,3246530,63.8,161746,4.7
Michigan,2006,6,5058880,65.2,4701332,60.6,357548,7.1
Minnesota,2006,6,2882243,72.6,2769472,69.8,112771,3.9
Mississippi,2006,6,1277358,59.4,1197221,55.7,80137,6.3
Missouri,2006,6,3033601,67.6,2886066,64.3,147535,4.9
Montana,2006,6,496176,67.1,479335,64.9,16841,3.4
Nebraska,2006,6,970087,72.8,940667,70.6,29420,3.0
Nevada,2006,6,1288880,68.5,1235957,65.7,52923,4.1
New Hampshire,2006,6,731464,70.9,706031,68.4,25433,3.5
New Jersey,2006,6,4437157,66.7,4224916,63.5,212241,4.8
New Mexico,2006,6,914427,62.6,875099,59.9,39328,4.3
New York,2006,6,9530898,63.2,9090653,60.2,440245,4.6
New York city,2006,6,3827854,59.2,3637111,56.2,190743,5.0
North Carolina,2006,6,4455650,66.4,4227934,63.0,227716,5.1
North Dakota,2006,6,361937,73.3,350670,71.0,11267,3.1
Ohio,2006,6,5950887,67.2,5631674,63.6,319213,5.4
Oklahoma,2006,6,1711998,63.7,1645917,61.2,66081,3.9
Oregon,2006,6,1879552,65.4,1778796,61.9,100756,5.4
Pennsylvania,2006,6,6295098,64.5,5994139,61.4,300959,4.8
Rhode Island,2006,6,571775,68.3,541227,64.6,30548,5.3
South Carolina,2006,6,2145543,65.0,1995143,60.4,150400,7.0
South Dakota,2006,6,432138,72.4,419282,70.3,12856,3.0
Tennessee,2006,6,3021272,64.4,2854682,60.9,166590,5.5
Texas,2006,6,11335374,66.7,10749064,63.2,586310,5.2
Utah,2006,6,1329902,72.5,1291669,70.5,38233,2.9
Vermont,2006,6,355183,71.1,342044,68.5,13139,3.7
Virginia,2006,6,3971300,68.6,3838785,66.4,132515,3.3
Washington,2006,6,3326358,67.7,3158117,64.3,168241,5.1
West Virginia,2006,6,805217,55.9,762682,53.0,42535,5.3
Wisconsin,2006,6,3064326,70.9,2923138,67.6,141188,4.6
Wyoming,2006,6,284276,71.9,275795,69.7,8481,3.0
Alabama,2006,7,2171367,61.6,2084065,59.1,87302,4.0
Alaska,2006,7,349357,71.2,326290,66.5,23067,6.6
Arizona,2006,7,2977028,64.2,2847274,61.4,129754,4.4
Arkansas,2006,7,1346289,62.8,1274581,59.4,71708,5.3
California,2006,7,17650474,65.4,16786840,62.2,863634,4.9
Los Angeles County,2006,7,4782941,64.8,4554572,61.8,228369,4.8
Colorado,2006,7,2647155,73.0,2532065,69.9,115090,4.3
Connecticut,2006,7,1830942,68.0,1750241,65.0,80701,4.4
Delaware,2006,7,442992,67.3,425528,64.7,17464,3.9
District of Columbia,2006,7,320865,68.3,300268,63.9,20597,6.4
Florida,2006,7,8938216,63.0,8719152,61.5,219064,2.5
Georgia,2006,7,4717188,68.2,4476911,64.7,240277,5.1
Hawaii,2006,7,635731,66.2,619244,64.5,16487,2.6
Idaho,2006,7,743753,68.4,718495,66.1,25258,3.4
Illinois,2006,7,6519819,67.4,6230966,64.4,288853,4.4
Indiana,2006,7,3236278,67.5,3072207,64.0,164071,5.1
Iowa,2006,7,1657590,72.3,1596824,69.7,60766,3.7
Kansas,2006,7,1467807,70.6,1403581,67.5,64226,4.4
Kentucky,2006,7,2025779,62.4,1910088,58.8,115691,5.7
Louisiana,2006,7,1994902,62.4,1917341,60.0,77561,3.9
Maine,2006,7,701038,66.7,667451,63.5,33587,4.8
Maryland,2006,7,2988845,69.6,2859174,66.6,129671,4.3
Massachusetts,2006,7,3413405,67.1,3251310,63.9,162095,4.7
Michigan,2006,7,5055515,65.1,4696148,60.5,359367,7.1
Minnesota,2006,7,2883675,72.6,2769850,69.7,113825,3.9
Mississippi,2006,7,1280178,59.4,1199699,55.7,80479,6.3
Missouri,2006,7,3039402,67.7,2890439,64.4,148963,4.9
Montana,2006,7,496676,67.1,479942,64.9,16734,3.4
Nebraska,2006,7,971231,72.8,941724,70.6,29507,3.0
Nevada,2006,7,1294646,68.6,1241605,65.8,53041,4.1
New Hampshire,2006,7,732649,70.9,706839,68.4,25810,3.5
New Jersey,2006,7,4438357,66.7,4228376,63.5,209981,4.7
New Mexico,2006,7,915559,62.6,876198,59.9,39361,4.3
New York,2006,7,9520777,63.1,9087715,60.2,433062,4.5
New York city,2006,7,3824122,59.1,3637962,56.2,186160,4.9
North Carolina,2006,7,4469761,66.5,4238151,63.0,231610,5.2
North Dakota,2006,7,362649,73.4,351322,71.1,11327,3.1
Ohio,2006,7,5964470,67.3,5641744,63.7,322726,5.4
Oklahoma,2006,7,1713704,63.7,1647247,61.2,66457,3.9
Oregon,2006,7,1883930,65.5,1782598,61.9,101332,5.4
Pennsylvania,2006,7,6300948,64.5,5999284,61.4,301664,4.8
Rhode Island,2006,7,572139,68.3,541730,64.7,30409,5.3
South Carolina,2006,7,2147804,64.9,1998767,60.4,149037,6.9
South Dakota,2006,7,433034,72.5,419998,70.3,13036,3.0
Tennessee,2006,7,3031107,64.5,2865935,61.0,165172,5.4
Texas,2006,7,11351838,66.6,10775124,63.2,576714,5.1
Utah,2006,7,1334478,72.6,1297521,70.6,36957,2.8
Vermont,2006,7,355703,71.2,342294,68.5,13409,3.8
Virginia,2006,7,3976954,68.7,3843635,66.4,133319,3.4
Washington,2006,7,3333760,67.8,3165012,64.3,168748,5.1
West Virginia,2006,7,806015,56.0,762889,53.0,43126,5.4
Wisconsin,2006,7,3069428,71.0,2926323,67.7,143105,4.7
Wyoming,2006,7,285048,72.0,276434,69.8,8614,3.0
Alabama,2006,8,2176026,61.7,2089301,59.2,86725,4.0
Alaska,2006,8,349634,71.2,326706,66.5,22928,6.6
Arizona,2006,8,2986508,64.2,2857798,61.5,128710,4.3
Arkansas,2006,8,1346217,62.7,1274701,59.4,71516,5.3
California,2006,8,17671419,65.4,16810113,62.2,861306,4.9
Los Angeles County,2006,8,4780454,64.8,4553424,61.7,227030,4.7
Colorado,2006,8,2652385,73.1,2538867,69.9,113518,4.3
Connecticut,2006,8,1833746,68.0,1753195,65.0,80551,4.4
Delaware,2006,8,443425,67.3,426171,64.7,17254,3.9
District of Columbia,2006,8,321679,68.4,301037,64.0,20642,6.4
Florida,2006,8,8964208,63.2,8742603,61.6,221605,2.5
Georgia,2006,8,4730491,68.2,4491354,64.8,239137,5.1
Hawaii,2006,8,636833,66.2,621045,64.6,15788,2.5
Idaho,2006,8,745184,68.4,720255,66.1,24929,3.3
Illinois,2006,8,6537794,67.5,6251061,64.6,286733,4.4
Indiana,2006,8,3237482,67.4,3073727,64.0,163755,5.1
Iowa,2006,8,1659099,72.4,1597910,69.7,61189,3.7
Kansas,2006,8,1471727,70.7,1407676,67.6,64051,4.4
Kentucky,2006,8,2031652,62.5,1915782,58.9,115870,5.7
Louisiana,2006,8,1998749,62.4,1920481,59.9,78268,3.9
Maine,2006,8,702011,66.8,668042,63.5,33969,4.8
Maryland,2006,8,2992402,69.6,2862631,66.6,129771,4.3
Massachusetts,2006,8,3418840,67.1,3256631,63.9,162209,4.7
Michigan,2006,8,5052872,65.1,4691989,60.4,360883,7.1
Minnesota,2006,8,2887166,72.6,2771111,69.7,116055,4.0
Mississippi,2006,8,1283338,59.5,1202508,55.8,80830,6.3
Missouri,2006,8,3045228,67.8,2895141,64.4,150087,4.9
Montana,2006,8,496874,67.1,480340,64.8,16534,3.3
Nebraska,2006,8,972530,72.9,943039,70.7,29491,3.0
Nevada,2006,8,1300611,68.8,1247515,66.0,53096,4.1
New Hampshire,2006,8,733885,71.0,707684,68.4,26201,3.6
New Jersey,2006,8,4440260,66.7,4233913,63.6,206347,4.6
New Mexico,2006,8,916599,62.6,877554,59.9,39045,4.3
New York,2006,8,9511488,63.0,9086770,60.2,424718,4.5
New York city,2006,8,3821311,59.0,3639845,56.2,181466,4.7
North Carolina,2006,8,4483993,66.5,4248964,63.1,235029,5.2
North Dakota,2006,8,363565,73.6,352156,71.3,11409,3.1
Ohio,2006,8,5978031,67.5,5652208,63.8,325823,5.5
Oklahoma,2006,8,1715726,63.7,1648772,61.2,66954,3.9
Oregon,2006,8,1888427,65.5,1786546,62.0,101881,5.4
Pennsylvania,2006,8,6307766,64.5,6007146,61.5,300620,4.8
Rhode Island,2006,8,572453,68.4,542291,64.8,30162,5.3
South Carolina,2006,8,2151562,64.9,2004201,60.5,147361,6.8
South Dakota,2006,8,433934,72.6,420774,70.3,13160,3.0
Tennessee,2006,8,3038347,64.6,2876327,61.2,162020,5.3
Texas,2006,8,11367207,66.6,10804130,63.3,563077,5.0
Utah,2006,8,1339519,72.7,1303704,70.7,35815,2.7
Vermont,2006,8,356239,71.3,342595,68.5,13644,3.8
Virginia,2006,8,3983653,68.7,3849897,66.4,133756,3.4
Washington,2006,8,3341319,67.8,3172753,64.4,168566,5.0
West Virginia,2006,8,806777,56.0,763493,53.0,43284,5.4
Wisconsin,2006,8,3074307,71.0,2929287,67.7,145020,4.7
Wyoming,2006,8,285874,72.1,277156,69.9,8718,3.0
Alabama,2006,9,2180689,61.8,2094591,59.3,86098,3.9
Alaska,2006,9,349874,71.1,327071,66.5,22803,6.5
Arizona,2006,9,2995813,64.3,2868713,61.5,127100,4.2
Arkansas,2006,9,1346678,62.7,1275263,59.4,71415,5.3
California,2006,9,17699166,65.4,16838653,62.2,860513,4.9
Los Angeles County,2006,9,4782464,64.8,4556670,61.7,225794,4.7
Colorado,2006,9,2656964,73.1,2545785,70.0,111179,4.2
Connecticut,2006,9,1836913,68.1,1756417,65.1,80496,4.4
Delaware,2006,9,443955,67.3,427015,64.7,16940,3.8
District of Columbia,2006,9,322404,68.5,301755,64.1,20649,6.4
Florida,2006,9,8990679,63.3,8765814,61.7,224865,2.5
Georgia,2006,9,4744336,68.3,4506631,64.9,237705,5.0
Hawaii,2006,9,637954,66.3,622790,64.7,15164,2.4
Idaho,2006,9,746840,68.4,722205,66.1,24635,3.3
Illinois,2006,9,6555585,67.7,6268521,64.7,287064,4.4
Indiana,2006,9,3238710,67.4,3075872,64.0,162838,5.0
Iowa,2006,9,1661018,72.4,1599582,69.7,61436,3.7
Kansas,2006,9,1475958,70.9,1411988,67.8,63970,4.3
Kentucky,2006,9,2038086,62.6,1922152,59.1,115934,5.7
Louisiana,2006,9,2003637,62.3,1924375,59.9,79262,4.0
Maine,2006,9,703009,66.8,668866,63.6,34143,4.9
Maryland,2006,9,2995782,69.7,2866926,66.7,128856,4.3
Massachusetts,2006,9,3424172,67.2,3261883,64.0,162289,4.7
Michigan,2006,9,5050900,65.0,4688983,60.4,361917,7.2
Minnesota,2006,9,2892049,72.7,2772961,69.7,119088,4.1
Mississippi,2006,9,1286478,59.6,1205340,55.8,81138,6.3
Missouri,2006,9,3050585,67.8,2899808,64.5,150777,4.9
Montana,2006,9,497008,67.0,480753,64.8,16255,3.3
Nebraska,2006,9,973920,72.9,944455,70.7,29465,3.0
Nevada,2006,9,1306774,68.9,1253515,66.1,53259,4.1
New Hampshire,2006,9,735101,71.0,708478,68.5,26623,3.6
New Jersey,2006,9,4442947,66.7,4240957,63.7,201990,4.5
New Mexico,2006,9,917536,62.6,879114,60.0,38422,4.2
New York,2006,9,9505259,62.9,9087981,60.1,417278,4.4
New York city,2006,9,3820605,59.0,3642697,56.2,177908,4.7
North Carolina,2006,9,4497305,66.6,4259872,63.1,237433,5.3
North Dakota,2006,9,364623,73.8,353145,71.4,11478,3.1
Ohio,2006,9,5990760,67.6,5662364,63.9,328396,5.5
Oklahoma,2006,9,1718058,63.7,1650292,61.2,67766,3.9
Oregon,2006,9,1892988,65.6,1790709,62.0,102279,5.4
Pennsylvania,2006,9,6315598,64.6,6017276,61.5,298322,4.7
Rhode Island,2006,9,572774,68.4,542951,64.8,29823,5.2
South Carolina,2006,9,2157039,65.0,2011196,60.6,145843,6.8
South Dakota,2006,9,434769,72.6,421551,70.4,13218,3.0
Tennessee,2006,9,3043505,64.6,2885641,61.3,157864,5.2
Texas,2006,9,11381736,66.5,10832912,63.3,548824,4.8
Utah,2006,9,1344922,72.8,1310071,70.9,34851,2.6
Vermont,2006,9,356647,71.3,342812,68.5,13835,3.9
Virginia,2006,9,3991266,68.8,3857489,66.5,133777,3.4
Washington,2006,9,3348767,67.8,3180801,64.4,167966,5.0
West Virginia,2006,9,807404,56.0,764376,53.0,43028,5.3
Wisconsin,2006,9,3078965,71.1,2932001,67.7,146964,4.8
Wyoming,2006,9,286704,72.1,277957,69.9,8747,3.1
Alabama,2006,10,2184587,61.8,2099223,59.4,85364,3.9
Alaska,2006,10,350052,71.1,327406,66.5,22646,6.5
Arizona,2006,10,3004252,64.3,2879213,61.6,125039,4.2
Arkansas,2006,10,1347720,62.7,1276360,59.3,71360,5.3
California,2006,10,17731148,65.5,16870354,62.3,860794,4.9
Los Angeles County,2006,10,4788553,64.9,4563800,61.8,224753,4.7
Colorado,2006,10,2660820,73.0,2552545,70.1,108275,4.1
Connecticut,2006,10,1840211,68.2,1759811,65.2,80400,4.4
Delaware,2006,10,444511,67.3,427949,64.8,16562,3.7
District of Columbia,2006,10,323040,68.6,302460,64.2,20580,6.4
Florida,2006,10,9016846,63.4,8788180,61.8,228666,2.5
Georgia,2006,10,4757415,68.3,4521848,64.9,235567,5.0
Hawaii,2006,10,638975,66.4,624209,64.8,14766,2.3
Idaho,2006,10,748469,68.4,724217,66.2,24252,3.2
Illinois,2006,10,6570891,67.8,6281776,64.8,289115,4.4
Indiana,2006,10,3239074,67.4,3078111,64.0,160963,5.0
Iowa,2006,10,1662986,72.4,1601611,69.8,61375,3.7
Kansas,2006,10,1478938,71.0,1415081,67.9,63857,4.3
Kentucky,2006,10,2043869,62.8,1928275,59.2,115594,5.7
Louisiana,2006,10,2009343,62.4,1928865,59.9,80478,4.0
Maine,2006,10,703851,66.9,669845,63.6,34006,4.8
Maryland,2006,10,2998354,69.7,2871256,66.7,127098,4.2
Massachusetts,2006,10,3428730,67.2,3266745,64.0,161985,4.7
Michigan,2006,10,5048765,65.0,4687689,60.3,361076,7.2
Minnesota,2006,10,2897203,72.7,2775300,69.7,121903,4.2
Mississippi,2006,10,1289198,59.7,1207813,55.9,81385,6.3
Missouri,2006,10,3054914,67.9,2904208,64.5,150706,4.9
Montana,2006,10,497327,66.9,481487,64.8,15840,3.2
Nebraska,2006,10,975160,73.0,945823,70.8,29337,3.0
Nevada,2006,10,1312862,69.1,1259390,66.3,53472,4.1
New Hampshire,2006,10,736259,71.1,709278,68.5,26981,3.7
New Jersey,2006,10,4445225,66.7,4248153,63.7,197072,4.4
New Mexico,2006,10,918338,62.6,880849,60.0,37489,4.1
New York,2006,10,9502793,62.8,9092269,60.1,410524,4.3
New York city,2006,10,3822478,58.9,3646976,56.2,175502,4.6
North Carolina,2006,10,4508874,66.6,4271262,63.1,237612,5.3
North Dakota,2006,10,365696,73.9,354220,71.6,11476,3.1
Ohio,2006,10,6001365,67.6,5672001,63.9,329364,5.5
Oklahoma,2006,10,1720521,63.7,1651829,61.2,68692,4.0
Oregon,2006,10,1897606,65.6,1795512,62.1,102094,5.4
Pennsylvania,2006,10,6323451,64.6,6028619,61.6,294832,4.7
Rhode Island,2006,10,573073,68.4,543752,64.9,29321,5.1
South Carolina,2006,10,2163454,65.0,2019114,60.7,144340,6.7
South Dakota,2006,10,435472,72.6,422293,70.4,13179,3.0
Tennessee,2006,10,3047672,64.6,2894538,61.4,153134,5.0
Texas,2006,10,11394861,66.5,10859232,63.3,535629,4.7
Utah,2006,10,1350404,72.9,1316400,71.1,34004,2.5
Vermont,2006,10,356823,71.3,342892,68.5,13931,3.9
Virginia,2006,10,3999235,68.8,3866151,66.5,133084,3.3
Washington,2006,10,3355850,67.9,3189139,64.5,166711,5.0
West Virginia,2006,10,807734,56.0,765299,53.1,42435,5.3
Wisconsin,2006,10,3083012,71.1,2934814,67.7,148198,4.8
Wyoming,2006,10,287463,72.2,278828,70.0,8635,3.0
Alabama,2006,11,2187215,61.8,2102582,59.4,84633,3.9
Alaska,2006,11,350202,71.1,327755,66.5,22447,6.4
Arizona,2006,11,3011163,64.3,2888274,61.7,122889,4.1
Arkansas,2006,11,1349135,62.7,1277814,59.4,71321,5.3
California,2006,11,17763499,65.5,16900814,62.4,862685,4.9
Los Angeles County,2006,11,4797331,65.0,4572815,61.9,224516,4.7
Colorado,2006,11,2663422,73.0,2558561,70.1,104861,3.9
Connecticut,2006,11,1843373,68.3,1763165,65.3,80208,4.4
Delaware,2006,11,444980,67.2,428750,64.8,16230,3.6
District of Columbia,2006,11,323706,68.7,303280,64.4,20426,6.3
Florida,2006,11,9041667,63.5,8808471,61.9,233196,2.6
Georgia,2006,11,4768552,68.4,4535543,65.0,233009,4.9
Hawaii,2006,11,639733,66.4,625059,64.9,14674,2.3
Idaho,2006,11,749884,68.4,726133,66.2,23751,3.2
Illinois,2006,11,6581859,67.8,6289937,64.8,291922,4.4
Indiana,2006,11,3238109,67.3,3079821,64.0,158288,4.9
Iowa,2006,11,1664385,72.4,1603265,69.8,61120,3.7
Kansas,2006,11,1484594,71.2,1420985,68.1,63609,4.3
Kentucky,2006,11,2047981,62.9,1933255,59.3,114726,5.6
Louisiana,2006,11,2015113,62.4,1933463,59.8,81650,4.1
Maine,2006,11,704327,66.9,670736,63.7,33591,4.8
Maryland,2006,11,2999434,69.6,2874673,66.7,124761,4.2
Massachusetts,2006,11,3432017,67.2,3270894,64.0,161123,4.7
Michigan,2006,11,5045048,64.9,4686860,60.3,358188,7.1
Minnesota,2006,11,2901587,72.8,2777537,69.6,124050,4.3
Mississippi,2006,11,1291444,59.7,1209651,56.0,81793,6.3
Missouri,2006,11,3057697,67.9,2907850,64.5,149847,4.9
Montana,2006,11,498025,66.9,482717,64.9,15308,3.1
Nebraska,2006,11,975966,73.0,947007,70.8,28959,3.0
Nevada,2006,11,1318570,69.2,1264827,66.4,53743,4.1
New Hampshire,2006,11,737245,71.1,710011,68.5,27234,3.7
New Jersey,2006,11,4445641,66.7,4253587,63.8,192054,4.3
New Mexico,2006,11,919054,62.5,882644,60.0,36410,4.0
New York,2006,11,9503075,62.8,9098570,60.1,404505,4.3
New York city,2006,11,3826440,58.9,3652373,56.3,174067,4.5
North Carolina,2006,11,4517303,66.6,4281978,63.1,235325,5.2
North Dakota,2006,11,366612,74.1,355207,71.8,11405,3.1
Ohio,2006,11,6008981,67.7,5680298,64.0,328683,5.5
Oklahoma,2006,11,1722979,63.8,1653494,61.2,69485,4.0
Oregon,2006,11,1901918,65.7,1800823,62.2,101095,5.3
Pennsylvania,2006,11,6329667,64.6,6039226,61.7,290441,4.6
Rhode Island,2006,11,573244,68.4,544562,65.0,28682,5.0
South Carolina,2006,11,2169409,65.1,2026695,60.8,142714,6.6
South Dakota,2006,11,435997,72.6,422938,70.5,13059,3.0
Tennessee,2006,11,3050954,64.6,2902791,61.5,148163,4.9
Texas,2006,11,11405690,66.4,10881093,63.4,524597,4.6
Utah,2006,11,1355691,73.0,1322348,71.2,33343,2.5
Vermont,2006,11,356762,71.3,342822,68.5,13940,3.9
Virginia,2006,11,4006703,68.9,3874981,66.6,131722,3.3
Washington,2006,11,3362320,67.9,3197583,64.6,164737,4.9
West Virginia,2006,11,807634,56.0,765992,53.1,41642,5.2
Wisconsin,2006,11,3085923,71.1,2937397,67.7,148526,4.8
Wyoming,2006,11,288093,72.2,279707,70.1,8386,2.9
Alabama,2006,12,2188157,61.8,2104100,59.4,84057,3.8
Alaska,2006,12,350246,71.0,328038,66.5,22208,6.3
Arizona,2006,12,3015741,64.2,2894953,61.7,120788,4.0
Arkansas,2006,12,1350471,62.7,1279168,59.4,71303,5.3
California,2006,12,17791249,65.6,16924622,62.4,866627,4.9
Los Angeles County,2006,12,4806691,65.1,4581422,62.0,225269,4.7
Colorado,2006,12,2664298,72.9,2563203,70.1,101095,3.8
Connecticut,2006,12,1845968,68.4,1766016,65.4,79952,4.3
Delaware,2006,12,445217,67.2,429217,64.8,16000,3.6
District of Columbia,2006,12,324467,68.8,304268,64.5,20199,6.2
Florida,2006,12,9063204,63.6,8824665,61.9,238539,2.6
Georgia,2006,12,4776763,68.3,4546384,65.0,230379,4.8
Hawaii,2006,12,640049,66.4,625186,64.8,14863,2.3
Idaho,2006,12,750946,68.3,727798,66.2,23148,3.1
Illinois,2006,12,6587537,67.9,6292132,64.8,295405,4.5
Indiana,2006,12,3234565,67.2,3079521,64.0,155044,4.8
Iowa,2006,12,1664469,72.4,1603613,69.8,60856,3.7
Kansas,2006,12,1485269,71.2,1421997,68.1,63272,4.3
Kentucky,2006,12,2049777,62.9,1936376,59.4,113401,5.5
Louisiana,2006,12,2019911,62.4,1937175,59.8,82736,4.1
Maine,2006,12,704222,66.8,671172,63.7,33050,4.7
Maryland,2006,12,2998285,69.6,2876346,66.7,121939,4.1
Massachusetts,2006,12,3433704,67.2,3273958,64.1,159746,4.7
Michigan,2006,12,5038631,64.8,4684597,60.3,354034,7.0
Minnesota,2006,12,2904402,72.8,2778889,69.6,125513,4.3
Mississippi,2006,12,1292752,59.8,1210528,56.0,82224,6.4
Missouri,2006,12,3058416,67.8,2909972,64.5,148444,4.9
Montana,2006,12,499089,67.0,484328,65.0,14761,3.0
Nebraska,2006,12,976178,73.0,947798,70.9,28380,2.9
Nevada,2006,12,1323560,69.3,1269442,66.5,54118,4.1
New Hampshire,2006,12,737892,71.1,710530,68.5,27362,3.7
New Jersey,2006,12,4443461,66.6,4256088,63.8,187373,4.2
New Mexico,2006,12,919560,62.5,884218,60.1,35342,3.8
New York,2006,12,9502870,62.8,9102977,60.1,399893,4.2
New York city,2006,12,3830846,59.0,3657213,56.3,173633,4.5
North Carolina,2006,12,4521187,66.5,4289779,63.1,231408,5.1
North Dakota,2006,12,367189,74.2,355898,71.9,11291,3.1
Ohio,2006,12,6013359,67.7,5686100,64.0,327259,5.4
Oklahoma,2006,12,1725014,63.8,1654984,61.2,70030,4.1
Oregon,2006,12,1905040,65.7,1805631,62.3,99409,5.2
Pennsylvania,2006,12,6332288,64.6,6046688,61.7,285600,4.5
Rhode Island,2006,12,573158,68.4,545163,65.1,27995,4.9
South Carolina,2006,12,2173063,65.1,2032325,60.9,140738,6.5
South Dakota,2006,12,436286,72.6,423393,70.5,12893,3.0
Tennessee,2006,12,3052604,64.6,2909137,61.6,143467,4.7
Texas,2006,12,11412317,66.3,10896648,63.3,515669,4.5
Utah,2006,12,1360400,73.1,1327488,71.3,32912,2.4
Vermont,2006,12,356469,71.2,342563,68.4,13906,3.9
Virginia,2006,12,4012705,68.9,3882705,66.7,130000,3.2
Washington,2006,12,3367727,67.9,3205651,64.6,162076,4.8
West Virginia,2006,12,806919,55.9,766149,53.1,40770,5.1
Wisconsin,2006,12,3087289,71.1,2939043,67.7,148246,4.8
Wyoming,2006,12,288545,72.2,280486,70.2,8059,2.8
Alabama,2007,1,2187339,61.7,2103550,59.4,83789,3.8
Alaska,2007,1,350083,70.9,328102,66.5,21981,6.3
Arizona,2007,1,3017695,64.1,2899008,61.6,118687,3.9
Arkansas,2007,1,1351331,62.7,1279989,59.4,71342,5.3
California,2007,1,17811829,65.6,16938382,62.4,873447,4.9
Los Angeles County,2007,1,4814860,65.2,4587747,62.1,227113,4.7
Colorado,2007,1,2663897,72.8,2566479,70.1,97418,3.7
Connecticut,2007,1,1848030,68.4,1768257,65.5,79773,4.3
Delaware,2007,1,445183,67.1,429285,64.7,15898,3.6
District of Columbia,2007,1,325086,68.9,305135,64.7,19951,6.1
Florida,2007,1,9079865,63.6,8835015,61.9,244850,2.7
Georgia,2007,1,4781979,68.3,4553801,65.0,228178,4.8
Hawaii,2007,1,639907,66.3,624680,64.7,15227,2.4
Idaho,2007,1,751704,68.3,729172,66.2,22532,3.0
Illinois,2007,1,6589487,67.8,6289431,64.8,300056,4.6
Indiana,2007,1,3227858,67.0,3076193,63.8,151665,4.7
Iowa,2007,1,1663289,72.3,1602493,69.7,60796,3.7
Kansas,2007,1,1485282,71.1,1422275,68.1,63007,4.2
Kentucky,2007,1,2049214,62.8,1937338,59.4,111876,5.5
Louisiana,2007,1,2022840,62.3,1939101,59.7,83739,4.1
Maine,2007,1,703506,66.7,670974,63.6,32532,4.6
Maryland,2007,1,2994895,69.5,2875951,66.7,118944,4.0
Massachusetts,2007,1,3434072,67.1,3275858,64.1,158214,4.6
Michigan,2007,1,5029796,64.7,4679591,60.2,350205,7.0
Minnesota,2007,1,2905237,72.7,2778670,69.6,126567,4.4
Mississippi,2007,1,1292826,59.7,1210328,55.9,82498,6.4
Missouri,2007,1,3057457,67.7,2910257,64.5,147200,4.8
Montana,2007,1,500327,67.1,485966,65.2,14361,2.9
Nebraska,2007,1,976001,72.9,948140,70.8,27861,2.9
Nevada,2007,1,1327708,69.3,1273015,66.5,54693,4.1
New Hampshire,2007,1,738127,71.1,710750,68.4,27377,3.7
New Jersey,2007,1,4439278,66.5,4255550,63.8,183728,4.1
New Mexico,2007,1,919697,62.4,885300,60.1,34397,3.7
New York,2007,1,9499799,62.7,9102241,60.1,397558,4.2
New York city,2007,1,3834096,59.0,3659766,56.3,174330,4.5
North Carolina,2007,1,4521375,66.4,4294318,63.1,227057,5.0
North Dakota,2007,1,367404,74.2,356225,72.0,11179,3.0
Ohio,2007,1,6015798,67.7,5688698,64.0,327100,5.4
Oklahoma,2007,1,1726172,63.8,1655845,61.2,70327,4.1
Oregon,2007,1,1906671,65.7,1809169,62.3,97502,5.1
Pennsylvania,2007,1,6331494,64.6,6050069,61.7,281425,4.4
Rhode Island,2007,1,572807,68.4,545438,65.1,27369,4.8
South Carolina,2007,1,2173719,65.0,2035325,60.9,138394,6.4
South Dakota,2007,1,436333,72.5,423609,70.4,12724,2.9
Tennessee,2007,1,3051958,64.5,2912489,61.6,139469,4.6
Texas,2007,1,11413662,66.2,10905100,63.3,508562,4.5
Utah,2007,1,1364352,73.1,1331564,71.4,32788,2.4
Vermont,2007,1,355976,71.0,342115,68.3,13861,3.9
Virginia,2007,1,4016723,68.9,3888251,66.7,128472,3.2
Washington,2007,1,3371978,67.9,3213005,64.7,158973,4.7
West Virginia,2007,1,805561,55.8,765642,53.1,39919,5.0
Wisconsin,2007,1,3087107,71.1,2939387,67.7,147720,4.8
Wyoming,2007,1,288825,72.2,281087,70.3,7738,2.7
Alabama,2007,2,2185202,61.6,2101371,59.3,83831,3.8
Alaska,2007,2,349811,70.8,327999,66.4,21812,6.2
Arizona,2007,2,3017647,64.0,2901286,61.5,116361,3.9
Arkansas,2007,2,1351478,62.6,1279970,59.3,71508,5.3
California,2007,2,17826788,65.6,16943822,62.4,882966,5.0
Los Angeles County,2007,2,4821968,65.3,4592074,62.2,229894,4.8
Colorado,2007,2,2663475,72.7,2569153,70.1,94322,3.5
Connecticut,2007,2,1849724,68.4,1769948,65.5,79776,4.3
Delaware,2007,2,444987,67.0,429060,64.6,15927,3.6
District of Columbia,2007,2,325363,68.9,305635,64.8,19728,6.1
Florida,2007,2,9091891,63.7,8839714,61.9,252177,2.8
Georgia,2007,2,4785242,68.2,4558332,65.0,226910,4.7
Hawaii,2007,2,639382,66.2,623747,64.6,15635,2.4
Idaho,2007,2,752358,68.2,730389,66.2,21969,2.9
Illinois,2007,2,6591137,67.8,6285513,64.7,305624,4.6
Indiana,2007,2,3218753,66.8,3070366,63.7,148387,4.6
Iowa,2007,2,1661602,72.2,1600672,69.6,60930,3.7
Kansas,2007,2,1484899,71.0,1422087,68.0,62812,4.2
Kentucky,2007,2,2046911,62.7,1936545,59.3,110366,5.4
Louisiana,2007,2,2023956,62.2,1939168,59.6,84788,4.2
Maine,2007,2,702423,66.6,670267,63.6,32156,4.6
Maryland,2007,2,2990228,69.3,2874136,66.6,116092,3.9
Massachusetts,2007,2,3433865,67.1,3277054,64.0,156811,4.6
Michigan,2007,2,5019800,64.6,4672378,60.1,347422,6.9
Minnesota,2007,2,2904324,72.6,2776911,69.5,127413,4.4
Mississippi,2007,2,1291912,59.7,1209476,55.8,82436,6.4
Missouri,2007,2,3055861,67.7,2909172,64.4,146689,4.8
Montana,2007,2,501476,67.2,487228,65.3,14248,2.8
Nebraska,2007,2,975808,72.9,948238,70.8,27570,2.8
Nevada,2007,2,1331183,69.4,1275701,66.5,55482,4.2
New Hampshire,2007,2,738051,71.0,710769,68.4,27282,3.7
New Jersey,2007,2,4434374,66.4,4252745,63.7,181629,4.1
New Mexico,2007,2,919575,62.3,885908,60.0,33667,3.7
New York,2007,2,9494831,62.6,9096946,60.0,397885,4.2
New York city,2007,2,3836227,59.0,3660161,56.2,176066,4.6
North Carolina,2007,2,4519599,66.3,4296091,63.0,223508,4.9
North Dakota,2007,2,367395,74.2,356305,72.0,11090,3.0
Ohio,2007,2,6017630,67.7,5689064,64.0,328566,5.5
Oklahoma,2007,2,1726322,63.8,1655815,61.2,70507,4.1
Oregon,2007,2,1906967,65.6,1811075,62.3,95892,5.0
Pennsylvania,2007,2,6328908,64.5,6050384,61.7,278524,4.4
Rhode Island,2007,2,572300,68.3,545375,65.1,26925,4.7
South Carolina,2007,2,2171850,64.9,2035894,60.8,135956,6.3
South Dakota,2007,2,436230,72.5,423663,70.4,12567,2.9
Tennessee,2007,2,3049020,64.4,2912944,61.5,136076,4.5
Texas,2007,2,11411958,66.1,10908743,63.2,503215,4.4
Utah,2007,2,1367666,73.1,1334719,71.4,32947,2.4
Vermont,2007,2,355401,70.9,341580,68.1,13821,3.9
Virginia,2007,2,4019179,68.9,3891877,66.7,127302,3.2
Washington,2007,2,3375862,67.9,3219836,64.7,156026,4.6
West Virginia,2007,2,803965,55.7,764782,53.0,39183,4.9
Wisconsin,2007,2,3086120,71.0,2938906,67.6,147214,4.8
Wyoming,2007,2,289039,72.1,281520,70.3,7519,2.6
Alabama,2007,3,2182257,61.5,2098155,59.1,84102,3.9
Alaska,2007,3,349471,70.7,327774,66.3,21697,6.2
Arizona,2007,3,3015955,63.8,2902281,61.4,113674,3.8
Arkansas,2007,3,1350887,62.6,1279107,59.2,71780,5.3
California,2007,3,17837732,65.6,16944145,62.3,893587,5.0
Los Angeles County,2007,3,4829313,65.4,4596451,62.2,232862,4.8
Colorado,2007,3,2664085,72.6,2572031,70.1,92054,3.5
Connecticut,2007,3,1850803,68.5,1770914,65.5,79889,4.3
Delaware,2007,3,444654,66.9,428670,64.5,15984,3.6
District of Columbia,2007,3,325327,68.9,305806,64.8,19521,6.0
Florida,2007,3,9099437,63.7,8839277,61.8,260160,2.9
Georgia,2007,3,4787416,68.1,4560839,64.9,226577,4.7
Hawaii,2007,3,638441,66.1,622449,64.4,15992,2.5
Idaho,2007,3,752994,68.1,731466,66.2,21528,2.9
Illinois,2007,3,6594491,67.8,6283126,64.6,311365,4.7
Indiana,2007,3,3208405,66.5,3063073,63.5,145332,4.5
Iowa,2007,3,1659975,72.1,1598932,69.5,61043,3.7
Kansas,2007,3,1484163,71.0,1421613,68.0,62550,4.2
Kentucky,2007,3,2043296,62.6,1934313,59.2,108983,5.3
Louisiana,2007,3,2023695,62.0,1937949,59.4,85746,4.2
Maine,2007,3,701102,66.5,669145,63.4,31957,4.6
Maryland,2007,3,2985200,69.2,2871826,66.5,113374,3.8
Massachusetts,2007,3,3433170,67.0,3277638,64.0,155532,4.5
Michigan,2007,3,5009740,64.5,4664185,60.0,345555,6.9
Minnesota,2007,3,2902138,72.5,2774014,69.3,128124,4.4
Mississippi,2007,3,1290406,59.6,1208538,55.8,81868,6.3
Missouri,2007,3,3054108,67.6,2907025,64.3,147083,4.8
Montana,2007,3,502396,67.2,487908,65.3,14488,2.9
Nebraska,2007,3,975800,72.8,948254,70.8,27546,2.8
Nevada,2007,3,1334075,69.3,1277645,66.4,56430,4.2
New Hampshire,2007,3,737807,70.9,710760,68.3,27047,3.7
New Jersey,2007,3,4429421,66.3,4248592,63.6,180829,4.1
New Mexico,2007,3,919257,62.2,886141,60.0,33116,3.6
New York,2007,3,9488991,62.6,9088533,59.9,400458,4.2
New York city,2007,3,3837718,58.9,3659140,56.2,178578,4.7
North Carolina,2007,3,4517170,66.1,4295713,62.9,221457,4.9
North Dakota,2007,3,367245,74.2,356219,71.9,11026,3.0
Ohio,2007,3,6018863,67.7,5688428,64.0,330435,5.5
Oklahoma,2007,3,1725376,63.7,1654906,61.1,70470,4.1
Oregon,2007,3,1906174,65.5,1811295,62.2,94879,5.0
Pennsylvania,2007,3,6325867,64.5,6049127,61.7,276740,4.4
Rhode Island,2007,3,571668,68.3,544930,65.1,26738,4.7
South Carolina,2007,3,2167855,64.6,2034333,60.6,133522,6.2
South Dakota,2007,3,436036,72.4,423614,70.3,12422,2.8
Tennessee,2007,3,3044434,64.2,2911363,61.4,133071,4.4
Texas,2007,3,11408395,66.0,10909724,63.1,498671,4.4
Utah,2007,3,1370319,73.1,1337078,71.3,33241,2.4
Vermont,2007,3,354803,70.8,341022,68.0,13781,3.9
Virginia,2007,3,4020557,68.9,3894124,66.7,126433,3.1
Washington,2007,3,3379685,67.9,3226114,64.8,153571,4.5
West Virginia,2007,3,802527,55.6,763964,52.9,38563,4.8
Wisconsin,2007,3,3084887,71.0,2938058,67.6,146829,4.8
Wyoming,2007,3,289270,72.1,281824,70.2,7446,2.6
Alabama,2007,4,2179466,61.4,2094744,59.0,84722,3.9
Alaska,2007,4,349168,70.6,327497,66.2,21671,6.2
Arizona,2007,4,3013261,63.6,2902557,61.3,110704,3.7
Arkansas,2007,4,1349996,62.5,1277800,59.1,72196,5.3
California,2007,4,17848998,65.6,16944007,62.3,904991,5.1
Los Angeles County,2007,4,4838268,65.5,4602584,62.3,235684,4.9
Colorado,2007,4,2666633,72.5,2575603,70.0,91030,3.4
Connecticut,2007,4,1851481,68.5,1771391,65.5,80090,4.3
Delaware,2007,4,444310,66.7,428349,64.3,15961,3.6
District of Columbia,2007,4,325132,68.8,305789,64.7,19343,5.9
Florida,2007,4,9103305,63.6,8834580,61.8,268725,3.0
Georgia,2007,4,4789823,68.0,4562579,64.8,227244,4.7
Hawaii,2007,4,637218,65.9,620930,64.2,16288,2.6
Idaho,2007,4,753743,68.1,732433,66.2,21310,2.8
Illinois,2007,4,6601114,67.9,6284088,64.6,317026,4.8
Indiana,2007,4,3198676,66.3,3055662,63.3,143014,4.5
Iowa,2007,4,1658797,72.0,1597745,69.4,61052,3.7
Kansas,2007,4,1483334,70.9,1421088,67.9,62246,4.2
Kentucky,2007,4,2039096,62.4,1931178,59.1,107918,5.3
Louisiana,2007,4,2022494,61.8,1936224,59.2,86270,4.3
Maine,2007,4,699674,66.3,667728,63.3,31946,4.6
Maryland,2007,4,2981141,69.0,2870098,66.5,111043,3.7
Massachusetts,2007,4,3432208,67.0,3277798,64.0,154410,4.5
Michigan,2007,4,5000964,64.3,4656111,59.9,344853,6.9
Minnesota,2007,4,2899693,72.4,2770677,69.2,129016,4.4
Mississippi,2007,4,1288973,59.5,1208054,55.7,80919,6.3
Missouri,2007,4,3052781,67.5,2904486,64.2,148295,4.9
Montana,2007,4,503141,67.3,488072,65.2,15069,3.0
Nebraska,2007,4,976138,72.8,948372,70.8,27766,2.8
Nevada,2007,4,1336648,69.3,1279106,66.3,57542,4.3
New Hampshire,2007,4,737554,70.9,710853,68.3,26701,3.6
New Jersey,2007,4,4425655,66.3,4244696,63.6,180959,4.1
New Mexico,2007,4,918787,62.1,886126,59.9,32661,3.6
New York,2007,4,9484728,62.5,9079753,59.8,404975,4.3
New York city,2007,4,3839669,58.9,3657959,56.1,181710,4.7
North Carolina,2007,4,4516257,65.9,4294922,62.7,221335,4.9
North Dakota,2007,4,367044,74.1,356032,71.9,11012,3.0
Ohio,2007,4,6019476,67.7,5686963,64.0,332513,5.5
Oklahoma,2007,4,1723712,63.6,1653537,61.0,70175,4.1
Oregon,2007,4,1905062,65.3,1810393,62.1,94669,5.0
Pennsylvania,2007,4,6324317,64.4,6048045,61.6,276272,4.4
Rhode Island,2007,4,570999,68.2,544147,65.0,26852,4.7
South Carolina,2007,4,2162781,64.4,2031551,60.5,131230,6.1
South Dakota,2007,4,435857,72.3,423544,70.2,12313,2.8
Tennessee,2007,4,3039561,64.0,2908711,61.3,130850,4.3
Texas,2007,4,11405711,65.9,10910668,63.0,495043,4.3
Utah,2007,4,1372517,73.0,1338904,71.3,33613,2.4
Vermont,2007,4,354210,70.6,340469,67.9,13741,3.9
Virginia,2007,4,4021773,68.8,3895919,66.7,125854,3.1
Washington,2007,4,3383635,67.8,3231633,64.8,152002,4.5
West Virginia,2007,4,801602,55.5,763516,52.9,38086,4.8
Wisconsin,2007,4,3084013,70.9,2937255,67.5,146758,4.8
Wyoming,2007,4,289584,72.1,282060,70.2,7524,2.6
Alabama,2007,5,2177514,61.3,2091810,58.9,85704,3.9
Alaska,2007,5,349067,70.5,327322,66.1,21745,6.2
Arizona,2007,5,3010820,63.4,2902959,61.2,107861,3.6
Arkansas,2007,5,1349262,62.4,1276423,59.0,72839,5.4
California,2007,5,17864179,65.6,16945471,62.2,918708,5.1
Los Angeles County,2007,5,4848649,65.6,4609818,62.4,238831,4.9
Colorado,2007,5,2671638,72.5,2580013,70.0,91625,3.4
Connecticut,2007,5,1852382,68.5,1771872,65.5,80510,4.3
Delaware,2007,5,444108,66.6,428254,64.2,15854,3.6
District of Columbia,2007,5,324944,68.7,305707,64.7,19237,5.9
Florida,2007,5,9104735,63.6,8826525,61.6,278210,3.1
Georgia,2007,5,4793806,67.9,4564652,64.7,229154,4.8
Hawaii,2007,5,635993,65.7,619428,64.0,16565,2.6
Idaho,2007,5,754736,68.0,733266,66.1,21470,2.8
Illinois,2007,5,6612003,67.9,6288680,64.6,323323,4.9
Indiana,2007,5,3191090,66.1,3049045,63.1,142045,4.5
Iowa,2007,5,1658248,72.0,1597178,69.3,61070,3.7
Kansas,2007,5,1482871,70.8,1420764,67.8,62107,4.2
Kentucky,2007,5,2035221,62.2,1927722,59.0,107499,5.3
Louisiana,2007,5,2020880,61.6,1934816,59.0,86064,4.3
Maine,2007,5,698469,66.1,666311,63.1,32158,4.6
Maryland,2007,5,2979361,68.9,2869725,66.4,109636,3.7
Massachusetts,2007,5,3431323,66.9,3277616,63.9,153707,4.5
Michigan,2007,5,4994572,64.2,4648398,59.8,346174,6.9
Minnesota,2007,5,2897960,72.3,2767511,69.1,130449,4.5
Mississippi,2007,5,1288212,59.4,1208301,55.7,79911,6.2
Missouri,2007,5,3052676,67.4,2902173,64.1,150503,4.9
Montana,2007,5,503837,67.3,487924,65.1,15913,3.2
Nebraska,2007,5,976883,72.8,948707,70.7,28176,2.9
Nevada,2007,5,1339270,69.3,1280394,66.2,58876,4.4
New Hampshire,2007,5,737348,70.8,711043,68.3,26305,3.6
New Jersey,2007,5,4424305,66.2,4242385,63.5,181920,4.1
New Mexico,2007,5,918348,62.0,886059,59.9,32289,3.5
New York,2007,5,9484366,62.5,9073042,59.8,411324,4.3
New York city,2007,5,3842833,58.9,3657480,56.1,185353,4.8
North Carolina,2007,5,4518158,65.8,4294750,62.6,223408,4.9
North Dakota,2007,5,366908,74.1,355846,71.8,11062,3.0
Ohio,2007,5,6019240,67.7,5683902,63.9,335338,5.6
Oklahoma,2007,5,1721952,63.5,1652156,60.9,69796,4.1
Oregon,2007,5,1904550,65.2,1809031,62.0,95519,5.0
Pennsylvania,2007,5,6326189,64.4,6048133,61.6,278056,4.4
Rhode Island,2007,5,570461,68.1,543171,64.9,27290,4.8
South Carolina,2007,5,2157889,64.1,2028383,60.3,129506,6.0
South Dakota,2007,5,435799,72.2,423522,70.1,12277,2.8
Tennessee,2007,5,3036040,63.9,2905735,61.2,130305,4.3
Texas,2007,5,11406369,65.8,10913440,62.9,492929,4.3
Utah,2007,5,1374601,73.0,1340503,71.2,34098,2.5
Vermont,2007,5,353648,70.5,339909,67.7,13739,3.9
Virginia,2007,5,4023984,68.8,3898080,66.7,125904,3.1
Washington,2007,5,3388302,67.8,3236416,64.8,151886,4.5
West Virginia,2007,5,801447,55.5,763577,52.9,37870,4.7
Wisconsin,2007,5,3084018,70.8,2936652,67.5,147366,4.8
Wyoming,2007,5,290015,72.0,282297,70.1,7718,2.7
Alabama,2007,6,2176642,61.2,2089809,58.8,86833,4.0
Alaska,2007,6,349218,70.5,327344,66.0,21874,6.3
Arizona,2007,6,3009749,63.3,2904001,61.1,105748,3.5
Arkansas,2007,6,1348840,62.3,1275317,58.9,73523,5.5
California,2007,6,17884308,65.6,16949426,62.2,934882,5.2
Los Angeles County,2007,6,4860036,65.7,4617320,62.4,242716,5.0
Colorado,2007,6,2678950,72.6,2585195,70.1,93755,3.5
Connecticut,2007,6,1853582,68.5,1772394,65.5,81188,4.4
Delaware,2007,6,444095,66.5,428382,64.2,15713,3.5
District of Columbia,2007,6,324893,68.7,305688,64.6,19205,5.9
Florida,2007,6,9105560,63.5,8817098,61.5,288462,3.2
Georgia,2007,6,4799738,67.9,4567895,64.6,231843,4.8
Hawaii,2007,6,634988,65.6,618131,63.9,16857,2.7
Idaho,2007,6,755825,68.0,733862,66.0,21963,2.9
Illinois,2007,6,6626590,68.0,6295927,64.6,330663,5.0
Indiana,2007,6,3186811,65.9,3044087,63.0,142724,4.5
Iowa,2007,6,1658520,71.9,1597354,69.3,61166,3.7
Kansas,2007,6,1482976,70.8,1420851,67.8,62125,4.2
Kentucky,2007,6,2032318,62.1,1924641,58.8,107677,5.3
Louisiana,2007,6,2019628,61.4,1934783,58.8,84845,4.2
Maine,2007,6,697735,66.0,665225,63.0,32510,4.7
Maryland,2007,6,2980361,68.9,2871146,66.4,109215,3.7
Massachusetts,2007,6,3430837,66.9,3277367,63.9,153470,4.5
Michigan,2007,6,4990740,64.2,4641105,59.7,349635,7.0
Minnesota,2007,6,2897126,72.2,2764914,68.9,132212,4.6
Mississippi,2007,6,1288461,59.4,1209455,55.7,79006,6.1
Missouri,2007,6,3053868,67.4,2900452,64.0,153416,5.0
Montana,2007,6,504589,67.3,487728,65.0,16861,3.3
Nebraska,2007,6,978010,72.9,949273,70.7,28737,2.9
Nevada,2007,6,1342122,69.3,1281753,66.2,60369,4.5
New Hampshire,2007,6,737196,70.7,711311,68.2,25885,3.5
New Jersey,2007,6,4425548,66.2,4242159,63.5,183389,4.1
New Mexico,2007,6,918178,61.9,886182,59.8,31996,3.5
New York,2007,6,9488494,62.5,9070029,59.7,418465,4.4
New York city,2007,6,3847694,58.9,3658820,56.0,188874,4.9
North Carolina,2007,6,4522298,65.8,4295160,62.5,227138,5.0
North Dakota,2007,6,366881,74.0,355769,71.8,11112,3.0
Ohio,2007,6,6018239,67.6,5679913,63.8,338326,5.6
Oklahoma,2007,6,1720786,63.4,1651389,60.8,69397,4.0
Oregon,2007,6,1905140,65.2,1807945,61.8,97195,5.1
Pennsylvania,2007,6,6331860,64.4,6050019,61.6,281841,4.5
Rhode Island,2007,6,570163,68.1,542213,64.8,27950,4.9
South Carolina,2007,6,2153733,63.9,2025355,60.1,128378,6.0
South Dakota,2007,6,435880,72.1,423571,70.1,12309,2.8
Tennessee,2007,6,3035028,63.8,2903157,61.0,131871,4.3
Texas,2007,6,11411196,65.7,10919419,62.9,491777,4.3
Utah,2007,6,1376750,72.9,1342100,71.1,34650,2.5
Vermont,2007,6,353120,70.3,339337,67.6,13783,3.9
Virginia,2007,6,4028150,68.8,3901236,66.6,126914,3.2
Washington,2007,6,3394186,67.9,3241007,64.8,153179,4.5
West Virginia,2007,6,802046,55.5,764133,52.9,37913,4.7
Wisconsin,2007,6,3084946,70.8,2936311,67.4,148635,4.8
Wyoming,2007,6,290549,72.1,282594,70.1,7955,2.7
Alabama,2007,7,2176801,61.2,2088783,58.7,88018,4.0
Alaska,2007,7,349601,70.5,327600,66.0,22001,6.3
Arizona,2007,7,3010496,63.2,2905303,60.9,105193,3.5
Arkansas,2007,7,1348878,62.2,1274796,58.8,74082,5.5
California,2007,7,17909056,65.7,16955401,62.2,953655,5.3
Los Angeles County,2007,7,4872193,65.9,4624496,62.5,247697,5.1
Colorado,2007,7,2687730,72.7,2590676,70.1,97054,3.6
Connecticut,2007,7,1855062,68.5,1772917,65.5,82145,4.4
Delaware,2007,7,444306,66.5,428680,64.1,15626,3.5
District of Columbia,2007,7,325257,68.7,306040,64.7,19217,5.9
Florida,2007,7,9107665,63.5,8808067,61.4,299598,3.3
Georgia,2007,7,4807351,67.9,4572460,64.6,234891,4.9
Hawaii,2007,7,634347,65.5,617083,63.7,17264,2.7
Idaho,2007,7,756838,67.9,734072,65.9,22766,3.0
Illinois,2007,7,6643166,68.2,6304082,64.7,339084,5.1
Indiana,2007,7,3186509,65.9,3041603,62.9,144906,4.5
Iowa,2007,7,1659537,72.0,1598096,69.3,61441,3.7
Kansas,2007,7,1483761,70.7,1421335,67.8,62426,4.2
Kentucky,2007,7,2030626,62.0,1922179,58.7,108447,5.3
Louisiana,2007,7,2020024,61.3,1937021,58.8,83003,4.1
Maine,2007,7,697547,66.0,664650,62.9,32897,4.7
Maryland,2007,7,2983555,69.0,2874060,66.4,109495,3.7
Massachusetts,2007,7,3430818,66.8,3277176,63.8,153642,4.5
Michigan,2007,7,4988759,64.2,4634339,59.6,354420,7.1
Minnesota,2007,7,2896892,72.2,2762772,68.8,134120,4.6
Mississippi,2007,7,1289829,59.4,1211517,55.8,78312,6.1
Missouri,2007,7,3056144,67.4,2899507,64.0,156637,5.1
Montana,2007,7,505402,67.3,487649,64.9,17753,3.5
Nebraska,2007,7,979315,72.9,949989,70.8,29326,3.0
Nevada,2007,7,1345169,69.3,1283216,66.1,61953,4.6
New Hampshire,2007,7,737155,70.7,711665,68.2,25490,3.5
New Jersey,2007,7,4428637,66.2,4243568,63.5,185069,4.2
New Mexico,2007,7,918496,61.9,886585,59.7,31911,3.5
New York,2007,7,9497120,62.5,9071651,59.7,425469,4.5
New York city,2007,7,3854510,59.0,3662951,56.1,191559,5.0
North Carolina,2007,7,4527639,65.7,4295905,62.4,231734,5.1
North Dakota,2007,7,366973,74.0,355826,71.8,11147,3.0
Ohio,2007,7,6016911,67.6,5676080,63.8,340831,5.7
Oklahoma,2007,7,1720470,63.3,1651470,60.8,69000,4.0
Oregon,2007,7,1907026,65.1,1807857,61.7,99169,5.2
Pennsylvania,2007,7,6340420,64.5,6053546,61.6,286874,4.5
Rhode Island,2007,7,570143,68.1,541420,64.7,28723,5.0
South Carolina,2007,7,2150443,63.7,2022616,59.9,127827,5.9
South Dakota,2007,7,436076,72.1,423684,70.0,12392,2.8
Tennessee,2007,7,3036405,63.8,2900885,60.9,135520,4.5
Texas,2007,7,11421250,65.6,10928845,62.8,492405,4.3
Utah,2007,7,1378927,72.9,1343693,71.0,35234,2.6
Vermont,2007,7,352634,70.2,338784,67.4,13850,3.9
Virginia,2007,7,4034464,68.8,3905389,66.6,129075,3.2
Washington,2007,7,3401159,67.9,3245815,64.8,155344,4.6
West Virginia,2007,7,803177,55.6,764977,53.0,38200,4.8
Wisconsin,2007,7,3086615,70.8,2936378,67.4,150237,4.9
Wyoming,2007,7,291070,72.1,282958,70.1,8112,2.8
Alabama,2007,8,2177930,61.1,2088560,58.6,89370,4.1
Alaska,2007,8,350146,70.5,328057,66.1,22089,6.3
Arizona,2007,8,3013553,63.1,2906699,60.9,106854,3.5
Arkansas,2007,8,1349562,62.2,1275104,58.8,74458,5.5
California,2007,8,17937431,65.7,16962173,62.1,975258,5.4
Los Angeles County,2007,8,4883616,66.0,4629633,62.5,253983,5.2
Colorado,2007,8,2697211,72.9,2596232,70.1,100979,3.7
Connecticut,2007,8,1857126,68.6,1773734,65.5,83392,4.5
Delaware,2007,8,444788,66.5,429083,64.1,15705,3.5
District of Columbia,2007,8,326098,68.9,306820,64.8,19278,5.9
Florida,2007,8,9113142,63.5,8801072,61.3,312070,3.4
Georgia,2007,8,4816462,67.9,4578064,64.5,238398,4.9
Hawaii,2007,8,634307,65.4,616467,63.6,17840,2.8
Idaho,2007,8,757610,67.9,733890,65.8,23720,3.1
Illinois,2007,8,6659740,68.3,6311421,64.7,348319,5.2
Indiana,2007,8,3189936,65.9,3042056,62.8,147880,4.6
Iowa,2007,8,1661174,72.0,1599243,69.3,61931,3.7
Kansas,2007,8,1485166,70.8,1422076,67.8,63090,4.2
Kentucky,2007,8,2030101,61.9,1920430,58.6,109671,5.4
Louisiana,2007,8,2022752,61.3,1941466,58.8,81286,4.0
Maine,2007,8,697898,66.0,664625,62.8,33273,4.8
Maryland,2007,8,2987929,69.0,2877897,66.5,110032,3.7
Massachusetts,2007,8,3431305,66.8,3277143,63.8,154162,4.5
Michigan,2007,8,4987655,64.1,4628409,59.5,359246,7.2
Minnesota,2007,8,2896949,72.1,2760940,68.7,136009,4.7
Mississippi,2007,8,1292419,59.5,1214328,55.9,78091,6.0
Missouri,2007,8,3059270,67.4,2899435,63.9,159835,5.2
Montana,2007,8,506257,67.3,487785,64.9,18472,3.6
Nebraska,2007,8,980593,73.0,950869,70.8,29724,3.0
Nevada,2007,8,1348473,69.3,1284830,66.0,63643,4.7
New Hampshire,2007,8,737376,70.6,712204,68.2,25172,3.4
New Jersey,2007,8,4433145,66.3,4245978,63.5,187167,4.2
New Mexico,2007,8,919483,61.9,887348,59.7,32135,3.5
New York,2007,8,9509680,62.5,9077545,59.7,432135,4.5
New York city,2007,8,3862797,59.1,3669503,56.1,193294,5.0
North Carolina,2007,8,4533684,65.7,4297291,62.3,236393,5.2
North Dakota,2007,8,367248,74.0,356046,71.8,11202,3.1
Ohio,2007,8,6015646,67.6,5672744,63.7,342902,5.7
Oklahoma,2007,8,1721008,63.3,1652431,60.8,68577,4.0
Oregon,2007,8,1910361,65.1,1809306,61.7,101055,5.3
Pennsylvania,2007,8,6351089,64.6,6058375,61.6,292714,4.6
Rhode Island,2007,8,570405,68.1,540790,64.6,29615,5.2
South Carolina,2007,8,2148004,63.5,2020142,59.7,127862,6.0
South Dakota,2007,8,436349,72.0,423869,70.0,12480,2.9
Tennessee,2007,8,3039495,63.7,2898731,60.8,140764,4.6
Texas,2007,8,11437858,65.6,10942199,62.8,495659,4.3
Utah,2007,8,1381216,72.8,1345301,70.9,35915,2.6
Vermont,2007,8,352250,70.1,338324,67.3,13926,4.0
Virginia,2007,8,4042707,68.9,3910208,66.7,132499,3.3
Washington,2007,8,3409111,68.0,3251381,64.8,157730,4.6
West Virginia,2007,8,804627,55.7,765916,53.0,38711,4.8
Wisconsin,2007,8,3088677,70.8,2936986,67.3,151691,4.9
Wyoming,2007,8,291531,72.1,283401,70.1,8130,2.8
Alabama,2007,9,2179782,61.1,2088878,58.6,90904,4.2
Alaska,2007,9,350731,70.6,328614,66.1,22117,6.3
Arizona,2007,9,3018977,63.1,2908422,60.8,110555,3.7
Arkansas,2007,9,1350759,62.2,1276385,58.8,74374,5.5
California,2007,9,17966927,65.7,16969958,62.1,996969,5.5
Los Angeles County,2007,9,4892593,66.0,4631734,62.5,260859,5.3
Colorado,2007,9,2706470,73.0,2601718,70.2,104752,3.9
Connecticut,2007,9,1859938,68.6,1775209,65.5,84729,4.6
Delaware,2007,9,445525,66.5,429558,64.1,15967,3.6
District of Columbia,2007,9,327267,69.0,307902,65.0,19365,5.9
Florida,2007,9,9122980,63.5,8797471,61.2,325509,3.6
Georgia,2007,9,4826570,67.9,4584166,64.5,242404,5.0
Hawaii,2007,9,634954,65.5,616466,63.6,18488,2.9
Idaho,2007,9,757879,67.8,733406,65.6,24473,3.2
Illinois,2007,9,6674906,68.4,6317812,64.7,357094,5.3
Indiana,2007,9,3196416,66.0,3045872,62.9,150544,4.7
Iowa,2007,9,1663352,72.0,1600949,69.3,62403,3.8
Kansas,2007,9,1486755,70.8,1422954,67.8,63801,4.3
Kentucky,2007,9,2030322,61.9,1919801,58.5,110521,5.4
Louisiana,2007,9,2027354,61.3,1947292,58.9,80062,3.9
Maine,2007,9,698665,66.0,665148,62.9,33517,4.8
Maryland,2007,9,2992773,69.1,2882585,66.5,110188,3.7
Massachusetts,2007,9,3432460,66.7,3277791,63.7,154669,4.5
Michigan,2007,9,4986270,64.1,4623665,59.5,362605,7.3
Minnesota,2007,9,2897029,72.0,2759599,68.6,137430,4.7
Mississippi,2007,9,1295815,59.6,1217572,56.0,78243,6.0
Missouri,2007,9,3062504,67.4,2900171,63.8,162333,5.3
Montana,2007,9,507153,67.4,488205,64.9,18948,3.7
Nebraska,2007,9,981750,73.0,951958,70.8,29792,3.0
Nevada,2007,9,1352002,69.4,1286632,66.0,65370,4.8
New Hampshire,2007,9,737902,70.6,712965,68.2,24937,3.4
New Jersey,2007,9,4439191,66.3,4249429,63.5,189762,4.3
New Mexico,2007,9,921102,61.9,888518,59.8,32584,3.5
New York,2007,9,9525259,62.6,9087657,59.7,437602,4.6
New York city,2007,9,3872300,59.2,3678254,56.2,194046,5.0
North Carolina,2007,9,4539861,65.7,4299964,62.2,239897,5.3
North Dakota,2007,9,367720,74.1,356480,71.8,11240,3.1
Ohio,2007,9,6015396,67.5,5671388,63.7,344008,5.7
Oklahoma,2007,9,1722237,63.3,1654437,60.8,67800,3.9
Oregon,2007,9,1914597,65.2,1812240,61.7,102357,5.3
Pennsylvania,2007,9,6362760,64.6,6064488,61.6,298272,4.7
Rhode Island,2007,9,570798,68.1,540203,64.5,30595,5.4
South Carolina,2007,9,2146114,63.3,2018109,59.5,128005,6.0
South Dakota,2007,9,436671,72.0,424175,69.9,12496,2.9
Tennessee,2007,9,3043398,63.8,2896840,60.7,146558,4.8
Texas,2007,9,11459823,65.6,10960290,62.8,499533,4.4
Utah,2007,9,1383625,72.8,1346964,70.9,36661,2.6
Vermont,2007,9,352038,70.0,338053,67.2,13985,4.0
Virginia,2007,9,4052349,69.0,3915752,66.7,136597,3.4
Washington,2007,9,3417771,68.0,3258296,64.9,159475,4.7
West Virginia,2007,9,806067,55.8,766894,53.1,39173,4.9
Wisconsin,2007,9,3090646,70.8,2938383,67.3,152263,4.9
Wyoming,2007,9,291994,72.1,283956,70.1,8038,2.8
Alabama,2007,10,2181628,61.1,2088944,58.5,92684,4.2
Alaska,2007,10,351277,70.6,329175,66.2,22102,6.3
Arizona,2007,10,3026157,63.1,2910471,60.7,115686,3.8
Arkansas,2007,10,1352032,62.2,1278323,58.8,73709,5.5
California,2007,10,17993950,65.7,16976329,62.0,1017621,5.7
Los Angeles County,2007,10,4898521,66.1,4630664,62.5,267857,5.5
Colorado,2007,10,2714544,73.1,2606543,70.2,108001,4.0
Connecticut,2007,10,1862997,68.7,1776872,65.5,86125,4.6
Delaware,2007,10,446439,66.5,430080,64.1,16359,3.7
District of Columbia,2007,10,328517,69.2,309035,65.1,19482,5.9
Florida,2007,10,9135500,63.5,8795668,61.1,339832,3.7
Georgia,2007,10,4836836,68.0,4589565,64.5,247271,5.1
Hawaii,2007,10,636095,65.5,617035,63.6,19060,3.0
Idaho,2007,10,757432,67.7,732664,65.4,24768,3.3
Illinois,2007,10,6687735,68.5,6322851,64.7,364884,5.5
Indiana,2007,10,3204215,66.1,3051752,62.9,152463,4.8
Iowa,2007,10,1665743,72.1,1603116,69.4,62627,3.8
Kansas,2007,10,1487983,70.8,1423641,67.7,64342,4.3
Kentucky,2007,10,2030463,61.8,1919867,58.5,110596,5.4
Louisiana,2007,10,2032731,61.4,1952978,58.9,79753,3.9
Maine,2007,10,699588,66.1,666019,62.9,33569,4.8
Maryland,2007,10,2997232,69.1,2887521,66.6,109711,3.7
Massachusetts,2007,10,3434433,66.7,3279271,63.7,155162,4.5
Michigan,2007,10,4983547,64.1,4619463,59.4,364084,7.3
Minnesota,2007,10,2897040,72.0,2758855,68.5,138185,4.8
Mississippi,2007,10,1299111,59.7,1220565,56.1,78546,6.0
Missouri,2007,10,3064788,67.4,2900818,63.8,163970,5.4
Montana,2007,10,508080,67.4,488870,64.9,19210,3.8
Nebraska,2007,10,982695,73.0,953057,70.8,29638,3.0
Nevada,2007,10,1355515,69.4,1288393,66.0,67122,5.0
New Hampshire,2007,10,738556,70.6,713731,68.3,24825,3.4
New Jersey,2007,10,4446740,66.4,4253671,63.5,193069,4.3
New Mexico,2007,10,923117,62.0,889896,59.8,33221,3.6
New York,2007,10,9541506,62.7,9099049,59.8,442457,4.6
New York city,2007,10,3881969,59.3,3687513,56.4,194456,5.0
North Carolina,2007,10,4545177,65.6,4303422,62.2,241755,5.3
North Dakota,2007,10,368303,74.2,357073,71.9,11230,3.0
Ohio,2007,10,6016279,67.5,5671830,63.6,344449,5.7
Oklahoma,2007,10,1723543,63.3,1657137,60.8,66406,3.9
Oregon,2007,10,1918769,65.3,1815958,61.8,102811,5.4
Pennsylvania,2007,10,6373535,64.7,6070703,61.6,302832,4.8
Rhode Island,2007,10,571100,68.2,539446,64.4,31654,5.5
South Carolina,2007,10,2144524,63.2,2016549,59.4,127975,6.0
South Dakota,2007,10,436942,72.0,424539,69.9,12403,2.8
Tennessee,2007,10,3046663,63.7,2894542,60.6,152121,5.0
Texas,2007,10,11484031,65.6,10981282,62.8,502749,4.4
Utah,2007,10,1385953,72.8,1348475,70.8,37478,2.7
Vermont,2007,10,351966,70.0,337926,67.2,14040,4.0
Virginia,2007,10,4062269,69.1,3921492,66.7,140777,3.5
Washington,2007,10,3426353,68.1,3266024,64.9,160329,4.7
West Virginia,2007,10,807066,55.8,767739,53.1,39327,4.9
Wisconsin,2007,10,3091929,70.8,2940541,67.3,151388,4.9
Wyoming,2007,10,292498,72.1,284587,70.1,7911,2.7
Alabama,2007,11,2182775,61.1,2088237,58.5,94538,4.3
Alaska,2007,11,351710,70.6,329677,66.2,22033,6.3
Arizona,2007,11,3033968,63.1,2912955,60.6,121013,4.0
Arkansas,2007,11,1352941,62.2,1280515,58.9,72426,5.4
California,2007,11,18015561,65.8,16980264,62.0,1035297,5.7
Los Angeles County,2007,11,4901455,66.1,4627108,62.4,274347,5.6
Colorado,2007,11,2721095,73.1,2610602,70.2,110493,4.1
Connecticut,2007,11,1865712,68.7,1778299,65.5,87413,4.7
Delaware,2007,11,447478,66.6,430714,64.1,16764,3.7
District of Columbia,2007,11,329628,69.4,310023,65.3,19605,5.9
Florida,2007,11,9148193,63.5,8793740,61.1,354453,3.9
Georgia,2007,11,4846765,68.0,4594075,64.5,252690,5.2
Hawaii,2007,11,637526,65.6,618088,63.6,19438,3.0
Idaho,2007,11,756280,67.4,731723,65.2,24557,3.2
Illinois,2007,11,6697912,68.5,6327482,64.8,370430,5.5
Indiana,2007,11,3211460,66.2,3058115,63.0,153345,4.8
Iowa,2007,11,1667996,72.2,1605547,69.5,62449,3.7
Kansas,2007,11,1488571,70.8,1424075,67.7,64496,4.3
Kentucky,2007,11,2029895,61.7,1919969,58.4,109926,5.4
Louisiana,2007,11,2038038,61.4,1957597,59.0,80441,3.9
Maine,2007,11,700420,66.1,667037,63.0,33383,4.8
Maryland,2007,11,3000787,69.2,2892173,66.7,108614,3.6
Massachusetts,2007,11,3437265,66.7,3281811,63.7,155454,4.5
Michigan,2007,11,4978443,64.0,4615704,59.3,362739,7.3
Minnesota,2007,11,2896893,71.9,2758896,68.5,137997,4.8
Mississippi,2007,11,1301574,59.8,1222882,56.1,78692,6.0
Missouri,2007,11,3065589,67.4,2900868,63.7,164721,5.4
Montana,2007,11,508950,67.5,489629,64.9,19321,3.8
Nebraska,2007,11,983488,73.1,954064,70.9,29424,3.0
Nevada,2007,11,1358745,69.5,1289934,66.0,68811,5.1
New Hampshire,2007,11,739282,70.6,714482,68.3,24800,3.4
New Jersey,2007,11,4455133,66.5,4258556,63.6,196577,4.4
New Mexico,2007,11,925216,62.1,891317,59.8,33899,3.7
New York,2007,11,9556141,62.8,9109703,59.8,446438,4.7
New York city,2007,11,3890847,59.4,3696148,56.5,194699,5.0
North Carolina,2007,11,4548881,65.6,4307399,62.1,241482,5.3
North Dakota,2007,11,368915,74.2,357796,72.0,11119,3.0
Ohio,2007,11,6016931,67.5,5673416,63.6,343515,5.7
Oklahoma,2007,11,1724548,63.2,1660213,60.9,64335,3.7
Oregon,2007,11,1922205,65.3,1819994,61.8,102211,5.3
Pennsylvania,2007,11,6382502,64.8,6076768,61.7,305734,4.8
Rhode Island,2007,11,571118,68.2,538458,64.3,32660,5.7
South Carolina,2007,11,2143103,63.0,2015474,59.3,127629,6.0
South Dakota,2007,11,437109,71.9,424927,69.9,12182,2.8
Tennessee,2007,11,3048534,63.7,2891923,60.4,156611,5.1
Texas,2007,11,11508120,65.7,11004022,62.8,504098,4.4
Utah,2007,11,1387937,72.8,1349690,70.8,38247,2.8
Vermont,2007,11,351983,69.9,337899,67.1,14084,4.0
Virginia,2007,11,4071799,69.2,3927530,66.7,144269,3.5
Washington,2007,11,3434198,68.2,3274082,65.0,160116,4.7
West Virginia,2007,11,807417,55.8,768357,53.1,39060,4.8
Wisconsin,2007,11,3092492,70.7,2943825,67.3,148667,4.8
Wyoming,2007,11,293057,72.1,285260,70.2,7797,2.7
Alabama,2007,12,2183086,61.1,2086564,58.4,96522,4.4
Alaska,2007,12,352134,70.7,330190,66.3,21944,6.2
Arizona,2007,12,3041613,63.2,2915755,60.6,125858,4.1
Arkansas,2007,12,1353447,62.2,1282727,58.9,70720,5.2
California,2007,12,18032573,65.8,16982149,61.9,1050424,5.8
Los Angeles County,2007,12,4902375,66.0,4621833,62.3,280542,5.7
Colorado,2007,12,2726104,73.1,2613895,70.1,112209,4.1
Connecticut,2007,12,1867928,68.8,1779384,65.5,88544,4.7
Delaware,2007,12,448554,66.7,431428,64.1,17126,3.8
District of Columbia,2007,12,330482,69.6,310744,65.4,19738,6.0
Florida,2007,12,9159259,63.6,8789788,61.0,369471,4.0
Georgia,2007,12,4856726,68.1,4598040,64.4,258686,5.3
Hawaii,2007,12,639094,65.8,619435,63.7,19659,3.1
Idaho,2007,12,754691,67.2,730659,65.0,24032,3.2
Illinois,2007,12,6705536,68.6,6332204,64.8,373332,5.6
Indiana,2007,12,3217636,66.3,3064296,63.1,153340,4.8
Iowa,2007,12,1670033,72.2,1608126,69.5,61907,3.7
Kansas,2007,12,1488603,70.8,1424446,67.7,64157,4.3
Kentucky,2007,12,2028679,61.7,1919790,58.3,108889,5.4
Louisiana,2007,12,2042821,61.5,1961120,59.0,81701,4.0
Maine,2007,12,701031,66.1,668042,63.0,32989,4.7
Maryland,2007,12,3003897,69.2,2896480,66.7,107417,3.6
Massachusetts,2007,12,3440566,66.7,3284993,63.7,155573,4.5
Michigan,2007,12,4970964,63.9,4611446,59.3,359518,7.2
Minnesota,2007,12,2896769,71.9,2759616,68.5,137153,4.7
Mississippi,2007,12,1303016,59.8,1224337,56.2,78679,6.0
Missouri,2007,12,3065251,67.3,2900324,63.7,164927,5.4
Montana,2007,12,509732,67.5,490367,64.9,19365,3.8
Nebraska,2007,12,984217,73.1,955010,70.9,29207,3.0
Nevada,2007,12,1361625,69.5,1291127,65.9,70498,5.2
New Hampshire,2007,12,740089,70.7,715268,68.3,24821,3.4
New Jersey,2007,12,4463384,66.6,4263387,63.6,199997,4.5
New Mexico,2007,12,927178,62.2,892693,59.9,34485,3.7
New York,2007,12,9568190,62.8,9118591,59.9,449599,4.7
New York city,2007,12,3898301,59.5,3703513,56.5,194788,5.0
North Carolina,2007,12,4550690,65.5,4311456,62.1,239234,5.3
North Dakota,2007,12,369539,74.3,358627,72.1,10912,3.0
Ohio,2007,12,6016753,67.5,5675653,63.7,341100,5.7
Oklahoma,2007,12,1725382,63.2,1663681,61.0,61701,3.6
Oregon,2007,12,1924688,65.3,1824021,61.9,100667,5.2
Pennsylvania,2007,12,6390393,64.8,6083501,61.7,306892,4.8
Rhode Island,2007,12,570736,68.1,537218,64.1,33518,5.9
South Carolina,2007,12,2142197,62.9,2014876,59.2,127321,5.9
South Dakota,2007,12,437206,71.9,425335,69.9,11871,2.7
Tennessee,2007,12,3049619,63.7,2889792,60.3,159827,5.2
Texas,2007,12,11531148,65.7,11027674,62.8,503474,4.4
Utah,2007,12,1389416,72.7,1350526,70.7,38890,2.8
Vermont,2007,12,352068,69.9,337945,67.1,14123,4.0
Virginia,2007,12,4081055,69.3,3934313,66.8,146742,3.6
Washington,2007,12,3441083,68.2,3281863,65.0,159220,4.6
West Virginia,2007,12,807291,55.8,768882,53.1,38409,4.8
Wisconsin,2007,12,3092618,70.7,2948303,67.4,144315,4.7
Wyoming,2007,12,293644,72.1,285941,70.3,7703,2.6
Alabama,2008,1,2182712,61.0,2083744,58.3,98968,4.5
Alaska,2008,1,352640,70.7,330728,66.3,21912,6.2
Arizona,2008,1,3048650,63.2,2918156,60.5,130494,4.3
Arkansas,2008,1,1353678,62.2,1284620,59.0,69058,5.1
California,2008,1,18047064,65.7,16979728,61.8,1067336,5.9
Los Angeles County,2008,1,4901963,66.0,4614310,62.1,287653,5.9
Colorado,2008,1,2729192,73.1,2615692,70.1,113500,4.2
Connecticut,2008,1,1869605,68.8,1779846,65.5,89759,4.8
Delaware,2008,1,449481,66.7,432002,64.1,17479,3.9
District of Columbia,2008,1,331102,69.6,311186,65.4,19916,6.0
Florida,2008,1,9166494,63.6,8780743,60.9,385751,4.2
Georgia,2008,1,4866898,68.1,4601237,64.4,265661,5.5
Hawaii,2008,1,640525,65.9,620658,63.8,19867,3.1
Idaho,2008,1,753003,66.9,729462,64.8,23541,3.1
Illinois,2008,1,6709673,68.6,6334043,64.8,375630,5.6
Indiana,2008,1,3222317,66.3,3068926,63.2,153391,4.8
Iowa,2008,1,1671514,72.2,1610160,69.6,61354,3.7
Kansas,2008,1,1488330,70.7,1424783,67.7,63547,4.3
Kentucky,2008,1,2027269,61.6,1919001,58.3,108268,5.3
Louisiana,2008,1,2046613,61.5,1963488,59.0,83125,4.1
Maine,2008,1,701344,66.1,668746,63.1,32598,4.6
Maryland,2008,1,3006981,69.2,2899910,66.8,107071,3.6
Massachusetts,2008,1,3443336,66.7,3287272,63.7,156064,4.5
Michigan,2008,1,4962050,63.8,4604930,59.2,357120,7.2
Minnesota,2008,1,2896805,71.8,2760194,68.4,136611,4.7
Mississippi,2008,1,1303465,59.8,1224659,56.2,78806,6.0
Missouri,2008,1,3064242,67.2,2899013,63.6,165229,5.4
Montana,2008,1,510364,67.5,490873,64.9,19491,3.8
Nebraska,2008,1,984852,73.1,955811,70.9,29041,2.9
Nevada,2008,1,1364101,69.5,1291670,65.9,72431,5.3
New Hampshire,2008,1,740860,70.7,715950,68.3,24910,3.4
New Jersey,2008,1,4470219,66.7,4266692,63.6,203527,4.6
New Mexico,2008,1,928742,62.2,893771,59.9,34971,3.8
New York,2008,1,9577044,62.8,9124073,59.9,452971,4.7
New York city,2008,1,3904151,59.6,3709174,56.6,194977,5.0
North Carolina,2008,1,4550387,65.4,4313877,62.0,236510,5.2
North Dakota,2008,1,370084,74.4,359404,72.3,10680,2.9
Ohio,2008,1,6014754,67.4,5675960,63.6,338794,5.6
Oklahoma,2008,1,1726265,63.2,1667262,61.0,59003,3.4
Oregon,2008,1,1925863,65.3,1827073,61.9,98790,5.1
Pennsylvania,2008,1,6397499,64.9,6090155,61.7,307344,4.8
Rhode Island,2008,1,569965,68.0,535641,63.9,34324,6.0
South Carolina,2008,1,2142083,62.8,2014465,59.0,127618,6.0
South Dakota,2008,1,437280,71.8,425694,69.9,11586,2.6
Tennessee,2008,1,3050278,63.6,2887750,60.2,162528,5.3
Texas,2008,1,11551722,65.7,11049469,62.8,502253,4.3
Utah,2008,1,1390196,72.6,1350736,70.5,39460,2.8
Vermont,2008,1,352192,69.9,337980,67.1,14212,4.0
Virginia,2008,1,4089713,69.4,3941102,66.8,148611,3.6
Washington,2008,1,3446781,68.2,3288083,65.1,158698,4.6
West Virginia,2008,1,806965,55.8,769341,53.2,37624,4.7
Wisconsin,2008,1,3092444,70.7,2952857,67.5,139587,4.5
Wyoming,2008,1,294176,72.2,286531,70.3,7645,2.6
Alabama,2008,2,2182002,61.0,2079970,58.1,102032,4.7
Alaska,2008,2,353200,70.8,331231,66.4,21969,6.2
Arizona,2008,2,3055250,63.2,2919912,60.4,135338,4.4
Arkansas,2008,2,1353823,62.1,1286093,59.0,67730,5.0
California,2008,2,18061461,65.7,16972015,61.8,1089446,6.0
Los Angeles County,2008,2,4901017,65.9,4604505,61.9,296512,6.1
Colorado,2008,2,2730710,73.0,2615827,70.0,114883,4.2
Connecticut,2008,2,1871046,68.8,1779792,65.4,91254,4.9
Delaware,2008,2,450124,66.7,432276,64.1,17848,4.0
District of Columbia,2008,2,331607,69.7,311454,65.5,20153,6.1
Florida,2008,2,9169252,63.5,8765562,60.7,403690,4.4
Georgia,2008,2,4877596,68.2,4604149,64.4,273447,5.6
Hawaii,2008,2,641682,66.0,621470,63.9,20212,3.1
Idaho,2008,2,751556,66.7,728191,64.6,23365,3.1
Illinois,2008,2,6708900,68.6,6329578,64.7,379322,5.7
Indiana,2008,2,3225717,66.4,3071079,63.2,154638,4.8
Iowa,2008,2,1672496,72.3,1611271,69.6,61225,3.7
Kansas,2008,2,1488077,70.7,1425145,67.7,62932,4.2
Kentucky,2008,2,2026297,61.5,1917658,58.2,108639,5.4
Louisiana,2008,2,2049281,61.5,1964932,59.0,84349,4.1
Maine,2008,2,701507,66.1,669081,63.1,32426,4.6
Maryland,2008,2,3010368,69.3,2902178,66.8,108190,3.6
Massachusetts,2008,2,3445463,66.7,3288107,63.7,157356,4.6
Michigan,2008,2,4952602,63.7,4595514,59.1,357088,7.2
Minnesota,2008,2,2897217,71.8,2760058,68.4,137159,4.7
Mississippi,2008,2,1302924,59.7,1223753,56.1,79171,6.1
Missouri,2008,2,3063107,67.2,2897024,63.5,166083,5.4
Montana,2008,2,510816,67.5,491021,64.9,19795,3.9
Nebraska,2008,2,985443,73.1,956411,70.9,29032,2.9
Nevada,2008,2,1366231,69.6,1291488,65.7,74743,5.5
New Hampshire,2008,2,741503,70.7,716454,68.3,25049,3.4
New Jersey,2008,2,4474935,66.7,4267757,63.6,207178,4.6
New Mexico,2008,2,929824,62.3,894455,59.9,35369,3.8
New York,2008,2,9583530,62.9,9126805,59.9,456725,4.8
New York city,2008,2,3908761,59.6,3713630,56.6,195131,5.0
North Carolina,2008,2,4549021,65.3,4313948,61.9,235073,5.2
North Dakota,2008,2,370543,74.5,360026,72.4,10517,2.8
Ohio,2008,2,6011252,67.4,5672357,63.6,338895,5.6
Oklahoma,2008,2,1727384,63.2,1670591,61.1,56793,3.3
Oregon,2008,2,1926271,65.2,1828799,61.9,97472,5.1
Pennsylvania,2008,2,6403801,64.9,6095607,61.8,308194,4.8
Rhode Island,2008,2,569022,67.9,533834,63.7,35188,6.2
South Carolina,2008,2,2142958,62.7,2014109,58.9,128849,6.0
South Dakota,2008,2,437379,71.8,425948,69.9,11431,2.6
Tennessee,2008,2,3050932,63.6,2884998,60.1,165934,5.4
Texas,2008,2,11569544,65.7,11068110,62.9,501434,4.3
Utah,2008,2,1390331,72.5,1350305,70.4,40026,2.9
Vermont,2008,2,352351,69.9,337975,67.1,14376,4.1
Virginia,2008,2,4097974,69.5,3947359,66.9,150615,3.7
Washington,2008,2,3451561,68.2,3292130,65.1,159431,4.6
West Virginia,2008,2,806592,55.7,769703,53.2,36889,4.6
Wisconsin,2008,2,3092050,70.6,2956324,67.5,135726,4.4
Wyoming,2008,2,294628,72.2,286996,70.3,7632,2.6
Alabama,2008,3,2181312,60.9,2075441,57.9,105871,4.9
Alaska,2008,3,353867,70.9,331722,66.4,22145,6.3
Arizona,2008,3,3062260,63.3,2920981,60.4,141279,4.6
Arkansas,2008,3,1354111,62.1,1287098,59.0,67013,4.9
California,2008,3,18079489,65.7,16958869,61.7,1120620,6.2
Los Angeles County,2008,3,4900778,65.9,4592688,61.7,308090,6.3
Colorado,2008,3,2731524,72.9,2614588,69.8,116936,4.3
Connecticut,2008,3,1872549,68.8,1779225,65.4,93324,5.0
Delaware,2008,3,450558,66.7,432198,64.0,18360,4.1
District of Columbia,2008,3,332201,69.8,311711,65.5,20490,6.2
Florida,2008,3,9169367,63.5,8745057,60.6,424310,4.6
Georgia,2008,3,4889427,68.3,4607194,64.3,282233,5.8
Hawaii,2008,3,642622,66.0,621796,63.9,20826,3.2
Idaho,2008,3,750634,66.5,726940,64.4,23694,3.2
Illinois,2008,3,6703482,68.5,6317160,64.5,386322,5.8
Indiana,2008,3,3229511,66.4,3071330,63.2,158181,4.9
Iowa,2008,3,1673699,72.3,1611773,69.6,61926,3.7
Kansas,2008,3,1488306,70.7,1425587,67.7,62719,4.2
Kentucky,2008,3,2026753,61.4,1916245,58.1,110508,5.5
Louisiana,2008,3,2051196,61.5,1966079,58.9,85117,4.1
Maine,2008,3,701834,66.2,669166,63.1,32668,4.7
Maryland,2008,3,3014563,69.3,2903324,66.8,111239,3.7
Massachusetts,2008,3,3448080,66.7,3288084,63.6,159996,4.6
Michigan,2008,3,4943787,63.6,4583166,59.0,360621,7.3
Minnesota,2008,3,2898610,71.8,2759179,68.3,139431,4.8
Mississippi,2008,3,1301731,59.6,1221681,56.0,80050,6.1
Missouri,2008,3,3062698,67.1,2894477,63.4,168221,5.5
Montana,2008,3,511130,67.5,490799,64.8,20331,4.0
Nebraska,2008,3,986086,73.1,956801,70.9,29285,3.0
Nevada,2008,3,1368224,69.5,1290616,65.6,77608,5.7
New Hampshire,2008,3,742078,70.7,716778,68.3,25300,3.4
New Jersey,2008,3,4478301,66.7,4266825,63.6,211476,4.7
New Mexico,2008,3,930563,62.3,894781,59.9,35782,3.8
New York,2008,3,9590062,62.9,9128290,59.9,461772,4.8
New York city,2008,3,3912878,59.7,3717302,56.7,195576,5.0
North Carolina,2008,3,4548589,65.2,4312032,61.8,236557,5.2
North Dakota,2008,3,371008,74.5,360494,72.4,10514,2.8
Ohio,2008,3,6008457,67.4,5664400,63.5,344057,5.7
Oklahoma,2008,3,1729075,63.2,1673464,61.2,55611,3.2
Oregon,2008,3,1927307,65.2,1829599,61.9,97708,5.1
Pennsylvania,2008,3,6410873,64.9,6099944,61.8,310929,4.9
Rhode Island,2008,3,568244,67.8,531970,63.5,36274,6.4
South Carolina,2008,3,2145291,62.7,2013689,58.8,131602,6.1
South Dakota,2008,3,437569,71.8,426073,69.9,11496,2.6
Tennessee,2008,3,3052029,63.5,2881036,60.0,170993,5.6
Texas,2008,3,11587968,65.7,11084171,62.8,503797,4.3
Utah,2008,3,1390054,72.3,1349332,70.2,40722,2.9
Vermont,2008,3,352567,70.0,337934,67.1,14633,4.2
Virginia,2008,3,4106722,69.5,3952938,66.9,153784,3.7
Washington,2008,3,3456754,68.3,3294563,65.1,162191,4.7
West Virginia,2008,3,806233,55.7,769968,53.2,36265,4.5
Wisconsin,2008,3,3091763,70.6,2957863,67.5,133900,4.3
Wyoming,2008,3,295041,72.2,287354,70.3,7687,2.6
Alabama,2008,4,2180544,60.8,2070085,57.7,110459,5.1
Alaska,2008,4,354642,71.0,332225,66.5,22417,6.3
Arizona,2008,4,3070618,63.3,2921370,60.3,149248,4.9
Arkansas,2008,4,1354740,62.1,1287626,59.0,67114,5.0
California,2008,4,18102490,65.8,16940096,61.5,1162394,6.4
Los Angeles County,2008,4,4902214,65.8,4579663,61.5,322551,6.6
Colorado,2008,4,2732182,72.8,2612373,69.6,119809,4.4
Connecticut,2008,4,1874146,68.8,1778038,65.3,96108,5.1
Delaware,2008,4,450833,66.7,431703,63.8,19130,4.2
District of Columbia,2008,4,333093,69.9,312148,65.5,20945,6.3
Florida,2008,4,9168749,63.5,8720582,60.4,448167,4.9
Georgia,2008,4,4902145,68.3,4609997,64.3,292148,6.0
Hawaii,2008,4,643304,66.1,621515,63.8,21789,3.4
Idaho,2008,4,756944,67.0,725740,64.2,31204,4.1
Illinois,2008,4,6694126,68.3,6297079,64.3,397047,5.9
Indiana,2008,4,3234611,66.5,3070463,63.1,164148,5.1
Iowa,2008,4,1675641,72.3,1612124,69.6,63517,3.8
Kansas,2008,4,1489101,70.7,1425930,67.7,63171,4.2
Kentucky,2008,4,2028938,61.5,1914843,58.0,114095,5.6
Louisiana,2008,4,2053498,61.4,1967590,58.9,85908,4.2
Maine,2008,4,702403,66.2,669018,63.0,33385,4.8
Maryland,2008,4,3019372,69.4,2903305,66.8,116067,3.8
Massachusetts,2008,4,3451857,66.7,3287651,63.6,164206,4.8
Michigan,2008,4,4936116,63.5,4568466,58.8,367650,7.4
Minnesota,2008,4,2901263,71.8,2757878,68.2,143385,4.9
Mississippi,2008,4,1300119,59.5,1218522,55.8,81597,6.3
Missouri,2008,4,3063138,67.1,2891182,63.3,171956,5.6
Montana,2008,4,511411,67.5,490311,64.7,21100,4.1
Nebraska,2008,4,986716,73.1,956899,70.9,29817,3.0
Nevada,2008,4,1370126,69.5,1289063,65.4,81063,5.9
New Hampshire,2008,4,742699,70.8,716980,68.3,25719,3.5
New Jersey,2008,4,4481480,66.8,4264339,63.5,217141,4.8
New Mexico,2008,4,931269,62.3,894875,59.8,36394,3.9
New York,2008,4,9599018,62.9,9129190,59.8,469828,4.9
New York city,2008,4,3917911,59.7,3720582,56.7,197329,5.0
North Carolina,2008,4,4550328,65.1,4308779,61.7,241549,5.3
North Dakota,2008,4,371511,74.6,360812,72.4,10699,2.9
Ohio,2008,4,6007620,67.3,5652710,63.4,354910,5.9
Oklahoma,2008,4,1731478,63.3,1675777,61.2,55701,3.2
Oregon,2008,4,1930010,65.2,1829951,61.8,100059,5.2
Pennsylvania,2008,4,6419243,65.0,6103469,61.8,315774,4.9
Rhode Island,2008,4,567825,67.8,530113,63.3,37712,6.6
South Carolina,2008,4,2148967,62.7,2012754,58.7,136213,6.3
South Dakota,2008,4,437859,71.8,426056,69.8,11803,2.7
Tennessee,2008,4,3053781,63.5,2875899,59.8,177882,5.8
Texas,2008,4,11609646,65.7,11098012,62.8,511634,4.4
Utah,2008,4,1389475,72.2,1347866,70.0,41609,3.0
Vermont,2008,4,352841,70.0,337854,67.0,14987,4.2
Virginia,2008,4,4116032,69.6,3957470,67.0,158562,3.9
Washington,2008,4,3463341,68.3,3296358,65.0,166983,4.8
West Virginia,2008,4,805897,55.7,770072,53.2,35825,4.4
Wisconsin,2008,4,3091788,70.6,2957241,67.5,134547,4.4
Wyoming,2008,4,295452,72.2,287625,70.3,7827,2.6
Alabama,2008,5,2179601,60.8,2063894,57.5,115707,5.3
Alaska,2008,5,355376,71.0,332635,66.5,22741,6.4
Arizona,2008,5,3080677,63.4,2921270,60.1,159407,5.2
Arkansas,2008,5,1355970,62.1,1287961,59.0,68009,5.0
California,2008,5,18131133,65.8,16917726,61.4,1213407,6.7
Los Angeles County,2008,5,4906787,65.9,4567554,61.3,339233,6.9
Colorado,2008,5,2733114,72.7,2609574,69.5,123540,4.5
Connecticut,2008,5,1875861,68.9,1776383,65.2,99478,5.3
Delaware,2008,5,450971,66.6,430805,63.6,20166,4.5
District of Columbia,2008,5,334242,70.1,312748,65.6,21494,6.4
Florida,2008,5,9169161,63.4,8694289,60.1,474872,5.2
Georgia,2008,5,4915122,68.4,4611993,64.2,303129,6.2
Hawaii,2008,5,643618,66.1,620551,63.7,23067,3.6
Idaho,2008,5,760351,67.2,724589,64.0,35762,4.7
Illinois,2008,5,6681135,68.2,6270759,64.0,410376,6.1
Indiana,2008,5,3241131,66.6,3069326,63.0,171805,5.3
Iowa,2008,5,1678567,72.4,1612887,69.6,65680,3.9
Kansas,2008,5,1490277,70.7,1425962,67.6,64315,4.3
Kentucky,2008,5,2032389,61.5,1913311,57.9,119078,5.9
Louisiana,2008,5,2057291,61.5,1969706,58.8,87585,4.3
Maine,2008,5,703056,66.2,668592,63.0,34464,4.9
Maryland,2008,5,3024091,69.5,2902061,66.7,122030,4.0
Massachusetts,2008,5,3457054,66.8,3287296,63.5,169758,4.9
Michigan,2008,5,4929420,63.4,4552402,58.6,377018,7.6
Minnesota,2008,5,2905299,71.8,2756987,68.2,148312,5.1
Mississippi,2008,5,1298265,59.4,1214621,55.6,83644,6.4
Missouri,2008,5,3063984,67.0,2886999,63.2,176985,5.8
Montana,2008,5,511776,67.4,489740,64.5,22036,4.3
Nebraska,2008,5,987230,73.1,956699,70.8,30531,3.1
Nevada,2008,5,1371914,69.5,1286907,65.2,85007,6.2
New Hampshire,2008,5,743388,70.8,717095,68.3,26293,3.5
New Jersey,2008,5,4485779,66.8,4261272,63.5,224507,5.0
New Mexico,2008,5,932259,62.3,894964,59.8,37295,4.0
New York,2008,5,9612247,63.0,9130656,59.8,481591,5.0
New York city,2008,5,3925285,59.8,3724193,56.7,201092,5.1
North Carolina,2008,5,4555179,65.1,4305858,61.5,249321,5.5
North Dakota,2008,5,372002,74.7,360972,72.4,11030,3.0
Ohio,2008,5,6009324,67.3,5639316,63.2,370008,6.2
Oklahoma,2008,5,1734689,63.3,1677856,61.3,56833,3.3
Oregon,2008,5,1935049,65.3,1830610,61.7,104439,5.4
Pennsylvania,2008,5,6428978,65.1,6106957,61.8,322021,5.0
Rhode Island,2008,5,567747,67.8,528239,63.0,39508,7.0
South Carolina,2008,5,2153582,62.7,2011092,58.6,142490,6.6
South Dakota,2008,5,438234,71.8,425932,69.8,12302,2.8
Tennessee,2008,5,3056689,63.5,2870663,59.6,186026,6.1
Texas,2008,5,11635536,65.8,11109993,62.8,525543,4.5
Utah,2008,5,1388638,72.0,1345995,69.8,42643,3.1
Vermont,2008,5,353179,70.0,337781,67.0,15398,4.4
Virginia,2008,5,4125461,69.7,3960901,66.9,164560,4.0
Washington,2008,5,3470993,68.4,3297939,65.0,173054,5.0
West Virginia,2008,5,805631,55.6,770016,53.2,35615,4.4
Wisconsin,2008,5,3092342,70.5,2955027,67.4,137315,4.4
Wyoming,2008,5,295913,72.2,287868,70.2,8045,2.7
Alabama,2008,6,2178622,60.7,2057140,57.3,121482,5.6
Alaska,2008,6,355922,71.1,332865,66.5,23057,6.5
Arizona,2008,6,3092028,63.5,2921092,60.0,170936,5.5
Arkansas,2008,6,1357843,62.1,1288251,58.9,69592,5.1
California,2008,6,18164654,65.8,16894388,61.2,1270266,7.0
Los Angeles County,2008,6,4914789,65.9,4557708,61.1,357081,7.3
Colorado,2008,6,2734443,72.6,2606433,69.2,128010,4.7
Connecticut,2008,6,1877881,68.9,1774721,65.1,103160,5.5
Delaware,2008,6,451055,66.5,429649,63.4,21406,4.7
District of Columbia,2008,6,335385,70.3,313270,65.7,22115,6.6
Florida,2008,6,9171233,63.4,8667892,59.9,503341,5.5
Georgia,2008,6,4928114,68.5,4612997,64.1,315117,6.4
Hawaii,2008,6,643567,66.0,619036,63.5,24531,3.8
Idaho,2008,6,762381,67.2,723505,63.8,38876,5.1
Illinois,2008,6,6665433,68.0,6241078,63.6,424355,6.4
Indiana,2008,6,3248295,66.7,3068270,63.0,180025,5.5
Iowa,2008,6,1682183,72.6,1614205,69.6,67978,4.0
Kansas,2008,6,1491760,70.7,1425746,67.6,66014,4.4
Kentucky,2008,6,2036392,61.6,1911585,57.8,124807,6.1
Louisiana,2008,6,2062672,61.5,1971996,58.8,90676,4.4
Maine,2008,6,703584,66.2,667838,62.9,35746,5.1
Maryland,2008,6,3028390,69.6,2899785,66.6,128605,4.2
Massachusetts,2008,6,3463575,66.9,3287364,63.4,176211,5.1
Michigan,2008,6,4923379,63.4,4535828,58.4,387551,7.9
Minnesota,2008,6,2910820,71.9,2757296,68.1,153524,5.3
Mississippi,2008,6,1296313,59.3,1210483,55.4,85830,6.6
Missouri,2008,6,3064984,67.0,2882201,63.0,182783,6.0
Montana,2008,6,512294,67.4,489229,64.4,23065,4.5
Nebraska,2008,6,987667,73.1,956407,70.8,31260,3.2
Nevada,2008,6,1373585,69.5,1284291,65.0,89294,6.5
New Hampshire,2008,6,744061,70.8,717107,68.2,26954,3.6
New Jersey,2008,6,4491804,66.9,4258497,63.4,233307,5.2
New Mexico,2008,6,933669,62.3,895203,59.8,38466,4.1
New York,2008,6,9630028,63.1,9133515,59.8,496513,5.2
New York city,2008,6,3935612,59.9,3728697,56.8,206915,5.3
North Carolina,2008,6,4562466,65.1,4304212,61.4,258254,5.7
North Dakota,2008,6,372451,74.7,361028,72.4,11423,3.1
Ohio,2008,6,6012507,67.3,5625793,63.0,386714,6.4
Oklahoma,2008,6,1738601,63.4,1679997,61.3,58604,3.4
Oregon,2008,6,1942229,65.4,1831696,61.7,110533,5.7
Pennsylvania,2008,6,6439771,65.1,6110512,61.8,329259,5.1
Rhode Island,2008,6,567899,67.8,526367,62.8,41532,7.3
South Carolina,2008,6,2158755,62.8,2008838,58.4,149917,6.9
South Dakota,2008,6,438727,71.8,425798,69.7,12929,2.9
Tennessee,2008,6,3060667,63.5,2866212,59.5,194455,6.4
Texas,2008,6,11666163,65.8,11121171,62.8,544992,4.7
Utah,2008,6,1387616,71.8,1343861,69.5,43755,3.2
Vermont,2008,6,353581,70.1,337764,66.9,15817,4.5
Virginia,2008,6,4134305,69.8,3963346,66.9,170959,4.1
Washington,2008,6,3478758,68.4,3299349,64.9,179409,5.2
West Virginia,2008,6,805535,55.6,769877,53.2,35658,4.4
Wisconsin,2008,6,3093969,70.5,2952277,67.3,141692,4.6
Wyoming,2008,6,296475,72.2,288145,70.2,8330,2.8
Alabama,2008,7,2177334,60.6,2049897,57.0,127437,5.9
Alaska,2008,7,356199,71.1,332941,66.4,23258,6.5
Arizona,2008,7,3103708,63.7,2920905,59.9,182803,5.9
Arkansas,2008,7,1359733,62.2,1288132,58.9,71601,5.3
California,2008,7,18198631,65.9,16869967,61.1,1328664,7.3
Los Angeles County,2008,7,4924616,66.0,4549633,61.0,374983,7.6
Colorado,2008,7,2735689,72.6,2603060,69.0,132629,4.8
Connecticut,2008,7,1879919,68.9,1773119,65.0,106800,5.7
Delaware,2008,7,451063,66.5,428337,63.1,22726,5.0
District of Columbia,2008,7,336209,70.4,313420,65.7,22789,6.8
Florida,2008,7,9172784,63.3,8640817,59.7,531967,5.8
Georgia,2008,7,4940633,68.6,4612633,64.0,328000,6.6
Hawaii,2008,7,643139,65.9,617129,63.3,26010,4.0
Idaho,2008,7,763509,67.2,722338,63.6,41171,5.4
Illinois,2008,7,6647982,67.7,6211153,63.3,436829,6.6
Indiana,2008,7,3254256,66.7,3066171,62.9,188085,5.8
Iowa,2008,7,1685651,72.7,1615698,69.6,69953,4.1
Kansas,2008,7,1493312,70.7,1425477,67.5,67835,4.5
Kentucky,2008,7,2040031,61.6,1909387,57.7,130644,6.4
Louisiana,2008,7,2068708,61.6,1973844,58.8,94864,4.6
Maine,2008,7,703689,66.2,666608,62.7,37081,5.3
Maryland,2008,7,3031959,69.6,2896505,66.5,135454,4.5
Massachusetts,2008,7,3470637,66.9,3287628,63.4,183009,5.3
Michigan,2008,7,4916694,63.3,4517863,58.1,398831,8.1
Minnesota,2008,7,2916961,72.0,2758679,68.1,158282,5.4
Mississippi,2008,7,1293981,59.2,1206270,55.1,87711,6.8
Missouri,2008,7,3065820,67.0,2876896,62.8,188924,6.2
Montana,2008,7,512944,67.4,488842,64.3,24102,4.7
Nebraska,2008,7,988067,73.1,956138,70.7,31929,3.2
Nevada,2008,7,1375054,69.5,1281173,64.7,93881,6.8
New Hampshire,2008,7,744446,70.8,716847,68.1,27599,3.7
New Jersey,2008,7,4498916,66.9,4256003,63.3,242913,5.4
New Mexico,2008,7,935197,62.4,895490,59.7,39707,4.2
New York,2008,7,9649719,63.2,9136086,59.8,513633,5.3
New York city,2008,7,3947973,60.1,3733335,56.8,214638,5.4
North Carolina,2008,7,4570040,65.1,4303689,61.3,266351,5.8
North Dakota,2008,7,372778,74.7,361053,72.4,11725,3.1
Ohio,2008,7,6014218,67.3,5612464,62.8,401754,6.7
Oklahoma,2008,7,1742674,63.5,1682136,61.3,60538,3.5
Oregon,2008,7,1950173,65.6,1832417,61.6,117756,6.0
Pennsylvania,2008,7,6450249,65.2,6112981,61.8,337268,5.2
Rhode Island,2008,7,568073,67.8,524490,62.6,43583,7.7
South Carolina,2008,7,2163696,62.8,2006035,58.2,157661,7.3
South Dakota,2008,7,439323,71.8,425719,69.6,13604,3.1
Tennessee,2008,7,3064883,63.5,2862683,59.3,202200,6.6
Texas,2008,7,11698046,65.9,11131376,62.7,566670,4.8
Utah,2008,7,1386267,71.6,1341399,69.3,44868,3.2
Vermont,2008,7,353970,70.1,337768,66.9,16202,4.6
Virginia,2008,7,4141385,69.9,3964430,66.9,176955,4.3
Washington,2008,7,3485255,68.5,3300237,64.8,185018,5.3
West Virginia,2008,7,805550,55.6,769626,53.1,35924,4.5
Wisconsin,2008,7,3096523,70.5,2949524,67.2,146999,4.7
Wyoming,2008,7,297099,72.3,288449,70.2,8650,2.9
Alabama,2008,8,2175532,60.5,2041980,56.8,133552,6.1
Alaska,2008,8,356256,70.9,332935,66.3,23321,6.5
Arizona,2008,8,3114501,63.8,2920241,59.8,194260,6.2
Arkansas,2008,8,1360944,62.2,1287008,58.8,73936,5.4
California,2008,8,18229614,65.9,16841893,60.9,1387721,7.6
Los Angeles County,2008,8,4934841,66.1,4542066,60.8,392775,8.0
Colorado,2008,8,2736631,72.5,2599477,68.8,137154,5.0
Connecticut,2008,8,1881524,68.9,1771270,64.9,110254,5.9
Delaware,2008,8,450915,66.4,426883,62.8,24032,5.3
District of Columbia,2008,8,336627,70.4,313128,65.5,23499,7.0
Florida,2008,8,9170735,63.3,8610848,59.4,559887,6.1
Georgia,2008,8,4952285,68.7,4610521,63.9,341764,6.9
Hawaii,2008,8,642316,65.8,614884,63.0,27432,4.3
Idaho,2008,8,763961,67.2,720883,63.4,43078,5.6
Illinois,2008,8,6630290,67.5,6183599,63.0,446691,6.7
Indiana,2008,8,3257956,66.8,3061005,62.7,196951,6.0
Iowa,2008,8,1688328,72.7,1616614,69.6,71714,4.2
Kansas,2008,8,1494865,70.8,1425260,67.5,69605,4.7
Kentucky,2008,8,2042938,61.7,1906189,57.5,136749,6.7
Louisiana,2008,8,2074146,61.7,1974665,58.8,99481,4.8
Maine,2008,8,703231,66.1,664756,62.5,38475,5.5
Maryland,2008,8,3034819,69.6,2892074,66.3,142745,4.7
Massachusetts,2008,8,3477120,67.0,3287107,63.3,190013,5.5
Michigan,2008,8,4908296,63.2,4496904,57.9,411392,8.4
Minnesota,2008,8,2922523,72.1,2760026,68.1,162497,5.6
Mississippi,2008,8,1291079,59.0,1201959,54.9,89120,6.9
Missouri,2008,8,3066259,66.9,2870988,62.7,195271,6.4
Montana,2008,8,513563,67.5,488397,64.2,25166,4.9
Nebraska,2008,8,988463,73.0,955768,70.6,32695,3.3
Nevada,2008,8,1376217,69.4,1277347,64.5,98870,7.2
New Hampshire,2008,8,744390,70.7,716147,68.0,28243,3.8
New Jersey,2008,8,4505811,67.0,4252819,63.2,252992,5.6
New Mexico,2008,8,936491,62.4,895498,59.7,40993,4.4
New York,2008,8,9668018,63.3,9135938,59.8,532080,5.5
New York city,2008,8,3960730,60.2,3737104,56.8,223626,5.6
North Carolina,2008,8,4575725,65.1,4302733,61.2,272992,6.0
North Dakota,2008,8,372873,74.7,361008,72.3,11865,3.2
Ohio,2008,8,6011816,67.3,5598120,62.7,413696,6.9
Oklahoma,2008,8,1746499,63.6,1683945,61.3,62554,3.6
Oregon,2008,8,1957311,65.8,1831635,61.5,125676,6.4
Pennsylvania,2008,8,6458730,65.3,6112327,61.8,346403,5.4
Rhode Island,2008,8,568078,67.8,522550,62.3,45528,8.0
South Carolina,2008,8,2167886,62.9,2002548,58.1,165338,7.6
South Dakota,2008,8,439940,71.9,425685,69.5,14255,3.2
Tennessee,2008,8,3068290,63.5,2859187,59.2,209103,6.8
Texas,2008,8,11727305,65.9,11139202,62.6,588103,5.0
Utah,2008,8,1384255,71.4,1338357,69.0,45898,3.3
Vermont,2008,8,354246,70.1,337699,66.9,16547,4.7
Virginia,2008,8,4145890,69.9,3963418,66.8,182472,4.4
Washington,2008,8,3489319,68.4,3299643,64.7,189676,5.4
West Virginia,2008,8,805648,55.6,769123,53.1,36525,4.5
Wisconsin,2008,8,3099708,70.6,2946571,67.1,153137,4.9
Wyoming,2008,8,297673,72.3,288702,70.1,8971,3.0
Alabama,2008,9,2173629,60.4,2033141,56.5,140488,6.5
Alaska,2008,9,356278,70.8,332909,66.2,23369,6.6
Arizona,2008,9,3123387,63.9,2917994,59.7,205393,6.6
Arkansas,2008,9,1361416,62.2,1284515,58.6,76901,5.6
California,2008,9,18257580,66.0,16805122,60.7,1452458,8.0
Los Angeles County,2008,9,4944453,66.2,4532676,60.7,411777,8.3
Colorado,2008,9,2737389,72.4,2595132,68.6,142257,5.2
Connecticut,2008,9,1882648,68.9,1768820,64.8,113828,6.0
Delaware,2008,9,450618,66.3,425254,62.5,25364,5.6
District of Columbia,2008,9,336743,70.3,312433,65.2,24310,7.2
Florida,2008,9,9162508,63.2,8574307,59.1,588201,6.4
Georgia,2008,9,4800201,66.5,4442850,61.5,357351,7.4
Hawaii,2008,9,641210,65.7,612280,62.7,28930,4.5
Idaho,2008,9,764150,67.1,718961,63.2,45189,5.9
Illinois,2008,9,6614614,67.3,6158416,62.7,456198,6.9
Indiana,2008,9,3259403,66.8,3050821,62.5,208582,6.4
Iowa,2008,9,1689996,72.8,1616033,69.6,73963,4.4
Kansas,2008,9,1496707,70.8,1424974,67.4,71733,4.8
Kentucky,2008,9,2045566,61.7,1901351,57.4,144215,7.1
Louisiana,2008,9,2078215,61.8,1974007,58.7,104208,5.0
Maine,2008,9,702387,66.0,662212,62.3,40175,5.7
Maryland,2008,9,3037478,69.6,2886085,66.1,151393,5.0
Massachusetts,2008,9,3481923,67.0,3284012,63.2,197911,5.7
Michigan,2008,9,4898438,63.0,4471729,57.5,426709,8.7
Minnesota,2008,9,2926961,72.1,2759427,68.0,167534,5.7
Mississippi,2008,9,1287989,58.8,1197500,54.7,90489,7.0
Missouri,2008,9,3066669,66.9,2864204,62.5,202465,6.6
Montana,2008,9,513902,67.4,487527,64.0,26375,5.1
Nebraska,2008,9,988765,73.0,955119,70.5,33646,3.4
Nevada,2008,9,1377125,69.4,1272537,64.2,104588,7.6
New Hampshire,2008,9,743962,70.7,714905,67.9,29057,3.9
New Jersey,2008,9,4511156,67.0,4246910,63.1,264246,5.9
New Mexico,2008,9,937279,62.4,894766,59.5,42513,4.5
New York,2008,9,9682451,63.3,9129223,59.7,553228,5.7
New York city,2008,9,3971923,60.4,3737886,56.8,234037,5.9
North Carolina,2008,9,4578761,65.1,4298716,61.1,280045,6.1
North Dakota,2008,9,372754,74.6,360773,72.2,11981,3.2
Ohio,2008,9,6004979,67.2,5579973,62.4,425006,7.1
Oklahoma,2008,9,1749749,63.6,1684673,61.3,65076,3.7
Oregon,2008,9,1962925,65.9,1828177,61.4,134748,6.9
Pennsylvania,2008,9,6465072,65.3,6106294,61.7,358778,5.5
Rhode Island,2008,9,567986,67.7,520521,62.1,47465,8.4
South Carolina,2008,9,2171419,62.9,1997861,57.9,173558,8.0
South Dakota,2008,9,440469,71.9,425601,69.4,14868,3.4
Tennessee,2008,9,3070328,63.5,2854164,59.0,216164,7.0
Texas,2008,9,11751993,66.0,11141801,62.5,610192,5.2
Utah,2008,9,1381301,71.1,1334384,68.7,46917,3.4
Vermont,2008,9,354355,70.1,337442,66.8,16913,4.8
Virginia,2008,9,4147911,69.8,3959244,66.6,188667,4.5
Washington,2008,9,3490731,68.4,3296178,64.5,194553,5.6
West Virginia,2008,9,805969,55.6,768154,53.0,37815,4.7
Wisconsin,2008,9,3103711,70.6,2942506,66.9,161205,5.2
Wyoming,2008,9,298023,72.3,288770,70.0,9253,3.1
Alabama,2008,10,2172322,60.3,2023364,56.2,148958,6.9
Alaska,2008,10,356381,70.7,332820,66.0,23561,6.6
Arizona,2008,10,3129730,63.9,2912892,59.5,216838,6.9
Arkansas,2008,10,1361363,62.1,1280596,58.4,80767,5.9
California,2008,10,18283764,66.0,16755408,60.5,1528356,8.4
Los Angeles County,2008,10,4952014,66.2,4518624,60.4,433390,8.8
Colorado,2008,10,2738037,72.3,2589291,68.3,148746,5.4
Connecticut,2008,10,1883668,68.9,1765753,64.6,117915,6.3
Delaware,2008,10,450134,66.1,423297,62.2,26837,6.0
District of Columbia,2008,10,336687,70.2,311389,64.9,25298,7.5
Florida,2008,10,9143874,63.0,8528323,58.8,615551,6.7
Georgia,2008,10,4763216,65.9,4387423,60.7,375793,7.9
Hawaii,2008,10,639971,65.5,609289,62.3,30682,4.8
Idaho,2008,10,764450,67.1,716492,62.9,47958,6.3
Illinois,2008,10,6602533,67.1,6133051,62.4,469482,7.1
Indiana,2008,10,3259393,66.7,3034749,62.1,224644,6.9
Iowa,2008,10,1690958,72.8,1613479,69.4,77479,4.6
Kansas,2008,10,1498893,70.8,1424409,67.3,74484,5.0
Kentucky,2008,10,2048791,61.8,1894862,57.1,153929,7.5
Louisiana,2008,10,2080286,61.8,1971443,58.6,108843,5.2
Maine,2008,10,701476,65.9,659005,61.9,42471,6.1
Maryland,2008,10,3040575,69.6,2878435,65.9,162140,5.3
Massachusetts,2008,10,3484355,67.0,3276874,63.0,207481,6.0
Michigan,2008,10,4887718,62.9,4442055,57.1,445663,9.1
Minnesota,2008,10,2930202,72.1,2755312,67.8,174890,6.0
Mississippi,2008,10,1285225,58.6,1192839,54.4,92386,7.2
Missouri,2008,10,3067640,66.9,2856334,62.3,211306,6.9
Montana,2008,10,513700,67.4,485834,63.7,27866,5.4
Nebraska,2008,10,988947,73.0,954101,70.4,34846,3.5
Nevada,2008,10,1377911,69.4,1266591,63.8,111320,8.1
New Hampshire,2008,10,743369,70.6,713113,67.7,30256,4.1
New Jersey,2008,10,4514528,67.0,4236706,62.9,277822,6.2
New Mexico,2008,10,937338,62.3,892860,59.4,44478,4.7
New York,2008,10,9693575,63.4,9114128,59.6,579447,6.0
New York city,2008,10,3981539,60.5,3734723,56.7,246816,6.2
North Carolina,2008,10,4579559,65.0,4289462,60.9,290097,6.3
North Dakota,2008,10,372521,74.5,360295,72.0,12226,3.3
Ohio,2008,10,5995207,67.1,5556150,62.2,439057,7.3
Oklahoma,2008,10,1752645,63.7,1683793,61.2,68852,3.9
Oregon,2008,10,1966958,65.9,1821021,61.0,145937,7.4
Pennsylvania,2008,10,6469954,65.3,6093486,61.5,376468,5.8
Rhode Island,2008,10,568036,67.7,518421,61.8,49615,8.7
South Carolina,2008,10,2174417,62.9,1991342,57.6,183075,8.4
South Dakota,2008,10,440908,71.9,425382,69.3,15526,3.5
Tennessee,2008,10,3070955,63.5,2846010,58.8,224945,7.3
Texas,2008,10,11771507,66.0,11136874,62.4,634633,5.4
Utah,2008,10,1377244,70.8,1329258,68.3,47986,3.5
Vermont,2008,10,355352,70.3,337955,66.9,17397,4.9
Virginia,2008,10,4148057,69.7,3951093,66.4,196964,4.7
Washington,2008,10,3490210,68.2,3288871,64.3,201339,5.8
West Virginia,2008,10,806636,55.6,766594,52.9,40042,5.0
Wisconsin,2008,10,3108572,70.7,2935774,66.7,172798,5.6
Wyoming,2008,10,298085,72.2,288534,69.8,9551,3.2
Alabama,2008,11,2171630,60.2,2012593,55.8,159037,7.3
Alaska,2008,11,356617,70.6,332618,65.8,23999,6.7
Arizona,2008,11,3133420,63.9,2904315,59.2,229105,7.3
Arkansas,2008,11,1361045,62.0,1275604,58.2,85441,6.3
California,2008,11,18307599,66.0,16691191,60.2,1616408,8.8
Los Angeles County,2008,11,4956854,66.2,4499164,60.1,457690,9.2
Colorado,2008,11,2738762,72.2,2581484,68.0,157278,5.7
Connecticut,2008,11,1884613,68.9,1761893,64.4,122720,6.5
Delaware,2008,11,449376,65.9,420891,61.8,28485,6.3
District of Columbia,2008,11,336494,70.0,310042,64.5,26452,7.9
Florida,2008,11,9117676,62.8,8472472,58.3,645204,7.1
Georgia,2008,11,4761050,65.8,4364135,60.3,396915,8.3
Hawaii,2008,11,638587,65.3,605845,62.0,32742,5.1
Idaho,2008,11,764784,67.0,713504,62.5,51280,6.7
Illinois,2008,11,6594077,67.0,6104242,62.0,489835,7.4
Indiana,2008,11,3258489,66.7,3013159,61.6,245330,7.5
Iowa,2008,11,1691223,72.7,1608748,69.2,82475,4.9
Kansas,2008,11,1501360,70.9,1423372,67.2,77988,5.2
Kentucky,2008,11,2052892,61.9,1886996,56.9,165896,8.1
Louisiana,2008,11,2080055,61.7,1966607,58.4,113448,5.5
Maine,2008,11,700719,65.9,655292,61.6,45427,6.5
Maryland,2008,11,3044184,69.6,2869411,65.6,174773,5.7
Massachusetts,2008,11,3484329,66.9,3265439,62.7,218890,6.3
Michigan,2008,11,4876390,62.7,4409115,56.7,467275,9.6
Minnesota,2008,11,2932497,72.2,2747372,67.6,185125,6.3
Mississippi,2008,11,1282861,58.5,1187659,54.2,95202,7.4
Missouri,2008,11,3069076,66.8,2847323,62.0,221753,7.2
Montana,2008,11,512832,67.2,483179,63.3,29653,5.8
Nebraska,2008,11,988981,72.9,952612,70.2,36369,3.7
Nevada,2008,11,1378359,69.4,1259504,63.4,118855,8.6
New Hampshire,2008,11,742758,70.5,710772,67.4,31986,4.3
New Jersey,2008,11,4516496,67.0,4222306,62.7,294190,6.5
New Mexico,2008,11,936604,62.2,889563,59.1,47041,5.0
New York,2008,11,9703038,63.4,9091347,59.4,611691,6.3
New York city,2008,11,3990244,60.6,3727921,56.6,262323,6.6
North Carolina,2008,11,4660713,66.0,4261029,60.4,399684,8.6
North Dakota,2008,11,372157,74.3,359493,71.8,12664,3.4
Ohio,2008,11,5983594,66.9,5525376,61.8,458218,7.7
Oklahoma,2008,11,1755374,63.7,1680966,61.0,74408,4.2
Oregon,2008,11,1969619,66.0,1809879,60.6,159740,8.1
Pennsylvania,2008,11,6472379,65.3,6072949,61.3,399430,6.2
Rhode Island,2008,11,568403,67.7,516233,61.5,52170,9.2
South Carolina,2008,11,2176795,62.9,1982829,57.3,193966,8.9
South Dakota,2008,11,441280,71.9,424951,69.2,16329,3.7
Tennessee,2008,11,3069508,63.4,2832943,58.5,236565,7.7
Texas,2008,11,11784834,65.9,11123092,62.2,661742,5.6
Utah,2008,11,1371962,70.4,1322915,67.9,49047,3.6
Vermont,2008,11,356228,70.4,338176,66.9,18052,5.1
Virginia,2008,11,4146700,69.6,3938595,66.1,208105,5.0
Washington,2008,11,3488288,68.1,3277136,64.0,211152,6.1
West Virginia,2008,11,807678,55.7,764387,52.7,43291,5.4
Wisconsin,2008,11,3113762,70.8,2924909,66.5,188853,6.1
Wyoming,2008,11,298010,72.0,287926,69.6,10084,3.4
Alabama,2008,12,2171169,60.2,2001037,55.5,170132,7.8
Alaska,2008,12,357004,70.5,332312,65.6,24692,6.9
Arizona,2008,12,3135110,63.9,2892889,58.9,242221,7.7
Arkansas,2008,12,1360662,62.0,1270115,57.9,90547,6.7
California,2008,12,18327303,66.0,16614367,59.8,1712936,9.3
Los Angeles County,2008,12,4959074,66.2,4475508,59.8,483566,9.8
Colorado,2008,12,2739993,72.1,2572099,67.7,167894,6.1
Connecticut,2008,12,1885195,68.9,1757045,64.2,128150,6.8
Delaware,2008,12,448368,65.7,418100,61.3,30268,6.8
District of Columbia,2008,12,336200,69.9,308470,64.1,27730,8.2
Florida,2008,12,9086029,62.5,8409554,57.9,676475,7.4
Georgia,2008,12,4768790,65.8,4349635,60.0,419155,8.8
Hawaii,2008,12,637096,65.1,602094,61.5,35002,5.5
Idaho,2008,12,764905,67.0,710176,62.2,54729,7.2
Illinois,2008,12,6589361,66.9,6071369,61.7,517992,7.9
Indiana,2008,12,3257127,66.6,2987719,61.1,269408,8.3
Iowa,2008,12,1690582,72.7,1602026,68.9,88556,5.2
Kansas,2008,12,1504198,71.0,1421825,67.1,82373,5.5
Kentucky,2008,12,2057610,62.0,1878114,56.6,179496,8.7
Louisiana,2008,12,2078009,61.6,1959715,58.1,118294,5.7
Maine,2008,12,700292,65.8,651465,61.2,48827,7.0
Maryland,2008,12,3047840,69.7,2859476,65.4,188364,6.2
Massachusetts,2008,12,3482788,66.9,3251176,62.4,231612,6.7
Michigan,2008,12,4864371,62.6,4375398,56.3,488973,10.1
Minnesota,2008,12,2934202,72.2,2736774,67.3,197428,6.7
Mississippi,2008,12,1280995,58.4,1181857,53.9,99138,7.7
Missouri,2008,12,3070614,66.8,2837411,61.8,233203,7.6
Montana,2008,12,511355,67.0,479767,62.8,31588,6.2
Nebraska,2008,12,988919,72.9,950668,70.0,38251,3.9
Nevada,2008,12,1378215,69.3,1251597,62.9,126618,9.2
New Hampshire,2008,12,742265,70.4,708028,67.1,34237,4.6
New Jersey,2008,12,4518176,67.0,4205496,62.4,312680,6.9
New Mexico,2008,12,935301,62.1,885097,58.7,50204,5.4
New York,2008,12,9711658,63.4,9062948,59.2,648710,6.7
New York city,2008,12,3998183,60.7,3718072,56.4,280111,7.0
North Carolina,2008,12,4675867,66.2,4227952,59.8,447915,9.6
North Dakota,2008,12,371636,74.2,358367,71.5,13269,3.6
Ohio,2008,12,5970422,66.8,5487378,61.4,483044,8.1
Oklahoma,2008,12,1758229,63.8,1676316,60.8,81913,4.7
Oregon,2008,12,1971578,66.0,1795993,60.1,175585,8.9
Pennsylvania,2008,12,6471599,65.3,6045617,61.0,425982,6.6
Rhode Island,2008,12,569129,67.8,513987,61.2,55142,9.7
South Carolina,2008,12,2178566,62.9,1972839,56.9,205727,9.4
South Dakota,2008,12,441582,71.9,424301,69.1,17281,3.9
Tennessee,2008,12,3065036,63.3,2814331,58.1,250705,8.2
Texas,2008,12,11791925,65.9,11101977,62.0,689948,5.9
Utah,2008,12,1388245,71.1,1315656,67.4,72589,5.2
Vermont,2008,12,357013,70.6,338155,66.8,18858,5.3
Virginia,2008,12,4144520,69.5,3922612,65.8,221908,5.4
Washington,2008,12,3485137,67.9,3261532,63.6,223605,6.4
West Virginia,2008,12,808940,55.8,761482,52.5,47458,5.9
Wisconsin,2008,12,3118667,70.8,2909875,66.1,208792,6.7
Wyoming,2008,12,298049,71.9,287005,69.3,11044,3.7
Alabama,2009,1,2170615,60.1,1989308,55.1,181307,8.4
Alaska,2009,1,357527,70.5,331939,65.4,25588,7.2
Arizona,2009,1,3135245,63.8,2879700,58.6,255545,8.2
Arkansas,2009,1,1360180,61.9,1264593,57.6,95587,7.0
California,2009,1,18341252,66.0,16530013,59.5,1811239,9.9
Los Angeles County,2009,1,4959932,66.2,4450813,59.4,509119,10.3
Colorado,2009,1,2741783,72.0,2561844,67.3,179939,6.6
Connecticut,2009,1,1885168,68.8,1751324,64.0,133844,7.1
Delaware,2009,1,447205,65.5,415103,60.8,32102,7.2
District of Columbia,2009,1,335894,69.7,306831,63.7,29063,8.7
Florida,2009,1,9052178,62.3,8343928,57.4,708250,7.8
Georgia,2009,1,4778508,65.9,4337640,59.8,440868,9.2
Hawaii,2009,1,635569,64.9,598286,61.1,37283,5.9
Idaho,2009,1,764671,66.9,706733,61.8,57938,7.6
Illinois,2009,1,6588346,66.9,6037014,61.3,551332,8.4
Indiana,2009,1,3256297,66.5,2961664,60.5,294633,9.0
Iowa,2009,1,1689096,72.6,1594063,68.5,95033,5.6
Kansas,2009,1,1507169,71.1,1419811,67.0,87358,5.8
Kentucky,2009,1,2062601,62.1,1868875,56.3,193726,9.4
Louisiana,2009,1,2075125,61.5,1951613,57.8,123512,6.0
Maine,2009,1,700203,65.8,647898,60.9,52305,7.5
Maryland,2009,1,3051111,69.7,2849401,65.1,201710,6.6
Massachusetts,2009,1,3480717,66.8,3236069,62.1,244648,7.0
Michigan,2009,1,4875359,62.7,4342294,55.9,533065,10.9
Minnesota,2009,1,2935506,72.1,2725000,67.0,210506,7.2
Mississippi,2009,1,1279561,58.3,1175741,53.6,103820,8.1
Missouri,2009,1,3072024,66.8,2827112,61.5,244912,8.0
Montana,2009,1,509478,66.7,476051,62.3,33427,6.6
Nebraska,2009,1,988763,72.8,948435,69.8,40328,4.1
Nevada,2009,1,1377435,69.2,1243320,62.5,134115,9.7
New Hampshire,2009,1,741908,70.3,705050,66.8,36858,5.0
New Jersey,2009,1,4520580,67.0,4188473,62.1,332107,7.3
New Mexico,2009,1,933823,61.9,879969,58.3,53854,5.8
New York,2009,1,9719617,63.4,9031621,59.0,687996,7.1
New York city,2009,1,4005569,60.8,3706355,56.2,299214,7.5
North Carolina,2009,1,4671579,66.0,4192895,59.3,478684,10.2
North Dakota,2009,1,371028,74.0,357087,71.2,13941,3.8
Ohio,2009,1,5956344,66.6,5444780,60.9,511564,8.6
Oklahoma,2009,1,1761587,63.8,1670671,60.5,90916,5.2
Oregon,2009,1,1973386,66.0,1781451,59.5,191935,9.7
Pennsylvania,2009,1,6467790,65.2,6014392,60.6,453398,7.0
Rhode Island,2009,1,570102,67.9,511798,60.9,58304,10.2
South Carolina,2009,1,2179478,62.8,1961864,56.5,217614,10.0
South Dakota,2009,1,441816,71.9,423509,68.9,18307,4.1
Tennessee,2009,1,3057747,63.1,2791562,57.6,266185,8.7
Texas,2009,1,11794357,65.8,11077513,61.8,716844,6.1
Utah,2009,1,1392634,71.2,1307934,66.9,84700,6.1
Vermont,2009,1,357735,70.7,337995,66.8,19740,5.5
Virginia,2009,1,4142432,69.4,3905221,65.4,237211,5.7
Washington,2009,1,3480693,67.8,3243615,63.2,237078,6.8
West Virginia,2009,1,810279,55.8,758012,52.2,52267,6.5
Wisconsin,2009,1,3122945,70.9,2892187,65.7,230758,7.4
Wyoming,2009,1,298360,71.9,285891,68.9,12469,4.2
Alabama,2009,2,2169888,60.1,1978083,54.8,191805,8.8
Alaska,2009,2,358159,70.5,331565,65.2,26594,7.4
Arizona,2009,2,3134718,63.7,2866239,58.2,268479,8.6
Arkansas,2009,2,1359814,61.9,1259658,57.3,100156,7.4
California,2009,2,18350557,66.0,16445664,59.1,1904893,10.4
Los Angeles County,2009,2,4961033,66.1,4428376,59.0,532657,10.7
Colorado,2009,2,2743809,72.0,2551450,66.9,192359,7.0
Connecticut,2009,2,1885022,68.8,1745553,63.7,139469,7.4
Delaware,2009,2,445924,65.3,412069,60.3,33855,7.6
District of Columbia,2009,2,335788,69.6,305415,63.3,30373,9.0
Florida,2009,2,9020030,62.0,8280792,56.9,739238,8.2
Georgia,2009,2,4787926,65.9,4326851,59.6,461075,9.6
Hawaii,2009,2,634151,64.7,594807,60.7,39344,6.2
Idaho,2009,2,764044,66.8,703500,61.5,60544,7.9
Illinois,2009,2,6591950,66.9,6005570,60.9,586380,8.9
Indiana,2009,2,3255885,66.5,2937994,60.0,317891,9.8
Iowa,2009,2,1687015,72.5,1585947,68.1,101068,6.0
Kansas,2009,2,1510355,71.2,1417552,66.8,92803,6.1
Kentucky,2009,2,2067583,62.2,1860303,56.0,207280,10.0
Louisiana,2009,2,2072767,61.4,1943568,57.5,129199,6.2
Maine,2009,2,700270,65.8,644828,60.6,55442,7.9
Maryland,2009,2,3053799,69.7,2840168,64.8,213631,7.0
Massachusetts,2009,2,3478984,66.7,3221939,61.7,257045,7.4
Michigan,2009,2,4885037,62.9,4310659,55.5,574378,11.8
Minnesota,2009,2,2936857,72.1,2714157,66.7,222700,7.6
Mississippi,2009,2,1278354,58.2,1169822,53.3,108532,8.5
Missouri,2009,2,3073323,66.8,2817179,61.3,256144,8.3
Montana,2009,2,507574,66.4,472644,61.8,34930,6.9
Nebraska,2009,2,988607,72.7,946270,69.6,42337,4.3
Nevada,2009,2,1376206,69.1,1235176,62.0,141030,10.2
New Hampshire,2009,2,741687,70.3,702099,66.5,39588,5.3
New Jersey,2009,2,4524867,67.0,4173438,61.8,351429,7.8
New Mexico,2009,2,932594,61.8,874843,57.9,57751,6.2
New York,2009,2,9727756,63.5,9000993,58.7,726763,7.5
New York city,2009,2,4013572,60.9,3695020,56.0,318552,7.9
North Carolina,2009,2,4661739,65.8,4159541,58.7,502198,10.8
North Dakota,2009,2,370446,73.8,355913,70.9,14533,3.9
Ohio,2009,2,5942920,66.4,5402230,60.4,540690,9.1
Oklahoma,2009,2,1765678,63.9,1665415,60.3,100263,5.7
Oregon,2009,2,1975379,66.0,1768747,59.1,206632,10.5
Pennsylvania,2009,2,6462229,65.1,5983557,60.3,478672,7.4
Rhode Island,2009,2,571173,68.0,509825,60.7,61348,10.7
South Carolina,2009,2,2179540,62.8,1950864,56.2,228676,10.5
South Dakota,2009,2,442038,71.9,422739,68.7,19299,4.4
Tennessee,2009,2,3049266,62.8,2767661,57.0,281605,9.2
Texas,2009,2,11795821,65.7,11055073,61.5,740748,6.3
Utah,2009,2,1391346,71.0,1300274,66.4,91072,6.5
Vermont,2009,2,358464,70.8,337853,66.7,20611,5.7
Virginia,2009,2,4141054,69.3,3888770,65.1,252284,6.1
Washington,2009,2,3474872,67.6,3225423,62.7,249449,7.2
West Virginia,2009,2,811767,55.9,754397,52.0,57370,7.1
Wisconsin,2009,2,3126622,70.9,2874456,65.2,252166,8.1
Wyoming,2009,2,298950,71.9,284717,68.5,14233,4.8
Alabama,2009,3,2168962,60.0,1968035,54.5,200927,9.3
Alaska,2009,3,358815,70.5,331287,65.0,27528,7.7
Arizona,2009,3,3134761,63.6,2854602,57.9,280159,8.9
Arkansas,2009,3,1359655,61.8,1255912,57.1,103743,7.6
California,2009,3,18357115,65.9,16370975,58.8,1986140,10.8
Los Angeles County,2009,3,4962960,66.1,4410600,58.7,552360,11.1
Colorado,2009,3,2745639,71.9,2541992,66.6,203647,7.4
Connecticut,2009,3,1885758,68.8,1741164,63.5,144594,7.7
Delaware,2009,3,444546,65.0,409245,59.8,35301,7.9
District of Columbia,2009,3,335960,69.5,304404,63.0,31556,9.4
Florida,2009,3,8993087,61.8,8226093,56.5,766994,8.5
Georgia,2009,3,4796410,66.0,4318122,59.4,478288,10.0
Hawaii,2009,3,633015,64.6,592076,60.4,40939,6.5
Idaho,2009,3,763045,66.6,700851,61.2,62194,8.2
Illinois,2009,3,6599816,66.9,5981260,60.7,618556,9.4
Indiana,2009,3,3254065,66.4,2918351,59.6,335714,10.3
Iowa,2009,3,1684717,72.3,1578852,67.8,105865,6.3
Kansas,2009,3,1513752,71.3,1415542,66.7,98210,6.5
Kentucky,2009,3,2071976,62.4,1853366,55.8,218610,10.6
Louisiana,2009,3,2072027,61.3,1936935,57.3,135092,6.5
Maine,2009,3,700301,65.8,642493,60.4,57808,8.3
Maryland,2009,3,3055887,69.7,2832928,64.6,222959,7.3
Massachusetts,2009,3,3478298,66.6,3210588,61.5,267710,7.7
Michigan,2009,3,4893566,63.0,4282346,55.1,611220,12.5
Minnesota,2009,3,2938667,72.1,2706532,66.4,232135,7.9
Mississippi,2009,3,1277088,58.2,1164570,53.0,112518,8.8
Missouri,2009,3,3074303,66.8,2808736,61.1,265567,8.6
Montana,2009,3,505944,66.1,470036,61.4,35908,7.1
Nebraska,2009,3,988641,72.7,944615,69.5,44026,4.5
Nevada,2009,3,1374816,69.0,1227786,61.6,147030,10.7
New Hampshire,2009,3,741588,70.3,699527,66.3,42061,5.7
New Jersey,2009,3,4531179,67.1,4162020,61.6,369159,8.1
New Mexico,2009,3,931934,61.7,870494,57.6,61440,6.6
New York,2009,3,9657401,63.0,8896423,58.0,760978,7.9
New York city,2009,3,3943827,59.8,3607216,54.7,336611,8.5
North Carolina,2009,3,4650196,65.6,4131549,58.3,518647,11.2
North Dakota,2009,3,370006,73.7,355112,70.7,14894,4.0
Ohio,2009,3,5931002,66.3,5364822,60.0,566180,9.5
Oklahoma,2009,3,1770364,64.0,1661702,60.1,108662,6.1
Oregon,2009,3,1977117,66.0,1759644,58.7,217473,11.0
Pennsylvania,2009,3,6455797,65.1,5956881,60.0,498916,7.7
Rhode Island,2009,3,572186,68.1,508335,60.5,63851,11.2
South Carolina,2009,3,2178899,62.7,1941313,55.8,237586,10.9
South Dakota,2009,3,442303,71.8,422195,68.6,20108,4.5
Tennessee,2009,3,3041270,62.6,2746230,56.6,295040,9.7
Texas,2009,3,11799261,65.6,11040416,61.4,758845,6.4
Utah,2009,3,1387931,70.8,1293342,65.9,94589,6.8
Vermont,2009,3,359307,71.0,337951,66.7,21356,5.9
Virginia,2009,3,4140763,69.3,3875758,64.8,265005,6.4
Washington,2009,3,3467544,67.3,3209014,62.3,258530,7.5
West Virginia,2009,3,813446,56.0,751178,51.7,62268,7.7
Wisconsin,2009,3,3129930,71.0,2859606,64.9,270324,8.6
Wyoming,2009,3,299720,72.0,283647,68.1,16073,5.4
Alabama,2009,4,2167672,60.0,1959272,54.2,208400,9.6
Alaska,2009,4,359404,70.4,331163,64.9,28241,7.9
Arizona,2009,4,3135697,63.5,2845709,57.7,289988,9.2
Arkansas,2009,4,1359293,61.8,1253369,57.0,105924,7.8
California,2009,4,18360253,65.9,16310052,58.5,2050201,11.2
Los Angeles County,2009,4,4964626,66.1,4397217,58.5,567409,11.4
Colorado,2009,4,2746627,71.8,2534133,66.3,212494,7.7
Connecticut,2009,4,1887457,68.8,1738492,63.4,148965,7.9
Delaware,2009,4,443075,64.7,406789,59.4,36286,8.2
District of Columbia,2009,4,336315,69.5,303758,62.7,32557,9.7
Florida,2009,4,8974062,61.6,8182726,56.2,791336,8.8
Georgia,2009,4,4803528,66.0,4311940,59.2,491588,10.2
Hawaii,2009,4,632282,64.5,590308,60.2,41974,6.6
Idaho,2009,4,761716,66.4,698919,60.9,62797,8.2
Illinois,2009,4,6609226,67.0,5964724,60.5,644502,9.8
Indiana,2009,4,3249511,66.3,2903308,59.3,346203,10.7
Iowa,2009,4,1682539,72.2,1573692,67.5,108847,6.5
Kansas,2009,4,1517037,71.4,1414106,66.6,102931,6.8
Kentucky,2009,4,2074923,62.4,1848460,55.6,226463,10.9
Louisiana,2009,4,2072391,61.3,1932168,57.1,140223,6.8
Maine,2009,4,700192,65.8,640979,60.2,59213,8.5
Maryland,2009,4,3057218,69.7,2828165,64.5,229053,7.5
Massachusetts,2009,4,3478483,66.6,3202508,61.3,275975,7.9
Michigan,2009,4,4900321,63.1,4257967,54.8,642354,13.1
Minnesota,2009,4,2940298,72.1,2702508,66.3,237790,8.1
Mississippi,2009,4,1275427,58.1,1160113,52.8,115314,9.0
Missouri,2009,4,3074803,66.8,2802257,60.9,272546,8.9
Montana,2009,4,504683,65.9,468374,61.2,36309,7.2
Nebraska,2009,4,989011,72.7,943699,69.4,45312,4.6
Nevada,2009,4,1373429,68.8,1221385,61.2,152044,11.1
New Hampshire,2009,4,741426,70.2,697402,66.0,44024,5.9
New Jersey,2009,4,4538278,67.2,4154052,61.5,384226,8.5
New Mexico,2009,4,931753,61.6,867304,57.4,64449,6.9
New York,2009,4,9666899,63.0,8879394,57.9,787505,8.1
New York city,2009,4,3955005,59.9,3603068,54.6,351937,8.9
North Carolina,2009,4,4637538,65.3,4110725,57.9,526813,11.4
North Dakota,2009,4,369825,73.6,354854,70.6,14971,4.0
Ohio,2009,4,5920506,66.2,5335602,59.6,584904,9.9
Oklahoma,2009,4,1774985,64.1,1659766,60.0,115219,6.5
Oregon,2009,4,1977826,65.9,1754553,58.5,223273,11.3
Pennsylvania,2009,4,6448142,65.0,5935194,59.8,512948,8.0
Rhode Island,2009,4,572945,68.1,507414,60.3,65531,11.4
South Carolina,2009,4,2177493,62.6,1933791,55.6,243702,11.2
South Dakota,2009,4,442586,71.8,421978,68.5,20608,4.7
Tennessee,2009,4,3034647,62.5,2729517,56.2,305130,10.1
Texas,2009,4,11805364,65.5,11035746,61.2,769618,6.5
Utah,2009,4,1384192,70.5,1287412,65.5,96780,7.0
Vermont,2009,4,359755,71.0,337870,66.7,21885,6.1
Virginia,2009,4,4141347,69.2,3867062,64.6,274285,6.6
Washington,2009,4,3467492,67.2,3195574,62.0,271918,7.8
West Virginia,2009,4,815011,56.1,748641,51.6,66370,8.1
Wisconsin,2009,4,3132217,71.0,2848985,64.6,283232,9.0
Wyoming,2009,4,300461,72.1,282792,67.8,17669,5.9
Alabama,2009,5,2165514,59.9,1950906,53.9,214608,9.9
Alaska,2009,5,359892,70.4,331161,64.8,28731,8.0
Arizona,2009,5,3136601,63.5,2838286,57.4,298315,9.5
Arkansas,2009,5,1358162,61.7,1251338,56.9,106824,7.9
California,2009,5,18356368,65.8,16257221,58.3,2099147,11.4
Los Angeles County,2009,5,4963214,66.0,4384438,58.3,578776,11.7
Colorado,2009,5,2745488,71.7,2527186,66.0,218302,8.0
Connecticut,2009,5,1889319,68.9,1736551,63.3,152768,8.1
Delaware,2009,5,441440,64.4,404596,59.1,36844,8.3
District of Columbia,2009,5,336836,69.5,303415,62.6,33421,9.9
Florida,2009,5,8990744,61.7,8148166,55.9,842578,9.4
Georgia,2009,5,4807998,66.0,4306652,59.1,501346,10.4
Hawaii,2009,5,631952,64.4,589386,60.1,42566,6.7
Idaho,2009,5,765242,66.7,697495,60.8,67747,8.9
Illinois,2009,5,6616824,67.1,5952614,60.3,664210,10.0
Indiana,2009,5,3241440,66.1,2891493,59.0,349947,10.8
Iowa,2009,5,1680503,72.1,1570351,67.4,110152,6.6
Kansas,2009,5,1519576,71.5,1412960,66.5,106616,7.0
Kentucky,2009,5,2075708,62.4,1844941,55.5,230767,11.1
Louisiana,2009,5,2072526,61.2,1928778,57.0,143748,6.9
Maine,2009,5,699741,65.7,639964,60.1,59777,8.5
Maryland,2009,5,3057191,69.6,2824833,64.3,232358,7.6
Massachusetts,2009,5,3478354,66.5,3196305,61.1,282049,8.1
Michigan,2009,5,4904363,63.1,4236418,54.5,667945,13.6
Minnesota,2009,5,2940428,72.1,2700525,66.2,239903,8.2
Mississippi,2009,5,1272969,57.9,1155919,52.6,117050,9.2
Missouri,2009,5,3074117,66.8,2796764,60.7,277353,9.0
Montana,2009,5,503645,65.7,467389,61.0,36256,7.2
Nebraska,2009,5,989500,72.7,943261,69.3,46239,4.7
Nevada,2009,5,1371955,68.7,1215496,60.9,156459,11.4
New Hampshire,2009,5,741008,70.1,695549,65.8,45459,6.1
New Jersey,2009,5,4544120,67.2,4147183,61.4,396937,8.7
New Mexico,2009,5,931475,61.5,864960,57.1,66515,7.1
New York,2009,5,9672903,63.0,8866030,57.8,806873,8.3
New York city,2009,5,3965083,60.0,3600612,54.5,364471,9.2
North Carolina,2009,5,4628915,65.1,4101862,57.7,527053,11.4
North Dakota,2009,5,369861,73.5,355043,70.6,14818,4.0
Ohio,2009,5,5910747,66.0,5313941,59.4,596806,10.1
Oklahoma,2009,5,1778265,64.2,1658576,59.9,119689,6.7
Oregon,2009,5,1976717,65.8,1752493,58.4,224224,11.3
Pennsylvania,2009,5,6437627,64.8,5916119,59.6,521508,8.1
Rhode Island,2009,5,573225,68.1,506814,60.3,66411,11.6
South Carolina,2009,5,2175091,62.4,1927529,55.3,247562,11.4
South Dakota,2009,5,442719,71.8,421946,68.4,20773,4.7
Tennessee,2009,5,3029350,62.3,2717680,55.9,311670,10.3
Texas,2009,5,11933809,66.1,11037541,61.2,896268,7.5
Utah,2009,5,1380535,70.2,1282005,65.2,98530,7.1
Vermont,2009,5,361124,71.3,338923,66.9,22201,6.1
Virginia,2009,5,4141603,69.1,3861057,64.5,280546,6.8
Washington,2009,5,3466388,67.1,3185132,61.7,281256,8.1
West Virginia,2009,5,815875,56.2,746552,51.4,69323,8.5
Wisconsin,2009,5,3131940,71.0,2841498,64.4,290442,9.3
Wyoming,2009,5,300897,72.1,282070,67.6,18827,6.3
Alabama,2009,6,2162128,59.7,1942142,53.7,219986,10.2
Alaska,2009,6,360268,70.3,331193,64.6,29075,8.1
Arizona,2009,6,3136757,63.4,2831102,57.2,305655,9.7
Arkansas,2009,6,1356219,61.6,1249384,56.7,106835,7.9
California,2009,6,18344271,65.7,16206712,58.0,2137559,11.7
Los Angeles County,2009,6,4957047,65.9,4369451,58.1,587596,11.9
Colorado,2009,6,2741685,71.5,2520583,65.7,221102,8.1
Connecticut,2009,6,1890959,68.9,1734700,63.2,156259,8.3
Delaware,2009,6,439569,64.1,402469,58.7,37100,8.4
District of Columbia,2009,6,337534,69.5,303335,62.5,34199,10.1
Florida,2009,6,8991320,61.7,8119224,55.7,872096,9.7
Georgia,2009,6,4809047,65.9,4300595,59.0,508452,10.6
Hawaii,2009,6,631868,64.4,588993,60.0,42875,6.8
Idaho,2009,6,765973,66.6,696379,60.6,69594,9.1
Illinois,2009,6,6620584,67.1,5941437,60.2,679147,10.3
Indiana,2009,6,3229982,65.9,2881080,58.7,348902,10.8
Iowa,2009,6,1678718,72.0,1568344,67.2,110374,6.6
Kansas,2009,6,1520649,71.5,1411631,66.4,109018,7.2
Kentucky,2009,6,2074132,62.4,1841907,55.4,232225,11.2
Louisiana,2009,6,2071821,61.2,1926334,56.9,145487,7.0
Maine,2009,6,698904,65.6,639123,60.0,59781,8.6
Maryland,2009,6,3055637,69.5,2821735,64.2,233902,7.7
Massachusetts,2009,6,3477099,66.4,3190727,60.9,286372,8.2
Michigan,2009,6,4905950,63.2,4216979,54.3,688971,14.0
Minnesota,2009,6,2938602,72.0,2699072,66.1,239530,8.2
Mississippi,2009,6,1269700,57.7,1151486,52.4,118214,9.3
Missouri,2009,6,3071762,66.7,2791064,60.6,280698,9.1
Montana,2009,6,502704,65.6,466739,60.9,35965,7.2
Nebraska,2009,6,989738,72.6,942897,69.2,46841,4.7
Nevada,2009,6,1370321,68.6,1209700,60.5,160621,11.7
New Hampshire,2009,6,740388,70.1,693929,65.7,46459,6.3
New Jersey,2009,6,4547757,67.3,4139515,61.2,408242,9.0
New Mexico,2009,6,930735,61.4,863044,57.0,67691,7.3
New York,2009,6,9673753,63.0,8852531,57.7,821222,8.5
New York city,2009,6,3972691,60.1,3597951,54.4,374740,9.4
North Carolina,2009,6,4604881,64.7,4083417,57.4,521464,11.3
North Dakota,2009,6,370025,73.5,355453,70.6,14572,3.9
Ohio,2009,6,5902027,65.9,5297717,59.2,604310,10.2
Oklahoma,2009,6,1779326,64.2,1657117,59.8,122209,6.9
Oregon,2009,6,1973627,65.7,1752128,58.3,221499,11.2
Pennsylvania,2009,6,6423159,64.7,5897683,59.4,525476,8.2
Rhode Island,2009,6,572988,68.1,506299,60.2,66689,11.6
South Carolina,2009,6,2171786,62.3,1921622,55.1,250164,11.5
South Dakota,2009,6,442568,71.7,421904,68.4,20664,4.7
Tennessee,2009,6,3025629,62.2,2710361,55.7,315268,10.4
Texas,2009,6,11998393,66.4,11041350,61.1,957043,8.0
Utah,2009,6,1376948,69.9,1276697,64.8,100251,7.3
Vermont,2009,6,360821,71.2,338444,66.8,22377,6.2
Virginia,2009,6,4140712,69.1,3855929,64.3,284783,6.9
Washington,2009,6,3464827,67.0,3176939,61.4,287888,8.3
West Virginia,2009,6,815673,56.1,744591,51.3,71082,8.7
Wisconsin,2009,6,3128053,70.8,2835423,64.2,292630,9.4
Wyoming,2009,6,300868,71.9,281384,67.3,19484,6.5
Alabama,2009,7,2157556,59.6,1932774,53.4,224782,10.4
Alaska,2009,7,360424,70.2,331095,64.5,29329,8.1
Arizona,2009,7,3135266,63.3,2823229,57.0,312037,10.0
Arkansas,2009,7,1353772,61.4,1247347,56.6,106425,7.9
California,2009,7,18323390,65.6,16154640,57.8,2168750,11.8
Los Angeles County,2009,7,4945908,65.7,4351482,57.8,594426,12.0
Colorado,2009,7,2735370,71.2,2513522,65.4,221848,8.1
Connecticut,2009,7,1891930,68.9,1732321,63.1,159609,8.4
Delaware,2009,7,437522,63.8,400274,58.3,37248,8.5
District of Columbia,2009,7,338299,69.6,303415,62.4,34884,10.3
Florida,2009,7,8985929,61.6,8092905,55.5,893024,9.9
Georgia,2009,7,4806283,65.8,4292715,58.8,513568,10.7
Hawaii,2009,7,631704,64.3,588669,60.0,43035,6.8
Idaho,2009,7,765397,66.5,695387,60.4,70010,9.1
Illinois,2009,7,6618475,67.0,5927060,60.0,691415,10.4
Indiana,2009,7,3216060,65.5,2870731,58.5,345329,10.7
Iowa,2009,7,1676953,71.9,1566823,67.1,110130,6.6
Kansas,2009,7,1519761,71.4,1409610,66.2,110151,7.2
Kentucky,2009,7,2070370,62.2,1838771,55.3,231599,11.2
Louisiana,2009,7,2069984,61.1,1924210,56.8,145774,7.0
Maine,2009,7,697805,65.5,638257,59.9,59548,8.5
Maryland,2009,7,3052760,69.4,2818008,64.1,234752,7.7
Massachusetts,2009,7,3474026,66.3,3184659,60.8,289367,8.3
Michigan,2009,7,4881546,62.8,4199503,54.1,682043,14.0
Minnesota,2009,7,2935063,71.9,2697239,66.0,237824,8.1
Mississippi,2009,7,1266095,57.6,1146754,52.1,119341,9.4
Missouri,2009,7,3067274,66.5,2784144,60.4,283130,9.2
Montana,2009,7,501734,65.4,466047,60.7,35687,7.1
Nebraska,2009,7,989444,72.6,942248,69.1,47196,4.8
Nevada,2009,7,1368177,68.4,1203710,60.2,164467,12.0
New Hampshire,2009,7,739675,70.0,692510,65.5,47165,6.4
New Jersey,2009,7,4548943,67.2,4129968,61.0,418975,9.2
New Mexico,2009,7,929397,61.3,861120,56.8,68277,7.3
New York,2009,7,9668943,63.0,8836214,57.5,832729,8.6
New York city,2009,7,3977051,60.2,3593732,54.4,383319,9.6
North Carolina,2009,7,4597934,64.5,4084669,57.3,513265,11.2
North Dakota,2009,7,370213,73.5,355821,70.6,14392,3.9
Ohio,2009,7,5894470,65.8,5283917,59.0,610553,10.4
Oklahoma,2009,7,1777772,64.0,1654657,59.6,123115,6.9
Oregon,2009,7,1969041,65.4,1752029,58.2,217012,11.0
Pennsylvania,2009,7,6403921,64.4,5878278,59.1,525643,8.2
Rhode Island,2009,7,572299,68.0,505661,60.1,66638,11.6
South Carolina,2009,7,2167514,62.1,1915174,54.8,252340,11.6
South Dakota,2009,7,442080,71.6,421666,68.3,20414,4.6
Tennessee,2009,7,3023463,62.1,2706513,55.6,316950,10.5
Texas,2009,7,12027290,66.4,11042872,61.0,984418,8.2
Utah,2009,7,1373141,69.6,1271180,64.4,101961,7.4
Vermont,2009,7,360377,71.1,337862,66.6,22515,6.2
Virginia,2009,7,4138354,68.9,3850155,64.1,288199,7.0
Washington,2009,7,3463333,66.9,3169356,61.2,293977,8.5
West Virginia,2009,7,814325,56.0,742532,51.1,71793,8.8
Wisconsin,2009,7,3120387,70.6,2828900,64.0,291487,9.3
Wyoming,2009,7,300467,71.7,280658,67.0,19809,6.6
Alabama,2009,8,2152222,59.4,1923196,53.1,229026,10.6
Alaska,2009,8,360299,70.1,330803,64.4,29496,8.2
Arizona,2009,8,3131513,63.1,2814158,56.7,317355,10.1
Arkansas,2009,8,1351081,61.3,1245167,56.5,105914,7.8
California,2009,8,18295071,65.4,16100602,57.5,2194469,12.0
Los Angeles County,2009,8,4930956,65.4,4331419,57.5,599537,12.2
Colorado,2009,8,2727247,70.9,2505320,65.1,221927,8.1
Connecticut,2009,8,1891764,68.8,1728836,62.9,162928,8.6
Delaware,2009,8,435435,63.4,398014,57.9,37421,8.6
District of Columbia,2009,8,339054,69.6,303600,62.3,35454,10.5
Florida,2009,8,8978345,61.5,8067438,55.3,910907,10.1
Georgia,2009,8,4799902,65.6,4282945,58.6,516957,10.8
Hawaii,2009,8,631317,64.3,588153,59.9,43164,6.8
Idaho,2009,8,764334,66.4,694403,60.3,69931,9.1
Illinois,2009,8,6610820,66.9,5907507,59.8,703313,10.6
Indiana,2009,8,3201118,65.2,2860122,58.2,340996,10.7
Iowa,2009,8,1674750,71.7,1565031,67.0,109719,6.6
Kansas,2009,8,1516989,71.2,1406736,66.0,110253,7.3
Kentucky,2009,8,2064926,62.0,1835411,55.1,229515,11.1
Louisiana,2009,8,2067196,60.9,1921831,56.6,145365,7.0
Maine,2009,8,696562,65.4,637239,59.8,59323,8.5
Maryland,2009,8,3048938,69.3,2813403,63.9,235535,7.7
Massachusetts,2009,8,3469286,66.2,3177920,60.6,291366,8.4
Michigan,2009,8,4856487,62.5,4184303,53.8,672184,13.8
Minnesota,2009,8,2930548,71.7,2694937,65.9,235611,8.0
Mississippi,2009,8,1262789,57.4,1141924,51.9,120865,9.6
Missouri,2009,8,3060731,66.3,2775832,60.2,284899,9.3
Montana,2009,8,500707,65.2,465128,60.6,35579,7.1
Nebraska,2009,8,988595,72.4,941206,69.0,47389,4.8
Nevada,2009,8,1365329,68.2,1197462,59.8,167867,12.3
New Hampshire,2009,8,738881,69.8,691170,65.3,47711,6.5
New Jersey,2009,8,4548092,67.2,4119022,60.8,429070,9.4
New Mexico,2009,8,927445,61.1,858923,56.6,68522,7.4
New York,2009,8,9659298,62.9,8816461,57.4,842837,8.7
New York city,2009,8,3978106,60.1,3587532,54.2,390574,9.8
North Carolina,2009,8,4589848,64.4,4084287,57.3,505561,11.0
North Dakota,2009,8,370339,73.4,356001,70.6,14338,3.9
Ohio,2009,8,5888132,65.7,5270650,58.8,617482,10.5
Oklahoma,2009,8,1773942,63.9,1650963,59.4,122979,6.9
Oregon,2009,8,1963985,65.2,1751276,58.1,212709,10.8
Pennsylvania,2009,8,6380840,64.2,5857656,58.9,523184,8.2
Rhode Island,2009,8,571336,67.8,504843,59.9,66493,11.6
South Carolina,2009,8,2162403,61.8,1907931,54.6,254472,11.8
South Dakota,2009,8,441357,71.4,421142,68.1,20215,4.6
Tennessee,2009,8,3022770,62.0,2705032,55.5,317738,10.5
Texas,2009,8,12035941,66.4,11040880,60.9,995061,8.3
Utah,2009,8,1368895,69.2,1265371,64.0,103524,7.6
Vermont,2009,8,359802,70.9,337117,66.4,22685,6.3
Virginia,2009,8,4134913,68.8,3843174,63.9,291739,7.1
Washington,2009,8,3462571,66.8,3161327,61.0,301244,8.7
West Virginia,2009,8,812047,55.9,740294,50.9,71753,8.8
Wisconsin,2009,8,3110072,70.4,2820936,63.8,289136,9.3
Wyoming,2009,8,299950,71.6,279871,66.8,20079,6.7
Alabama,2009,9,2146808,59.2,1914421,52.8,232387,10.8
Alaska,2009,9,360018,70.1,330431,64.3,29587,8.2
Arizona,2009,9,3126346,62.9,2804614,56.5,321732,10.3
Arkansas,2009,9,1348368,61.1,1242864,56.3,105504,7.8
California,2009,9,18266064,65.2,16049842,57.3,2216222,12.1
Los Angeles County,2009,9,4915332,65.2,4312052,57.2,603280,12.3
Colorado,2009,9,2718739,70.6,2496342,64.8,222397,8.2
Connecticut,2009,9,1890575,68.7,1724297,62.7,166278,8.8
Delaware,2009,9,433494,63.0,395820,57.6,37674,8.7
District of Columbia,2009,9,339661,69.6,303787,62.2,35874,10.6
Florida,2009,9,8971805,61.4,8044442,55.0,927363,10.3
Georgia,2009,9,4791624,65.4,4272839,58.4,518785,10.8
Hawaii,2009,9,630905,64.2,587593,59.8,43312,6.9
Idaho,2009,9,763191,66.2,693446,60.1,69745,9.1
Illinois,2009,9,6601019,66.7,5885181,59.5,715838,10.8
Indiana,2009,9,3187111,64.9,2849830,58.0,337281,10.6
Iowa,2009,9,1671946,71.5,1562768,66.9,109178,6.5
Kansas,2009,9,1513022,70.9,1403365,65.8,109657,7.2
Kentucky,2009,9,2059145,61.8,1832168,55.0,226977,11.0
Louisiana,2009,9,2064076,60.8,1919181,56.5,144895,7.0
Maine,2009,9,695385,65.3,636129,59.7,59256,8.5
Maryland,2009,9,3044831,69.1,2808298,63.7,236533,7.8
Massachusetts,2009,9,3464412,66.0,3171810,60.4,292602,8.4
Michigan,2009,9,4832672,62.2,4171972,53.7,660700,13.7
Minnesota,2009,9,2926112,71.5,2692908,65.8,233204,8.0
Mississippi,2009,9,1260410,57.2,1137403,51.6,123007,9.8
Missouri,2009,9,3053430,66.1,2767093,59.9,286337,9.4
Montana,2009,9,499791,65.0,464097,60.4,35694,7.1
Nebraska,2009,9,987507,72.3,939966,68.8,47541,4.8
Nevada,2009,9,1362186,68.0,1191275,59.5,170911,12.5
New Hampshire,2009,9,738126,69.7,689936,65.2,48190,6.5
New Jersey,2009,9,4546766,67.1,4109034,60.6,437732,9.6
New Mexico,2009,9,925248,60.9,856574,56.4,68674,7.4
New York,2009,9,9647854,62.8,8796265,57.2,851589,8.8
New York city,2009,9,3977085,60.1,3580844,54.1,396241,10.0
North Carolina,2009,9,4583348,64.2,4082693,57.2,500655,10.9
North Dakota,2009,9,370388,73.4,356037,70.5,14351,3.9
Ohio,2009,9,5883486,65.7,5257988,58.7,625498,10.6
Oklahoma,2009,9,1769326,63.6,1646669,59.2,122657,6.9
Oregon,2009,9,1959776,65.0,1750074,58.0,209702,10.7
Pennsylvania,2009,9,6357890,63.9,5837681,58.7,520209,8.2
Rhode Island,2009,9,570350,67.7,503932,59.8,66418,11.6
South Carolina,2009,9,2157433,61.6,1900913,54.3,256520,11.9
South Dakota,2009,9,440625,71.2,420427,67.9,20198,4.6
Tennessee,2009,9,3023659,62.0,2705490,55.5,318169,10.5
Texas,2009,9,12036191,66.3,11038831,60.8,997360,8.3
Utah,2009,9,1364462,68.9,1259612,63.6,104850,7.7
Vermont,2009,9,359182,70.7,336279,66.2,22903,6.4
Virginia,2009,9,4131421,68.7,3835560,63.7,295861,7.2
Washington,2009,9,3463071,66.7,3152726,60.7,310345,9.0
West Virginia,2009,9,809466,55.7,738033,50.7,71433,8.8
Wisconsin,2009,9,3099185,70.1,2812227,63.6,286958,9.3
Wyoming,2009,9,299610,71.4,279101,66.5,20509,6.8
Alabama,2009,10,2142208,59.0,1907643,52.5,234565,10.9
Alaska,2009,10,359711,70.0,330034,64.2,29677,8.3
Arizona,2009,10,3120895,62.7,2795851,56.2,325044,10.4
Arkansas,2009,10,1345775,60.9,1240400,56.1,105375,7.8
California,2009,10,18243355,65.0,16007637,57.1,2235718,12.3
Los Angeles County,2009,10,4902699,65.0,4296539,57.0,606160,12.4
Colorado,2009,10,2711692,70.3,2487400,64.5,224292,8.3
Connecticut,2009,10,1888815,68.6,1719152,62.4,169663,9.0
Delaware,2009,10,431859,62.7,393847,57.2,38012,8.8
District of Columbia,2009,10,340006,69.5,303892,62.1,36114,10.6
Florida,2009,10,8968645,61.3,8026138,54.9,942507,10.5
Georgia,2009,10,4783230,65.2,4264115,58.2,519115,10.9
Hawaii,2009,10,630679,64.1,587205,59.7,43474,6.9
Idaho,2009,10,762147,66.0,692584,60.0,69563,9.1
Illinois,2009,10,6593339,66.6,5864865,59.3,728474,11.0
Indiana,2009,10,3175581,64.6,2840309,57.8,335272,10.6
Iowa,2009,10,1668747,71.4,1560093,66.7,108654,6.5
Kansas,2009,10,1508787,70.7,1399911,65.6,108876,7.2
Kentucky,2009,10,2054515,61.6,1829565,54.8,224950,10.9
Louisiana,2009,10,2061211,60.6,1916572,56.4,144639,7.0
Maine,2009,10,694561,65.2,635139,59.6,59422,8.6
Maryland,2009,10,3041386,68.9,2803176,63.5,238210,7.8
Massachusetts,2009,10,3460868,65.9,3167575,60.3,293293,8.5
Michigan,2009,10,4811810,61.9,4162184,53.5,649626,13.5
Minnesota,2009,10,2922698,71.4,2691628,65.8,231070,7.9
Mississippi,2009,10,1259466,57.2,1133784,51.4,125682,10.0
Missouri,2009,10,3046720,65.9,2759008,59.7,287712,9.4
Montana,2009,10,499149,64.9,463140,60.2,36009,7.2
Nebraska,2009,10,986531,72.2,938727,68.7,47804,4.8
Nevada,2009,10,1359279,67.8,1185525,59.1,173754,12.8
New Hampshire,2009,10,737634,69.6,688986,65.0,48648,6.6
New Jersey,2009,10,4545928,67.0,4101692,60.5,444236,9.8
New Mexico,2009,10,923328,60.7,854347,56.1,68981,7.5
New York,2009,10,9636718,62.7,8778512,57.1,858206,8.9
New York city,2009,10,3974933,60.0,3575241,54.0,399692,10.1
North Carolina,2009,10,4580404,64.1,4080565,57.1,499839,10.9
North Dakota,2009,10,370429,73.3,356015,70.4,14414,3.9
Ohio,2009,10,5880324,65.6,5245920,58.5,634404,10.8
Oklahoma,2009,10,1765197,63.4,1642579,59.0,122618,6.9
Oregon,2009,10,1957509,64.8,1749082,57.9,208427,10.6
Pennsylvania,2009,10,6339102,63.7,5820126,58.5,518976,8.2
Rhode Island,2009,10,569553,67.6,503064,59.7,66489,11.7
South Carolina,2009,10,2153550,61.5,1895357,54.1,258193,12.0
South Dakota,2009,10,439992,71.0,419656,67.7,20336,4.6
Tennessee,2009,10,3025771,62.0,2707285,55.4,318486,10.5
Texas,2009,10,12036269,66.2,11040270,60.7,995999,8.3
Utah,2009,10,1360205,68.6,1254310,63.2,105895,7.8
Vermont,2009,10,358651,70.6,335482,66.0,23169,6.5
Virginia,2009,10,4128934,68.5,3828154,63.5,300780,7.3
Washington,2009,10,3456236,66.5,3143906,60.5,312330,9.0
West Virginia,2009,10,807341,55.5,736007,50.6,71334,8.8
Wisconsin,2009,10,3089933,69.8,2804121,63.4,285812,9.2
Wyoming,2009,10,299628,71.4,278438,66.3,21190,7.1
Alabama,2009,11,2139947,58.9,1904011,52.4,235936,11.0
Alaska,2009,11,359647,69.9,329798,64.1,29849,8.3
Arizona,2009,11,3116842,62.6,2789383,56.0,327459,10.5
Arkansas,2009,11,1343857,60.8,1238191,56.0,105666,7.9
California,2009,11,18237262,64.9,15981193,56.9,2256069,12.4
Los Angeles County,2009,11,4897091,64.9,4287794,56.8,609297,12.4
Colorado,2009,11,2708033,70.1,2479744,64.2,228289,8.4
Connecticut,2009,11,1887858,68.5,1714686,62.2,173172,9.2
Delaware,2009,11,430762,62.5,392346,56.9,38416,8.9
District of Columbia,2009,11,340324,69.5,304115,62.1,36209,10.6
Florida,2009,11,8973003,61.3,8016095,54.7,956908,10.7
Georgia,2009,11,4777540,65.1,4258854,58.0,518686,10.9
Hawaii,2009,11,631046,64.1,587373,59.7,43673,6.9
Idaho,2009,11,761632,65.9,692099,59.9,69533,9.1
Illinois,2009,11,6592973,66.6,5852392,59.1,740581,11.2
Indiana,2009,11,3168554,64.4,2833101,57.6,335453,10.6
Iowa,2009,11,1666336,71.2,1558033,66.6,108303,6.5
Kansas,2009,11,1505314,70.5,1396912,65.4,108402,7.2
Kentucky,2009,11,2052571,61.5,1828591,54.8,223980,10.9
Louisiana,2009,11,2059990,60.6,1915071,56.3,144919,7.0
Maine,2009,11,694427,65.1,634580,59.5,59847,8.6
Maryland,2009,11,3040505,68.9,2799603,63.4,240902,7.9
Massachusetts,2009,11,3460102,65.8,3166227,60.2,293875,8.5
Michigan,2009,11,4796531,61.7,4155159,53.4,641372,13.4
Minnesota,2009,11,2921699,71.3,2692020,65.7,229679,7.9
Mississippi,2009,11,1260322,57.2,1131805,51.3,128517,10.2
Missouri,2009,11,3042320,65.8,2752712,59.5,289608,9.5
Montana,2009,11,498984,64.8,462518,60.1,36466,7.3
Nebraska,2009,11,986060,72.1,937863,68.6,48197,4.9
Nevada,2009,11,1357494,67.6,1180770,58.8,176724,13.0
New Hampshire,2009,11,737602,69.6,688535,65.0,49067,6.7
New Jersey,2009,11,4547032,67.0,4098119,60.4,448913,9.9
New Mexico,2009,11,922350,60.5,852745,56.0,69605,7.5
New York,2009,11,9630492,62.6,8767080,57.0,863412,9.0
New York city,2009,11,3974045,60.0,3572537,53.9,401508,10.1
North Carolina,2009,11,4583521,64.1,4080299,57.0,503222,11.0
North Dakota,2009,11,370759,73.3,356229,70.4,14530,3.9
Ohio,2009,11,5880807,65.6,5236980,58.4,643827,10.9
Oklahoma,2009,11,1762634,63.3,1639789,58.9,122845,7.0
Oregon,2009,11,1958343,64.8,1749369,57.9,208974,10.7
Pennsylvania,2009,11,6328965,63.5,5807933,58.3,521032,8.2
Rhode Island,2009,11,569272,67.5,502515,59.6,66757,11.7
South Carolina,2009,11,2151877,61.3,1892604,54.0,259273,12.0
South Dakota,2009,11,439639,70.9,419064,67.5,20575,4.7
Tennessee,2009,11,3030297,62.0,2711254,55.5,319043,10.5
Texas,2009,11,12045372,66.1,11050184,60.6,995188,8.3
Utah,2009,11,1356818,68.3,1250061,62.9,106757,7.9
Vermont,2009,11,358407,70.5,334938,65.9,23469,6.5
Virginia,2009,11,4129176,68.5,3822838,63.4,306338,7.4
Washington,2009,11,3451994,66.3,3136631,60.3,315363,9.1
West Virginia,2009,11,806250,55.4,734638,50.5,71612,8.9
Wisconsin,2009,11,3084461,69.7,2798737,63.2,285724,9.3
Wyoming,2009,11,300001,71.4,278031,66.2,21970,7.3
Alabama,2009,12,2140674,58.9,1903811,52.4,236863,11.1
Alaska,2009,12,359932,70.0,329829,64.1,30103,8.4
Arizona,2009,12,3115241,62.5,2785895,55.9,329346,10.6
Arkansas,2009,12,1343147,60.7,1236853,55.9,106294,7.9
California,2009,12,18254035,64.9,15975922,56.8,2278113,12.5
Los Angeles County,2009,12,4900294,64.9,4286945,56.8,613349,12.5
Colorado,2009,12,2708249,70.0,2474419,64.0,233830,8.6
Connecticut,2009,12,1889075,68.5,1712315,62.1,176760,9.4
Delaware,2009,12,430322,62.4,391519,56.8,38803,9.0
District of Columbia,2009,12,340983,69.5,304827,62.1,36156,10.6
Florida,2009,12,8987807,61.3,8017476,54.7,970331,10.8
Georgia,2009,12,4776286,65.0,4258241,57.9,518045,10.8
Hawaii,2009,12,632327,64.2,588446,59.8,43881,6.9
Idaho,2009,12,761927,65.9,692251,59.9,69676,9.1
Illinois,2009,12,6601820,66.6,5851687,59.1,750133,11.4
Indiana,2009,12,3167003,64.3,2829818,57.5,337185,10.6
Iowa,2009,12,1666046,71.2,1557898,66.6,108148,6.5
Kansas,2009,12,1503151,70.3,1394859,65.3,108292,7.2
Kentucky,2009,12,2053885,61.5,1829926,54.8,223959,10.9
Louisiana,2009,12,2061538,60.6,1915554,56.3,145984,7.1
Maine,2009,12,695077,65.2,634656,59.5,60421,8.7
Maryland,2009,12,3043485,68.9,2799405,63.3,244080,8.0
Massachusetts,2009,12,3462787,65.8,3168295,60.2,294492,8.5
Michigan,2009,12,4788182,61.6,4151879,53.4,636303,13.3
Minnesota,2009,12,2923951,71.3,2694944,65.8,229007,7.8
Mississippi,2009,12,1262711,57.3,1131753,51.3,130958,10.4
Missouri,2009,12,3041155,65.7,2749112,59.4,292043,9.6
Montana,2009,12,499358,64.8,462376,60.0,36982,7.4
Nebraska,2009,12,986333,72.0,937752,68.5,48581,4.9
Nevada,2009,12,1357344,67.6,1177391,58.6,179953,13.3
New Hampshire,2009,12,738068,69.6,688711,65.0,49357,6.7
New Jersey,2009,12,4551132,67.0,4099004,60.4,452128,9.9
New Mexico,2009,12,922762,60.5,852174,55.9,70588,7.6
New York,2009,12,9633209,62.6,8765800,56.9,867409,9.0
New York city,2009,12,3976918,60.0,3574645,54.0,402273,10.1
North Carolina,2009,12,4594002,64.2,4084559,57.1,509443,11.1
North Dakota,2009,12,371637,73.4,356990,70.5,14647,3.9
Ohio,2009,12,5886389,65.7,5234320,58.4,652069,11.1
Oklahoma,2009,12,1762250,63.2,1639144,58.8,123106,7.0
Oregon,2009,12,1962640,64.9,1751681,57.9,210959,10.7
Pennsylvania,2009,12,6329739,63.5,5803095,58.2,526644,8.3
Rhode Island,2009,12,569708,67.5,502523,59.6,67185,11.8
South Carolina,2009,12,2153079,61.3,1893602,53.9,259477,12.1
South Dakota,2009,12,439775,70.8,418867,67.4,20908,4.8
Tennessee,2009,12,3038713,62.1,2718884,55.6,319829,10.5
Texas,2009,12,12070223,66.1,11072620,60.7,997603,8.3
Utah,2009,12,1354784,68.1,1247251,62.7,107533,7.9
Vermont,2009,12,358555,70.5,334803,65.8,23752,6.6
Virginia,2009,12,4132983,68.5,3821237,63.3,311746,7.5
Washington,2009,12,3451532,66.2,3132862,60.1,318670,9.2
West Virginia,2009,12,806459,55.4,734370,50.4,72089,8.9
Wisconsin,2009,12,3083749,69.6,2797682,63.2,286067,9.3
Wyoming,2009,12,300619,71.5,277989,66.1,22630,7.5
Alabama,2010,1,2143297,58.9,1906185,52.4,237112,11.1
Alaska,2010,1,360431,70.0,330113,64.1,30318,8.4
Arizona,2010,1,3115797,62.4,2785351,55.8,330446,10.6
Arkansas,2010,1,1343957,60.7,1237151,55.9,106806,7.9
California,2010,1,18288466,65.0,15991766,56.8,2296700,12.6
Los Angeles County,2010,1,4909952,65.0,4292621,56.8,617331,12.6
Colorado,2010,1,2711291,70.0,2471793,63.8,239498,8.8
Connecticut,2010,1,1892594,68.6,1712632,62.1,179962,9.5
Delaware,2010,1,430527,62.4,391523,56.7,39004,9.1
District of Columbia,2010,1,342135,69.6,306215,62.3,35920,10.5
Florida,2010,1,9011633,61.4,8031055,54.7,980578,10.9
Georgia,2010,1,4778162,64.9,4261834,57.9,516328,10.8
Hawaii,2010,1,634566,64.4,590573,59.9,43993,6.9
Idaho,2010,1,762726,65.9,693074,59.9,69652,9.1
Illinois,2010,1,6616172,66.8,5862132,59.1,754040,11.4
Indiana,2010,1,3169128,64.3,2830634,57.5,338494,10.7
Iowa,2010,1,1668161,71.2,1560395,66.6,107766,6.5
Kansas,2010,1,1502302,70.3,1394052,65.2,108250,7.2
Kentucky,2010,1,2057265,61.5,1833428,54.8,223837,10.9
Louisiana,2010,1,2065893,60.6,1918232,56.3,147661,7.1
Maine,2010,1,696250,65.3,635414,59.6,60836,8.7
Maryland,2010,1,3049772,69.0,2803421,63.4,246351,8.1
Massachusetts,2010,1,3468119,65.9,3173610,60.3,294509,8.5
Michigan,2010,1,4785142,61.5,4153410,53.4,631732,13.2
Minnesota,2010,1,2928681,71.4,2700412,65.9,228269,7.8
Mississippi,2010,1,1265805,57.4,1133350,51.4,132455,10.5
Missouri,2010,1,3042296,65.7,2748478,59.4,293818,9.7
Montana,2010,1,500111,64.9,462743,60.1,37368,7.5
Nebraska,2010,1,987372,72.1,938545,68.5,48827,4.9
Nevada,2010,1,1358406,67.6,1175465,58.5,182941,13.5
New Hampshire,2010,1,738872,69.7,689553,65.0,49319,6.7
New Jersey,2010,1,4557586,67.1,4104101,60.4,453485,10.0
New Mexico,2010,1,924482,60.6,852812,55.9,71670,7.8
New York,2010,1,9644070,62.6,8775340,57.0,868730,9.0
New York city,2010,1,3983407,60.1,3581646,54.0,401761,10.1
North Carolina,2010,1,4610346,64.3,4094353,57.1,515993,11.2
North Dakota,2010,1,373035,73.6,358345,70.7,14690,3.9
Ohio,2010,1,5895027,65.7,5238928,58.4,656099,11.1
Oklahoma,2010,1,1763483,63.2,1640540,58.8,122943,7.0
Oregon,2010,1,1969690,65.1,1756262,58.0,213428,10.8
Pennsylvania,2010,1,6338833,63.6,5805453,58.2,533380,8.4
Rhode Island,2010,1,570682,67.6,503082,59.6,67600,11.8
South Carolina,2010,1,2156723,61.4,1898449,54.0,258274,12.0
South Dakota,2010,1,440408,70.8,419140,67.4,21268,4.8
Tennessee,2010,1,3050578,62.3,2730789,55.8,319789,10.5
Texas,2010,1,12108919,66.3,11106882,60.8,1002037,8.3
Utah,2010,1,1354098,68.0,1245935,62.6,108163,8.0
Vermont,2010,1,359006,70.6,335086,65.9,23920,6.7
Virginia,2010,1,4139523,68.5,3823909,63.3,315614,7.6
Washington,2010,1,3454420,66.2,3133335,60.1,321085,9.3
West Virginia,2010,1,807671,55.5,735302,50.5,72369,9.0
Wisconsin,2010,1,3086454,69.7,2800945,63.2,285509,9.3
Wyoming,2010,1,301350,71.6,278343,66.2,23007,7.6
Alabama,2010,2,2145780,59.0,1909481,52.5,236299,11.0
Alaska,2010,2,360957,70.1,330579,64.2,30378,8.4
Arizona,2010,2,3116749,62.3,2786396,55.7,330353,10.6
Arkansas,2010,2,1345947,60.8,1239114,55.9,106833,7.9
California,2010,2,18327194,65.1,16020128,56.9,2307066,12.6
Los Angeles County,2010,2,4921282,65.1,4301138,56.9,620144,12.6
Colorado,2010,2,2714852,70.0,2471124,63.8,243728,9.0
Connecticut,2010,2,1897276,68.8,1714982,62.2,182294,9.6
Delaware,2010,2,431248,62.4,392300,56.8,38948,9.0
District of Columbia,2010,2,343633,69.8,308102,62.6,35531,10.3
Florida,2010,2,9039135,61.6,8052755,54.9,986380,10.9
Georgia,2010,2,4725950,64.2,4213413,57.2,512537,10.8
Hawaii,2010,2,637461,64.7,593468,60.2,43993,6.9
Idaho,2010,2,763525,65.9,694203,59.9,69322,9.1
Illinois,2010,2,6628765,66.9,5878039,59.3,750726,11.3
Indiana,2010,2,3172852,64.4,2834812,57.5,338040,10.7
Iowa,2010,2,1671781,71.4,1564951,66.8,106830,6.4
Kansas,2010,2,1502043,70.2,1394188,65.2,107855,7.2
Kentucky,2010,2,2060696,61.6,1838044,55.0,222652,10.8
Louisiana,2010,2,2071784,60.8,1922452,56.4,149332,7.2
Maine,2010,2,697409,65.4,636533,59.7,60876,8.7
Maryland,2010,2,3057423,69.1,2810540,63.5,246883,8.1
Massachusetts,2010,2,3473982,66.0,3180656,60.4,293326,8.4
Michigan,2010,2,4784327,61.5,4158820,53.5,625507,13.1
Minnesota,2010,2,2933933,71.5,2707327,66.0,226606,7.7
Mississippi,2010,2,1268874,57.5,1135839,51.5,133035,10.5
Missouri,2010,2,3043869,65.7,2749657,59.4,294212,9.7
Montana,2010,2,500923,65.0,463419,60.1,37504,7.5
Nebraska,2010,2,988776,72.1,939919,68.6,48857,4.9
Nevada,2010,2,1359771,67.6,1174541,58.4,185230,13.6
New Hampshire,2010,2,739669,69.7,690835,65.1,48834,6.6
New Jersey,2010,2,4563977,67.2,4111253,60.5,452724,9.9
New Mexico,2010,2,926927,60.7,854371,55.9,72556,7.8
New York,2010,2,9657047,62.7,8790529,57.1,866518,9.0
New York city,2010,2,3990358,60.2,3590594,54.2,399764,10.0
North Carolina,2010,2,4627749,64.5,4107826,57.3,519923,11.2
North Dakota,2010,2,374693,73.9,360056,71.0,14637,3.9
Ohio,2010,2,5902220,65.8,5248612,58.5,653608,11.1
Oklahoma,2010,2,1765258,63.2,1643105,58.9,122153,6.9
Oregon,2010,2,1977638,65.3,1762239,58.2,215399,10.9
Pennsylvania,2010,2,6350528,63.7,5812330,58.3,538198,8.5
Rhode Island,2010,2,571720,67.8,503913,59.7,67807,11.9
South Carolina,2010,2,2161383,61.5,1905694,54.2,255689,11.8
South Dakota,2010,2,441293,70.9,419724,67.5,21569,4.9
Tennessee,2010,2,3063620,62.6,2745903,56.1,317717,10.4
Texas,2010,2,12151988,66.4,11146453,60.9,1005535,8.3
Utah,2010,2,1354151,67.9,1245598,62.5,108553,8.0
Vermont,2010,2,359539,70.6,335633,65.9,23906,6.6
Virginia,2010,2,4146809,68.6,3829743,63.3,317066,7.6
Washington,2010,2,3458632,66.2,3136999,60.1,321633,9.3
West Virginia,2010,2,809095,55.6,736973,50.6,72122,8.9
Wisconsin,2010,2,3089495,69.7,2806625,63.3,282870,9.2
Wyoming,2010,2,301933,71.7,278975,66.3,22958,7.6
Alabama,2010,3,2146904,59.0,1912541,52.5,234363,10.9
Alaska,2010,3,361357,70.2,331099,64.3,30258,8.4
Arizona,2010,3,3116147,62.3,2787165,55.7,328982,10.6
Arkansas,2010,3,1348707,60.9,1242264,56.1,106443,7.9
California,2010,3,18359589,65.1,16050996,56.9,2308593,12.6
Los Angeles County,2010,3,4931091,65.2,4309620,57.0,621471,12.6
Colorado,2010,3,2717321,70.0,2471367,63.7,245954,9.1
Connecticut,2010,3,1902002,68.9,1718400,62.3,183602,9.7
Delaware,2010,3,432340,62.5,393640,56.9,38700,9.0
District of Columbia,2010,3,345142,70.0,310074,62.9,35068,10.2
Florida,2010,3,9065533,61.7,8076970,55.0,988563,10.9
Georgia,2010,3,4708859,63.9,4201580,57.0,507279,10.8
Hawaii,2010,3,640630,65.0,596671,60.5,43959,6.9
Idaho,2010,3,763983,65.9,695240,60.0,68743,9.0
Illinois,2010,3,6634842,66.9,5894031,59.4,740811,11.2
Indiana,2010,3,3177346,64.5,2841624,57.6,335722,10.6
Iowa,2010,3,1675368,71.5,1570007,67.0,105361,6.3
Kansas,2010,3,1501694,70.1,1394805,65.2,106889,7.1
Kentucky,2010,3,2062897,61.6,1842725,55.1,220172,10.7
Louisiana,2010,3,2077866,60.9,1927051,56.5,150815,7.3
Maine,2010,3,698109,65.5,637570,59.8,60539,8.7
Maryland,2010,3,3064844,69.2,2818977,63.6,245867,8.0
Massachusetts,2010,3,3478448,66.0,3187591,60.5,290857,8.4
Michigan,2010,3,4783504,61.5,4165926,53.6,617578,12.9
Minnesota,2010,3,2938371,71.6,2714349,66.1,224022,7.6
Mississippi,2010,3,1271407,57.6,1138614,51.6,132793,10.4
Missouri,2010,3,3044587,65.7,2751280,59.4,293307,9.6
Montana,2010,3,501546,65.0,464199,60.2,37347,7.4
Nebraska,2010,3,990060,72.2,941517,68.6,48543,4.9
Nevada,2010,3,1360604,67.6,1173988,58.4,186616,13.7
New Hampshire,2010,3,740166,69.8,692203,65.2,47963,6.5
New Jersey,2010,3,4568271,67.2,4117952,60.6,450319,9.9
New Mexico,2010,3,929410,60.8,856258,56.0,73152,7.9
New York,2010,3,9666303,62.7,8804772,57.1,861531,8.9
New York city,2010,3,3994779,60.2,3598336,54.3,396443,9.9
North Carolina,2010,3,4641281,64.7,4122130,57.4,519151,11.2
North Dakota,2010,3,376324,74.1,361821,71.3,14503,3.9
Ohio,2010,3,5904597,65.8,5259913,58.6,644684,10.9
Oklahoma,2010,3,1766675,63.3,1645979,58.9,120696,6.8
Oregon,2010,3,1984778,65.5,1768457,58.3,216321,10.9
Pennsylvania,2010,3,6359683,63.8,5820638,58.4,539045,8.5
Rhode Island,2010,3,572495,67.8,504735,59.8,67760,11.8
South Carolina,2010,3,2165917,61.5,1913417,54.4,252500,11.7
South Dakota,2010,3,442184,71.0,420409,67.5,21775,4.9
Tennessee,2010,3,3076129,62.8,2762469,56.4,313660,10.2
Texas,2010,3,12191275,66.5,11184615,61.0,1006660,8.3
Utah,2010,3,1354198,67.8,1245524,62.4,108674,8.0
Vermont,2010,3,359952,70.7,336236,66.0,23716,6.6
Virginia,2010,3,4153490,68.6,3837310,63.4,316180,7.6
Washington,2010,3,3462164,66.2,3141865,60.1,320299,9.3
West Virginia,2010,3,810179,55.6,738804,50.7,71375,8.8
Wisconsin,2010,3,3090610,69.7,2812648,63.4,277962,9.0
Wyoming,2010,3,302202,71.8,279686,66.4,22516,7.5
Alabama,2010,4,2197720,59.4,1966202,53.2,231518,10.5
Alaska,2010,4,361538,70.1,331564,64.3,29974,8.3
Arizona,2010,4,3113354,64.3,2786810,57.6,326544,10.5
Arkansas,2010,4,1351964,60.6,1246062,55.8,105902,7.8
California,2010,4,18381603,64.4,16078778,56.3,2302825,12.5
Los Angeles County,2010,4,4938672,64.6,4317332,56.4,621340,12.6
Colorado,2010,4,2718188,70.6,2471781,64.2,246407,9.1
Connecticut,2010,4,1906595,68.0,1722636,61.5,183959,9.6
Delaware,2010,4,433690,61.8,395333,56.4,38357,8.8
District of Columbia,2010,4,346457,69.0,311849,62.1,34608,10.0
Florida,2010,4,9099777,60.8,8111208,54.2,988569,10.9
Georgia,2010,4,4701086,64.6,4199284,57.7,501802,10.7
Hawaii,2010,4,643754,61.9,599835,57.7,43919,6.8
Idaho,2010,4,764012,65.7,696013,59.8,67999,8.9
Illinois,2010,4,6634091,67.1,5907874,59.8,726217,10.9
Indiana,2010,4,3181319,64.1,2849394,57.4,331925,10.4
Iowa,2010,4,1677557,71.1,1573836,66.7,103721,6.2
Kansas,2010,4,1501224,69.9,1395682,65.0,105542,7.0
Kentucky,2010,4,2063774,61.8,1847055,55.3,216719,10.5
Louisiana,2010,4,2083571,60.7,1931260,56.2,152311,7.3
Maine,2010,4,698248,65.0,638356,59.4,59892,8.6
Maryland,2010,4,3071526,68.4,2827499,63.0,244027,7.9
Massachusetts,2010,4,3480846,66.6,3193516,61.1,287330,8.3
Michigan,2010,4,4781950,62.0,4173309,54.1,608641,12.7
Minnesota,2010,4,2941579,71.6,2720784,66.2,220795,7.5
Mississippi,2010,4,1273382,57.1,1141411,51.2,131971,10.4
Missouri,2010,4,3044286,65.9,2752890,59.6,291396,9.6
Montana,2010,4,501897,64.6,464966,59.8,36931,7.4
Nebraska,2010,4,991039,71.4,943174,68.0,47865,4.8
Nevada,2010,4,1360595,65.6,1173507,56.6,187088,13.8
New Hampshire,2010,4,740408,70.4,693597,65.9,46811,6.3
New Jersey,2010,4,4569772,66.5,4122909,60.0,446863,9.8
New Mexico,2010,4,931382,59.5,857944,54.8,73438,7.9
New York,2010,4,9669447,63.0,8814800,57.5,854647,8.8
New York city,2010,4,3996188,61.1,3603964,55.1,392224,9.8
North Carolina,2010,4,4647554,63.7,4134333,56.7,513221,11.0
North Dakota,2010,4,377707,72.2,363391,69.5,14316,3.8
Ohio,2010,4,5901230,65.9,5269891,58.8,631339,10.7
Oklahoma,2010,4,1767216,62.3,1648598,58.1,118618,6.7
Oregon,2010,4,1990068,65.8,1773965,58.7,216103,10.9
Pennsylvania,2010,4,6364141,63.3,5829048,58.0,535093,8.4
Rhode Island,2010,4,572934,68.2,505463,60.1,67471,11.8
South Carolina,2010,4,2169966,60.8,1920582,53.8,249384,11.5
South Dakota,2010,4,442991,71.9,421101,68.3,21890,4.9
Tennessee,2010,4,3087199,62.8,2778857,56.5,308342,10.0
Texas,2010,4,12222661,65.9,11218075,60.5,1004586,8.2
Utah,2010,4,1353881,69.4,1245364,63.8,108517,8.0
Vermont,2010,4,360198,71.1,336797,66.5,23401,6.5
Virginia,2010,4,4159068,67.6,3845699,62.5,313369,7.5
Washington,2010,4,3463843,66.2,3146041,60.1,317802,9.2
West Virginia,2010,4,810822,54.7,740453,50.0,70369,8.7
Wisconsin,2010,4,3089354,69.8,2817875,63.6,271479,8.8
Wyoming,2010,4,302183,69.8,280341,64.7,21842,7.2
Alabama,2010,5,2211777,59.8,1983756,53.6,228021,10.3
Alaska,2010,5,361511,70.0,331982,64.2,29529,8.2
Arizona,2010,5,3108504,64.2,2785501,57.5,323003,10.4
Arkansas,2010,5,1355055,60.7,1249752,56.0,105303,7.8
California,2010,5,18391244,64.4,16101040,56.4,2290204,12.5
Los Angeles County,2010,5,4943708,64.6,4324255,56.5,619453,12.5
Colorado,2010,5,2717428,70.5,2471774,64.2,245654,9.0
Connecticut,2010,5,1910818,68.1,1727354,61.6,183464,9.6
Delaware,2010,5,435187,62.0,397214,56.6,37973,8.7
District of Columbia,2010,5,347407,69.0,313225,62.2,34182,9.8
Florida,2010,5,9128507,61.0,8141742,54.4,986765,10.8
Georgia,2010,5,4695916,64.5,4199284,57.6,496632,10.6
Hawaii,2010,5,646474,62.1,602624,57.9,43850,6.8
Idaho,2010,5,763624,65.6,696473,59.8,67151,8.8
Illinois,2010,5,6627042,67.0,5918616,59.9,708426,10.7
Indiana,2010,5,3183430,64.1,2856480,57.5,326950,10.3
Iowa,2010,5,1677764,71.1,1575622,66.8,102142,6.1
Kansas,2010,5,1500581,69.8,1396641,65.0,103940,6.9
Kentucky,2010,5,2063716,61.7,1851019,55.4,212697,10.3
Louisiana,2010,5,2088368,60.8,1934470,56.3,153898,7.4
Maine,2010,5,697946,65.0,638921,59.5,59025,8.5
Maryland,2010,5,3077202,68.5,2835458,63.1,241744,7.9
Massachusetts,2010,5,3481152,66.6,3198192,61.1,282960,8.1
Michigan,2010,5,4779667,61.9,4179998,54.1,599669,12.5
Minnesota,2010,5,2943440,71.6,2726065,66.3,217375,7.4
Mississippi,2010,5,1274962,57.2,1144100,51.3,130862,10.3
Missouri,2010,5,3043234,65.8,2754497,59.6,288737,9.5
Montana,2010,5,501975,64.5,465645,59.9,36330,7.2
Nebraska,2010,5,991699,71.4,944751,68.0,46948,4.7
Nevada,2010,5,1359713,65.5,1173032,56.5,186681,13.7
New Hampshire,2010,5,740470,70.4,694958,66.0,45512,6.1
New Jersey,2010,5,4568263,66.5,4125803,60.0,442460,9.7
New Mexico,2010,5,932501,59.6,859086,54.9,73415,7.9
New York,2010,5,9665480,63.0,8819490,57.5,845990,8.8
New York city,2010,5,3994390,61.0,3607200,55.1,387190,9.7
North Carolina,2010,5,4645967,63.6,4142800,56.7,503167,10.8
North Dakota,2010,5,378740,72.3,364640,69.6,14100,3.7
Ohio,2010,5,5892307,65.8,5276565,58.9,615742,10.4
Oklahoma,2010,5,1766844,62.2,1650772,58.1,116072,6.6
Oregon,2010,5,1992953,65.8,1778073,58.7,214880,10.8
Pennsylvania,2010,5,6363851,63.3,5836971,58.0,526880,8.3
Rhode Island,2010,5,573007,68.1,506076,60.2,66931,11.7
South Carolina,2010,5,2173188,60.9,1926827,54.0,246361,11.3
South Dakota,2010,5,443666,71.9,421758,68.4,21908,4.9
Tennessee,2010,5,3096008,62.9,2793510,56.8,302498,9.8
Texas,2010,5,12244873,65.9,11246029,60.6,998844,8.2
Utah,2010,5,1353095,69.2,1245042,63.7,108053,8.0
Vermont,2010,5,360279,71.1,337283,66.6,22996,6.4
Virginia,2010,5,4163253,67.6,3854150,62.6,309103,7.4
Washington,2010,5,3463335,66.1,3148394,60.1,314941,9.1
West Virginia,2010,5,811064,54.7,741736,50.1,69328,8.5
Wisconsin,2010,5,3086350,69.7,2821846,63.7,264504,8.6
Wyoming,2010,5,301985,69.7,280897,64.8,21088,7.0
Alabama,2010,6,2214822,59.8,1990063,53.7,224759,10.1
Alaska,2010,6,361350,69.8,332315,64.2,29035,8.0
Arizona,2010,6,3102036,64.0,2782917,57.4,319119,10.3
Arkansas,2010,6,1357180,60.7,1252284,56.0,104896,7.7
California,2010,6,18389824,64.3,16113195,56.4,2276629,12.4
Los Angeles County,2010,6,4945886,64.6,4328584,56.5,617302,12.5
Colorado,2010,6,2715479,70.4,2470389,64.1,245090,9.0
Connecticut,2010,6,1914097,68.2,1731412,61.7,182685,9.5
Delaware,2010,6,436637,62.1,398992,56.8,37645,8.6
District of Columbia,2010,6,347887,69.0,314012,62.3,33875,9.7
Florida,2010,6,9150806,61.1,8165455,54.5,985351,10.8
Georgia,2010,6,4692273,64.3,4199144,57.6,493129,10.5
Hawaii,2010,6,648687,62.2,604821,58.0,43866,6.8
Idaho,2010,6,762884,65.5,696497,59.8,66387,8.7
Illinois,2010,6,6615981,66.9,5925185,59.9,690796,10.4
Indiana,2010,6,3183185,64.1,2861326,57.6,321859,10.1
Iowa,2010,6,1676132,71.0,1575290,66.7,100842,6.0
Kansas,2010,6,1499954,69.8,1397316,65.0,102638,6.8
Kentucky,2010,6,2063356,61.6,1854264,55.4,209092,10.1
Louisiana,2010,6,2091461,60.8,1935671,56.3,155790,7.4
Maine,2010,6,697428,64.9,639223,59.5,58205,8.3
Maryland,2010,6,3081487,68.5,2841759,63.2,239728,7.8
Massachusetts,2010,6,3479736,66.4,3201063,61.1,278673,8.0
Michigan,2010,6,4776679,61.9,4184137,54.2,592542,12.4
Minnesota,2010,6,2943802,71.6,2729228,66.3,214574,7.3
Mississippi,2010,6,1309109,58.6,1179145,52.8,129964,9.9
Missouri,2010,6,3041931,65.8,2755633,59.6,286298,9.4
Montana,2010,6,501750,64.5,466046,59.9,35704,7.1
Nebraska,2010,6,992091,71.4,945979,68.1,46112,4.6
Nevada,2010,6,1358272,65.4,1172324,56.5,185948,13.7
New Hampshire,2010,6,740293,70.3,695944,66.1,44349,6.0
New Jersey,2010,6,4564190,66.4,4126170,60.0,438020,9.6
New Mexico,2010,6,932541,59.5,859355,54.8,73186,7.8
New York,2010,6,9654362,62.9,8817095,57.4,837267,8.7
New York city,2010,6,3989127,60.9,3607156,55.0,381971,9.6
North Carolina,2010,6,4639128,63.4,4147049,56.7,492079,10.6
North Dakota,2010,6,379417,72.4,365524,69.7,13893,3.7
Ohio,2010,6,5879456,65.6,5278705,58.9,600751,10.2
Oklahoma,2010,6,1765862,62.1,1652192,58.1,113670,6.4
Oregon,2010,6,1994048,65.8,1780620,58.8,213428,10.7
Pennsylvania,2010,6,6360595,63.2,5842888,58.1,517707,8.1
Rhode Island,2010,6,572722,68.0,506386,60.2,66336,11.6
South Carolina,2010,6,2175384,60.9,1931588,54.0,243796,11.2
South Dakota,2010,6,444123,72.0,422282,68.4,21841,4.9
Tennessee,2010,6,3101945,63.0,2804364,56.9,297581,9.6
Texas,2010,6,12259778,65.9,11267141,60.6,992637,8.1
Utah,2010,6,1351732,69.1,1244308,63.6,107424,7.9
Vermont,2010,6,360157,71.1,337576,66.6,22581,6.3
Virginia,2010,6,4165768,67.6,3861060,62.7,304708,7.3
Washington,2010,6,3461303,66.0,3148334,60.1,312969,9.0
West Virginia,2010,6,810955,54.7,742393,50.1,68562,8.5
Wisconsin,2010,6,3082609,69.6,2824115,63.7,258494,8.4
Wyoming,2010,6,301753,69.6,281308,64.9,20445,6.8
Alabama,2010,7,2215237,59.8,1992482,53.8,222755,10.1
Alaska,2010,7,361237,69.6,332532,64.1,28705,7.9
Arizona,2010,7,3094880,63.7,2779038,57.2,315842,10.2
Arkansas,2010,7,1358003,60.7,1253026,56.0,104977,7.7
California,2010,7,18384037,64.2,16113653,56.3,2270384,12.3
Los Angeles County,2010,7,4946267,64.6,4329176,56.5,617091,12.5
Colorado,2010,7,2713677,70.3,2467557,63.9,246120,9.1
Connecticut,2010,7,1916460,68.2,1734133,61.7,182327,9.5
Delaware,2010,7,437815,62.2,400363,56.9,37452,8.6
District of Columbia,2010,7,347929,68.9,314145,62.2,33784,9.7
Florida,2010,7,9169009,61.1,8181978,54.5,987031,10.8
Georgia,2010,7,4691252,64.2,4198521,57.5,492731,10.5
Hawaii,2010,7,650583,62.3,606535,58.1,44048,6.8
Idaho,2010,7,761967,65.3,696118,59.7,65849,8.6
Illinois,2010,7,6605960,66.8,5929180,59.9,676780,10.2
Indiana,2010,7,3180859,64.0,2863150,57.6,317709,10.0
Iowa,2010,7,1673866,70.9,1573698,66.6,100168,6.0
Kansas,2010,7,1499521,69.7,1397499,65.0,102022,6.8
Kentucky,2010,7,2063585,61.6,1856614,55.4,206971,10.0
Louisiana,2010,7,2092507,60.8,1934492,56.2,158015,7.6
Maine,2010,7,697027,64.9,639323,59.5,57704,8.3
Maryland,2010,7,3084531,68.5,2845807,63.2,238724,7.7
Massachusetts,2010,7,3478152,66.3,3202585,61.1,275567,7.9
Michigan,2010,7,4773819,61.8,4184857,54.2,588962,12.3
Minnesota,2010,7,2943204,71.5,2729891,66.3,213313,7.2
Mississippi,2010,7,1326873,59.4,1196962,53.6,129911,9.8
Missouri,2010,7,3041121,65.7,2756025,59.6,285096,9.4
Montana,2010,7,501304,64.4,466066,59.9,35238,7.0
Nebraska,2010,7,992335,71.4,946748,68.1,45587,4.6
Nevada,2010,7,1357070,65.3,1171332,56.4,185738,13.7
New Hampshire,2010,7,739936,70.3,696361,66.1,43575,5.9
New Jersey,2010,7,4559205,66.3,4124395,60.0,434810,9.5
New Mexico,2010,7,931590,59.4,858753,54.7,72837,7.8
New York,2010,7,9638270,62.7,8807520,57.3,830750,8.6
New York city,2010,7,3981631,60.7,3604179,55.0,377452,9.5
North Carolina,2010,7,4631078,63.2,4147718,56.6,483360,10.4
North Dakota,2010,7,379868,72.4,366120,69.8,13748,3.6
Ohio,2010,7,5866162,65.4,5277025,58.8,589137,10.0
Oklahoma,2010,7,1764974,62.0,1652848,58.1,112126,6.4
Oregon,2010,7,1994552,65.8,1781970,58.8,212582,10.7
Pennsylvania,2010,7,6357444,63.1,5846188,58.1,511256,8.0
Rhode Island,2010,7,572214,67.9,506297,60.1,65917,11.5
South Carolina,2010,7,2177246,60.9,1934931,54.1,242315,11.1
South Dakota,2010,7,444371,71.9,422617,68.4,21754,4.9
Tennessee,2010,7,3105034,63.0,2810185,57.0,294849,9.5
Texas,2010,7,12272590,65.9,11282344,60.6,990246,8.1
Utah,2010,7,1350000,68.9,1243121,63.4,106879,7.9
Vermont,2010,7,359881,71.0,337624,66.6,22257,6.2
Virginia,2010,7,4167097,67.6,3865710,62.7,301387,7.2
Washington,2010,7,3458973,65.9,3146426,60.0,312547,9.0
West Virginia,2010,7,810702,54.7,742317,50.1,68385,8.4
Wisconsin,2010,7,3079417,69.5,2824935,63.7,254482,8.3
Wyoming,2010,7,301585,69.5,281564,64.9,20021,6.6
Alabama,2010,8,2215825,59.7,1993456,53.8,222369,10.0
Alaska,2010,8,361349,69.5,332690,64.0,28659,7.9
Arizona,2010,8,3088178,63.5,2774664,57.1,313514,10.2
Arkansas,2010,8,1357870,60.6,1252260,55.9,105610,7.8
California,2010,8,18380281,64.2,16106916,56.2,2273365,12.4
Los Angeles County,2010,8,4946894,64.5,4327716,56.5,619178,12.5
Colorado,2010,8,2713080,70.2,2464356,63.7,248724,9.2
Connecticut,2010,8,1918237,68.2,1735650,61.7,182587,9.5
Delaware,2010,8,438620,62.3,401248,57.0,37372,8.5
District of Columbia,2010,8,347691,68.7,313803,62.0,33888,9.7
Florida,2010,8,9186214,61.1,8194731,54.5,991483,10.8
Georgia,2010,8,4693766,64.2,4198504,57.4,495262,10.6
Hawaii,2010,8,652315,62.4,607978,58.2,44337,6.8
Idaho,2010,8,761137,65.2,695586,59.6,65551,8.6
Illinois,2010,8,6600053,66.7,5933099,59.9,666954,10.1
Indiana,2010,8,3177460,63.9,2862980,57.6,314480,9.9
Iowa,2010,8,1672341,70.8,1572218,66.5,100123,6.0
Kansas,2010,8,1499329,69.7,1397291,64.9,102038,6.8
Kentucky,2010,8,2064904,61.6,1858381,55.4,206523,10.0
Louisiana,2010,8,2091887,60.7,1931705,56.0,160182,7.7
Maine,2010,8,697050,64.8,639483,59.5,57567,8.3
Maryland,2010,8,3087064,68.5,2848274,63.2,238790,7.7
Massachusetts,2010,8,3477864,66.3,3203993,61.0,273871,7.9
Michigan,2010,8,4754004,61.5,4183007,54.1,570997,12.0
Minnesota,2010,8,2942522,71.4,2728897,66.2,213625,7.3
Mississippi,2010,8,1336480,59.8,1205884,53.9,130596,9.8
Missouri,2010,8,3041423,65.7,2755882,59.5,285541,9.4
Montana,2010,8,500825,64.3,465795,59.8,35030,7.0
Nebraska,2010,8,992637,71.3,947230,68.1,45407,4.6
Nevada,2010,8,1356662,65.3,1170347,56.3,186315,13.7
New Hampshire,2010,8,739536,70.2,696314,66.1,43222,5.8
New Jersey,2010,8,4554955,66.2,4121586,59.9,433369,9.5
New Mexico,2010,8,930117,59.2,857660,54.6,72457,7.8
New York,2010,8,9621243,62.6,8794278,57.2,826965,8.6
New York city,2010,8,3974581,60.6,3600583,54.9,373998,9.4
North Carolina,2010,8,4625433,63.0,4146285,56.5,479148,10.4
North Dakota,2010,8,380313,72.4,366628,69.8,13685,3.6
Ohio,2010,8,5855186,65.3,5273622,58.8,581564,9.9
Oklahoma,2010,8,1764631,62.0,1653189,58.1,111442,6.3
Oregon,2010,8,1995295,65.7,1782838,58.7,212457,10.6
Pennsylvania,2010,8,6356859,63.1,5848142,58.0,508717,8.0
Rhode Island,2010,8,571663,67.8,505931,60.0,65732,11.5
South Carolina,2010,8,2179221,60.9,1937521,54.1,241700,11.1
South Dakota,2010,8,444504,71.9,422804,68.4,21700,4.9
Tennessee,2010,8,3105998,62.9,2811416,57.0,294582,9.5
Texas,2010,8,12287949,65.9,11294712,60.6,993237,8.1
Utah,2010,8,1348321,68.7,1241798,63.3,106523,7.9
Vermont,2010,8,359635,70.9,337553,66.5,22082,6.1
Virginia,2010,8,4168162,67.5,3868904,62.6,299258,7.2
Washington,2010,8,3457191,65.8,3143795,59.9,313396,9.1
West Virginia,2010,8,810504,54.6,741710,50.0,68794,8.5
Wisconsin,2010,8,3077502,69.4,2825260,63.7,252242,8.2
Wyoming,2010,8,301540,69.4,281736,64.9,19804,6.6
Alabama,2010,9,2216902,59.7,1993580,53.7,223322,10.1
Alaska,2010,9,361682,69.5,332846,63.9,28836,8.0
Arizona,2010,9,3082127,63.3,2770279,56.9,311848,10.1
Arkansas,2010,9,1357262,60.6,1250630,55.8,106632,7.9
California,2010,9,18378828,64.1,16097746,56.1,2281082,12.4
Los Angeles County,2010,9,4948434,64.5,4326130,56.4,622304,12.6
Colorado,2010,9,2713611,70.1,2461710,63.6,251901,9.3
Connecticut,2010,9,1919267,68.2,1736057,61.7,183210,9.5
Delaware,2010,9,439101,62.3,401788,57.0,37313,8.5
District of Columbia,2010,9,347532,68.5,313433,61.8,34099,9.8
Florida,2010,9,9203325,61.2,8206908,54.6,996417,10.8
Georgia,2010,9,4698525,64.2,4199495,57.4,499030,10.6
Hawaii,2010,9,653928,62.5,609279,58.2,44649,6.8
Idaho,2010,9,760571,65.1,695155,59.5,65416,8.6
Illinois,2010,9,6596284,66.6,5936658,59.9,659626,10.0
Indiana,2010,9,3173755,63.8,2862333,57.5,311422,9.8
Iowa,2010,9,1672191,70.7,1571768,66.5,100423,6.0
Kansas,2010,9,1499286,69.6,1396809,64.9,102477,6.8
Kentucky,2010,9,2066702,61.6,1859754,55.4,206948,10.0
Louisiana,2010,9,2090381,60.6,1928355,55.9,162026,7.8
Maine,2010,9,697492,64.8,639857,59.5,57635,8.3
Maryland,2010,9,3089416,68.4,2850163,63.1,239253,7.7
Massachusetts,2010,9,3478753,66.2,3205662,61.0,273091,7.9
Michigan,2010,9,4735269,61.3,4179731,54.1,555538,11.7
Minnesota,2010,9,2942201,71.4,2727753,66.2,214448,7.3
Mississippi,2010,9,1341711,60.0,1210162,54.1,131549,9.8
Missouri,2010,9,3042363,65.7,2755310,59.5,287053,9.4
Montana,2010,9,500372,64.2,465321,59.7,35051,7.0
Nebraska,2010,9,993061,71.3,947558,68.0,45503,4.6
Nevada,2010,9,1356846,65.2,1169573,56.2,187273,13.8
New Hampshire,2010,9,739060,70.1,695941,66.0,43119,5.8
New Jersey,2010,9,4552048,66.1,4118480,59.8,433568,9.5
New Mexico,2010,9,928535,59.0,856477,54.5,72058,7.8
New York,2010,9,9605787,62.4,8780710,57.1,825077,8.6
New York city,2010,9,3969585,60.4,3597978,54.8,371607,9.4
North Carolina,2010,9,4623661,62.9,4144357,56.4,479304,10.4
North Dakota,2010,9,380880,72.4,367203,69.8,13677,3.6
Ohio,2010,9,5846806,65.1,5270258,58.7,576548,9.9
Oklahoma,2010,9,1764391,61.9,1653363,58.0,111028,6.3
Oregon,2010,9,1996450,65.7,1783866,58.7,212584,10.6
Pennsylvania,2010,9,6358506,63.1,5850062,58.0,508444,8.0
Rhode Island,2010,9,571043,67.7,505366,60.0,65677,11.5
South Carolina,2010,9,2180881,60.9,1939615,54.1,241266,11.1
South Dakota,2010,9,444594,71.8,422872,68.3,21722,4.9
Tennessee,2010,9,3105987,62.9,2809706,56.9,296281,9.5
Texas,2010,9,12306687,65.9,11306167,60.5,1000520,8.1
Utah,2010,9,1346821,68.5,1240547,63.1,106274,7.9
Vermont,2010,9,359493,70.8,337459,66.5,22034,6.1
Virginia,2010,9,4169589,67.4,3871974,62.6,297615,7.1
Washington,2010,9,3456058,65.7,3141316,59.7,314742,9.1
West Virginia,2010,9,810266,54.6,740860,49.9,69406,8.6
Wisconsin,2010,9,3076543,69.3,2825612,63.7,250931,8.2
Wyoming,2010,9,301652,69.4,281862,64.9,19790,6.6
Alabama,2010,10,2217869,59.7,1993177,53.7,224692,10.1
Alaska,2010,10,362226,69.4,333152,63.9,29074,8.0
Arizona,2010,10,3076852,63.1,2766599,56.7,310253,10.1
Arkansas,2010,10,1356803,60.5,1249134,55.7,107669,7.9
California,2010,10,18378713,64.0,16092500,56.0,2286213,12.4
Los Angeles County,2010,10,4950288,64.5,4325771,56.3,624517,12.6
Colorado,2010,10,2714795,70.0,2460636,63.4,254159,9.4
Connecticut,2010,10,1919649,68.2,1735952,61.6,183697,9.6
Delaware,2010,10,439480,62.3,402336,57.0,37144,8.5
District of Columbia,2010,10,347817,68.4,313491,61.6,34326,9.9
Florida,2010,10,9215892,61.2,8216792,54.5,999100,10.8
Georgia,2010,10,4703944,64.2,4202054,57.4,501890,10.7
Hawaii,2010,10,655653,62.6,610770,58.3,44883,6.8
Idaho,2010,10,760364,65.0,695058,59.4,65306,8.6
Illinois,2010,10,6592116,66.5,5939556,59.9,652560,9.9
Indiana,2010,10,3170742,63.7,2863424,57.5,307318,9.7
Iowa,2010,10,1673392,70.7,1572819,66.5,100573,6.0
Kansas,2010,10,1499560,69.6,1396563,64.8,102997,6.9
Kentucky,2010,10,2068269,61.6,1861137,55.4,207132,10.0
Louisiana,2010,10,2089083,60.5,1925719,55.7,163364,7.8
Maine,2010,10,698162,64.9,640515,59.5,57647,8.3
Maryland,2010,10,3091736,68.4,2852813,63.1,238923,7.7
Massachusetts,2010,10,3480429,66.2,3208079,61.0,272350,7.8
Michigan,2010,10,4717673,61.0,4177199,54.0,540474,11.5
Minnesota,2010,10,2942469,71.3,2728215,66.1,214254,7.3
Mississippi,2010,10,1344467,60.1,1212089,54.2,132378,9.8
Missouri,2010,10,3043450,65.7,2755173,59.4,288277,9.5
Montana,2010,10,500038,64.1,464869,59.6,35169,7.0
Nebraska,2010,10,993816,71.3,948117,68.0,45699,4.6
Nevada,2010,10,1357352,65.2,1169345,56.2,188007,13.9
New Hampshire,2010,10,738460,70.0,695479,65.9,42981,5.8
New Jersey,2010,10,4551095,66.0,4116728,59.7,434367,9.5
New Mexico,2010,10,927187,58.9,855710,54.4,71477,7.7
New York,2010,10,9593183,62.3,8770596,57.0,822587,8.6
New York city,2010,10,3967015,60.3,3597685,54.7,369330,9.3
North Carolina,2010,10,4626410,62.9,4144561,56.3,481849,10.4
North Dakota,2010,10,381637,72.4,367989,69.8,13648,3.6
Ohio,2010,10,5840618,65.0,5269337,58.7,571281,9.8
Oklahoma,2010,10,1764070,61.9,1653719,58.0,110351,6.3
Oregon,2010,10,1998014,65.7,1786006,58.7,212008,10.6
Pennsylvania,2010,10,6362019,63.1,5854037,58.0,507982,8.0
Rhode Island,2010,10,570297,67.6,504726,59.9,65571,11.5
South Carolina,2010,10,2182059,60.8,1941633,54.1,240426,11.0
South Dakota,2010,10,444813,71.8,422952,68.3,21861,4.9
Tennessee,2010,10,3106786,62.8,2808210,56.8,298576,9.6
Texas,2010,10,12329159,65.9,11320132,60.5,1009027,8.2
Utah,2010,10,1345724,68.4,1239726,63.0,105998,7.9
Vermont,2010,10,359468,70.7,337452,66.4,22016,6.1
Virginia,2010,10,4172079,67.4,3876726,62.6,295353,7.1
Washington,2010,10,3455291,65.6,3139893,59.6,315398,9.1
West Virginia,2010,10,809927,54.6,740140,49.9,69787,8.6
Wisconsin,2010,10,3076209,69.3,2826902,63.6,249307,8.1
Wyoming,2010,10,301921,69.4,282034,64.9,19887,6.6
Alabama,2010,11,2217791,59.7,1992440,53.6,225351,10.2
Alaska,2010,11,362765,69.4,333546,63.8,29219,8.1
Arizona,2010,11,3072209,62.9,2763909,56.6,308300,10.0
Arkansas,2010,11,1356630,60.5,1248235,55.6,108395,8.0
California,2010,11,18376501,63.9,16093722,56.0,2282779,12.4
Los Angeles County,2010,11,4951379,64.4,4327135,56.3,624244,12.6
Colorado,2010,11,2715531,69.9,2461626,63.4,253905,9.4
Connecticut,2010,11,1919392,68.1,1735829,61.6,183563,9.6
Delaware,2010,11,439945,62.3,403158,57.1,36787,8.4
District of Columbia,2010,11,348530,68.4,314014,61.6,34516,9.9
Florida,2010,11,9239476,61.3,8241889,54.6,997587,10.8
Georgia,2010,11,4708019,64.2,4205813,57.4,502206,10.7
Hawaii,2010,11,657494,62.7,612571,58.4,44923,6.8
Idaho,2010,11,760441,64.9,695300,59.4,65141,8.6
Illinois,2010,11,6584845,66.4,5940621,59.9,644224,9.8
Indiana,2010,11,3168580,63.6,2867137,57.5,301443,9.5
Iowa,2010,11,1675189,70.8,1574964,66.5,100225,6.0
Kansas,2010,11,1499951,69.6,1396803,64.8,103148,6.9
Kentucky,2010,11,2069007,61.6,1862657,55.5,206350,10.0
Louisiana,2010,11,2088150,60.4,1924248,55.7,163902,7.8
Maine,2010,11,698775,64.9,641355,59.6,57420,8.2
Maryland,2010,11,3093338,68.4,2856158,63.1,237180,7.7
Massachusetts,2010,11,3482203,66.2,3211354,61.0,270849,7.8
Michigan,2010,11,4700743,60.8,4176364,54.0,524379,11.2
Minnesota,2010,11,2942990,71.3,2730889,66.1,212101,7.2
Mississippi,2010,11,1345720,60.1,1212871,54.2,132849,9.9
Missouri,2010,11,3043917,65.7,2755917,59.4,288000,9.5
Montana,2010,11,499828,64.0,464588,59.5,35240,7.1
Nebraska,2010,11,994951,71.4,949114,68.1,45837,4.6
Nevada,2010,11,1357786,65.2,1169711,56.2,188075,13.9
New Hampshire,2010,11,737754,69.9,695164,65.8,42590,5.8
New Jersey,2010,11,4551441,66.0,4117046,59.7,434395,9.5
New Mexico,2010,11,926179,58.8,855573,54.3,70606,7.6
New York,2010,11,9581746,62.2,8764573,56.9,817173,8.5
New York city,2010,11,3965886,60.3,3599745,54.7,366141,9.2
North Carolina,2010,11,4631812,62.9,4147506,56.3,484306,10.5
North Dakota,2010,11,382500,72.5,368950,69.9,13550,3.5
Ohio,2010,11,5834361,65.0,5271037,58.7,563324,9.7
Oklahoma,2010,11,1763618,61.8,1654525,58.0,109093,6.2
Oregon,2010,11,1999456,65.6,1789598,58.8,209858,10.5
Pennsylvania,2010,11,6365866,63.1,5860034,58.1,505832,7.9
Rhode Island,2010,11,569337,67.5,504107,59.8,65230,11.5
South Carolina,2010,11,2182565,60.8,1943658,54.1,238907,10.9
South Dakota,2010,11,445167,71.8,423105,68.2,22062,5.0
Tennessee,2010,11,3109113,62.8,2809060,56.8,300053,9.7
Texas,2010,11,12352386,65.9,11337423,60.5,1014963,8.2
Utah,2010,11,1345016,68.2,1239409,62.9,105607,7.9
Vermont,2010,11,359473,70.7,337528,66.4,21945,6.1
Virginia,2010,11,4175447,67.4,3883599,62.7,291848,7.0
Washington,2010,11,3453762,65.5,3139343,59.6,314419,9.1
West Virginia,2010,11,809442,54.5,739736,49.8,69706,8.6
Wisconsin,2010,11,3075716,69.2,2829157,63.7,246559,8.0
Wyoming,2010,11,302247,69.5,282256,64.9,19991,6.6
Alabama,2010,12,2216409,59.6,1991718,53.6,224691,10.1
Alaska,2010,12,363140,69.3,333936,63.8,29204,8.0
Arizona,2010,12,3067605,62.8,2762374,56.5,305231,10.0
Arkansas,2010,12,1356570,60.4,1247898,55.6,108672,8.0
California,2010,12,18370136,63.8,16100812,56.0,2269324,12.4
Los Angeles County,2010,12,4951137,64.4,4329985,56.3,621152,12.5
Colorado,2010,12,2715890,69.8,2464572,63.4,251318,9.3
Connecticut,2010,12,1918366,68.0,1735774,61.6,182592,9.5
Delaware,2010,12,440553,62.3,404310,57.2,36243,8.2
District of Columbia,2010,12,349451,68.4,314772,61.6,34679,9.9
Florida,2010,12,9245364,61.2,8253492,54.7,991872,10.7
Georgia,2010,12,4709976,64.2,4210339,57.4,499637,10.6
Hawaii,2010,12,659209,62.8,614428,58.5,44781,6.8
Idaho,2010,12,760670,64.9,695790,59.4,64880,8.5
Illinois,2010,12,6573920,66.3,5938573,59.8,635347,9.7
Indiana,2010,12,3167428,63.5,2873191,57.6,294237,9.3
Iowa,2010,12,1676546,70.8,1577238,66.6,99308,5.9
Kansas,2010,12,1500190,69.6,1397503,64.8,102687,6.8
Kentucky,2010,12,2068709,61.6,1864297,55.5,204412,9.9
Louisiana,2010,12,2087244,60.3,1923828,55.6,163416,7.8
Maine,2010,12,699099,64.9,642145,59.6,56954,8.1
Maryland,2010,12,3093874,68.3,2859411,63.2,234463,7.6
Massachusetts,2010,12,3483339,66.1,3215075,61.0,268264,7.7
Michigan,2010,12,4684248,60.5,4176837,54.0,507411,10.8
Minnesota,2010,12,2943772,71.2,2735520,66.2,208252,7.1
Mississippi,2010,12,1346211,60.1,1213311,54.2,132900,9.9
Missouri,2010,12,3043280,65.6,2757397,59.5,285883,9.4
Montana,2010,12,499719,63.9,464553,59.4,35166,7.0
Nebraska,2010,12,996345,71.4,950496,68.1,45849,4.6
Nevada,2010,12,1357880,65.2,1170535,56.2,187345,13.8
New Hampshire,2010,12,737034,69.8,695099,65.8,41935,5.7
New Jersey,2010,12,4552026,66.0,4118834,59.7,433192,9.5
New Mexico,2010,12,925418,58.7,855971,54.3,69447,7.5
New York,2010,12,9570220,62.1,8761434,56.8,808786,8.5
New York city,2010,12,3965254,60.2,3603171,54.7,362083,9.1
North Carolina,2010,12,4636964,62.9,4152239,56.3,484725,10.5
North Dakota,2010,12,383322,72.5,369920,70.0,13402,3.5
Ohio,2010,12,5826065,64.9,5273672,58.7,552393,9.5
Oklahoma,2010,12,1762867,61.7,1655823,58.0,107044,6.1
Oregon,2010,12,2000082,65.6,1794045,58.8,206037,10.3
Pennsylvania,2010,12,6367685,63.1,5866464,58.1,501221,7.9
Rhode Island,2010,12,568158,67.4,503571,59.7,64587,11.4
South Carolina,2010,12,2182283,60.7,1945344,54.1,236939,10.9
South Dakota,2010,12,445503,71.8,423307,68.2,22196,5.0
Tennessee,2010,12,3112714,62.9,2812682,56.8,300032,9.6
Texas,2010,12,12372836,65.9,11356570,60.5,1016266,8.2
Utah,2010,12,1344606,68.1,1239497,62.8,105109,7.8
Vermont,2010,12,359459,70.7,337650,66.4,21809,6.1
Virginia,2010,12,4179321,67.4,3892116,62.7,287205,6.9
Washington,2010,12,3450811,65.4,3139125,59.5,311686,9.0
West Virginia,2010,12,808714,54.5,739615,49.8,69099,8.5
Wisconsin,2010,12,3074471,69.2,2831638,63.7,242833,7.9
Wyoming,2010,12,302487,69.5,282475,64.9,20012,6.6
Alabama,2011,1,2214624,59.6,1991574,53.6,223050,10.1
Alaska,2011,1,363404,69.3,334356,63.8,29048,8.0
Arizona,2011,1,3063471,62.6,2761928,56.4,301543,9.8
Arkansas,2011,1,1356376,60.4,1247709,55.5,108667,8.0
California,2011,1,18363805,63.8,16113386,55.9,2250419,12.3
Los Angeles County,2011,1,4950414,64.3,4333827,56.3,616587,12.5
Colorado,2011,1,2716453,69.7,2469040,63.4,247413,9.1
Connecticut,2011,1,1917092,68.0,1736022,61.5,181070,9.4
Delaware,2011,1,441299,62.3,405681,57.3,35618,8.1
District of Columbia,2011,1,350280,68.5,315386,61.6,34894,10.0
Florida,2011,1,9251721,61.2,8267299,54.7,984422,10.6
Georgia,2011,1,4711595,64.2,4216168,57.4,495427,10.5
Hawaii,2011,1,660636,62.9,616041,58.6,44595,6.8
Idaho,2011,1,761044,64.9,696460,59.4,64584,8.5
Illinois,2011,1,6562937,66.1,5934625,59.8,628312,9.6
Indiana,2011,1,3168166,63.5,2881081,57.7,287085,9.1
Iowa,2011,1,1676887,70.8,1578751,66.6,98136,5.9
Kansas,2011,1,1500267,69.6,1398503,64.8,101764,6.8
Kentucky,2011,1,2067917,61.5,1866158,55.5,201759,9.8
Louisiana,2011,1,2086142,60.2,1924090,55.6,162052,7.8
Maine,2011,1,699101,64.9,642726,59.7,56375,8.1
Maryland,2011,1,3094091,68.3,2862372,63.2,231719,7.5
Massachusetts,2011,1,3483533,66.1,3218531,61.1,265002,7.6
Michigan,2011,1,4669483,60.3,4178511,54.0,490972,10.5
Minnesota,2011,1,2945255,71.2,2741797,66.3,203458,6.9
Mississippi,2011,1,1346725,60.1,1213959,54.2,132766,9.9
Missouri,2011,1,3042146,65.6,2759423,59.5,282723,9.3
Montana,2011,1,499721,63.9,464781,59.4,34940,7.0
Nebraska,2011,1,997896,71.5,952121,68.2,45775,4.6
Nevada,2011,1,1357776,65.1,1171682,56.2,186094,13.7
New Hampshire,2011,1,736494,69.7,695308,65.8,41186,5.6
New Jersey,2011,1,4552679,66.0,4121291,59.7,431388,9.5
New Mexico,2011,1,924865,58.6,856685,54.3,68180,7.4
New York,2011,1,9559651,62.0,8760232,56.8,799419,8.4
New York city,2011,1,3965218,60.1,3607068,54.7,358150,9.0
North Carolina,2011,1,4640615,62.9,4157931,56.4,482684,10.4
North Dakota,2011,1,384036,72.6,370786,70.1,13250,3.5
Ohio,2011,1,5816035,64.7,5275424,58.7,540611,9.3
Oklahoma,2011,1,1761984,61.7,1657557,58.0,104427,5.9
Oregon,2011,1,1999833,65.5,1798493,58.9,201340,10.1
Pennsylvania,2011,1,6367786,63.1,5872521,58.2,495265,7.8
Rhode Island,2011,1,566951,67.2,503187,59.6,63764,11.2
South Carolina,2011,1,2181867,60.7,1946678,54.1,235189,10.8
South Dakota,2011,1,445750,71.8,423555,68.2,22195,5.0
Tennessee,2011,1,3117268,62.9,2818458,56.9,298810,9.6
Texas,2011,1,12391831,65.9,11377422,60.5,1014409,8.2
Utah,2011,1,1344519,68.0,1239913,62.7,104606,7.8
Vermont,2011,1,359441,70.6,337829,66.4,21612,6.0
Virginia,2011,1,4183595,67.4,3901342,62.8,282253,6.7
Washington,2011,1,3447125,65.3,3139152,59.4,307973,8.9
West Virginia,2011,1,807822,54.4,739734,49.8,68088,8.4
Wisconsin,2011,1,3072930,69.1,2834013,63.7,238917,7.8
Wyoming,2011,1,302548,69.5,282676,64.9,19872,6.6
Alabama,2011,2,2212917,59.5,1991849,53.6,221068,10.0
Alaska,2011,2,363514,69.2,334711,63.7,28803,7.9
Arizona,2011,2,3060176,62.5,2761805,56.4,298371,9.8
Arkansas,2011,2,1355709,60.3,1247149,55.5,108560,8.0
California,2011,2,18359121,63.7,16127796,55.9,2231325,12.2
Los Angeles County,2011,2,4948941,64.2,4336856,56.3,612085,12.4
Colorado,2011,2,2717045,69.7,2474007,63.4,243038,8.9
Connecticut,2011,2,1915799,67.9,1736443,61.5,179356,9.4
Delaware,2011,2,442047,62.4,407022,57.5,35025,7.9
District of Columbia,2011,2,350793,68.4,315584,61.6,35209,10.0
Florida,2011,2,9252149,61.1,8280635,54.7,971514,10.5
Georgia,2011,2,4713939,64.1,4222918,57.5,491021,10.4
Hawaii,2011,2,661609,62.9,617144,58.7,44465,6.7
Idaho,2011,2,761435,64.9,697172,59.4,64263,8.4
Illinois,2011,2,6554409,66.0,5929766,59.7,624643,9.5
Indiana,2011,2,3170670,63.5,2889335,57.9,281335,8.9
Iowa,2011,2,1676002,70.7,1579056,66.6,96946,5.8
Kansas,2011,2,1499954,69.5,1399506,64.9,100448,6.7
Kentucky,2011,2,2066889,61.4,1867770,55.5,199119,9.6
Louisiana,2011,2,2084405,60.1,1924223,55.5,160182,7.7
Maine,2011,2,698816,64.8,643048,59.7,55768,8.0
Maryland,2011,2,3094149,68.2,2864621,63.2,229528,7.4
Massachusetts,2011,2,3482261,66.0,3220677,61.0,261584,7.5
Michigan,2011,2,4665113,60.3,4180564,54.0,484549,10.4
Minnesota,2011,2,2947224,71.2,2747825,66.4,199399,6.8
Mississippi,2011,2,1347354,60.1,1214734,54.2,132620,9.8
Missouri,2011,2,3040520,65.5,2761650,59.5,278870,9.2
Montana,2011,2,499700,63.9,465116,59.5,34584,6.9
Nebraska,2011,2,999312,71.6,953729,68.3,45583,4.6
Nevada,2011,2,1357524,65.1,1172858,56.2,184666,13.6
New Hampshire,2011,2,736127,69.6,695593,65.8,40534,5.5
New Jersey,2011,2,4553050,66.0,4123511,59.7,429539,9.4
New Mexico,2011,2,924330,58.6,857362,54.3,66968,7.2
New York,2011,2,9548708,61.9,8757912,56.7,790796,8.3
New York city,2011,2,3964838,60.1,3609777,54.7,355061,9.0
North Carolina,2011,2,4642589,62.9,4163486,56.4,479103,10.3
North Dakota,2011,2,384570,72.6,371452,70.1,13118,3.4
Ohio,2011,2,5804853,64.6,5274342,58.7,530511,9.1
Oklahoma,2011,2,1760853,61.6,1659149,58.0,101704,5.8
Oregon,2011,2,1998756,65.4,1801913,59.0,196843,9.8
Pennsylvania,2011,2,6366806,63.0,5876807,58.2,489999,7.7
Rhode Island,2011,2,565786,67.1,502846,59.6,62940,11.1
South Carolina,2011,2,2181732,60.6,1947628,54.1,234104,10.7
South Dakota,2011,2,445841,71.8,423826,68.2,22015,4.9
Tennessee,2011,2,3121614,63.0,2824825,57.0,296789,9.5
Texas,2011,2,12409993,65.9,11398153,60.5,1011840,8.2
Utah,2011,2,1344597,67.9,1240415,62.7,104182,7.7
Vermont,2011,2,359320,70.6,337959,66.4,21361,5.9
Virginia,2011,2,4187549,67.4,3909662,62.9,277887,6.6
Washington,2011,2,3443437,65.1,3139149,59.4,304288,8.8
West Virginia,2011,2,806776,54.3,739946,49.8,66830,8.3
Wisconsin,2011,2,3071357,69.0,2835627,63.7,235730,7.7
Wyoming,2011,2,302436,69.4,282854,64.9,19582,6.5
Alabama,2011,3,2210958,59.4,1991840,53.6,219118,9.9
Alaska,2011,3,363451,69.1,334935,63.7,28516,7.8
Arizona,2011,3,3057262,62.3,2761339,56.3,295923,9.7
Arkansas,2011,3,1354508,60.2,1246167,55.4,108341,8.0
California,2011,3,18354669,63.6,16139805,55.9,2214864,12.1
Los Angeles County,2011,3,4945604,64.2,4337136,56.3,608468,12.3
Colorado,2011,3,2717265,69.6,2478257,63.5,239008,8.8
Connecticut,2011,3,1914283,67.8,1736677,61.5,177606,9.3
Delaware,2011,3,442611,62.4,408089,57.6,34522,7.8
District of Columbia,2011,3,351005,68.4,315406,61.4,35599,10.1
Florida,2011,3,9250847,61.1,8290918,54.7,959929,10.4
Georgia,2011,3,4716845,64.1,4229650,57.5,487195,10.3
Hawaii,2011,3,662006,62.9,617560,58.7,44446,6.7
Idaho,2011,3,761692,64.8,697768,59.4,63924,8.4
Illinois,2011,3,6548847,65.9,5923813,59.6,625034,9.5
Indiana,2011,3,3173805,63.6,2895813,58.0,277992,8.8
Iowa,2011,3,1674053,70.6,1578220,66.5,95833,5.7
Kansas,2011,3,1499072,69.5,1400245,64.9,98827,6.6
Kentucky,2011,3,2065391,61.4,1868492,55.5,196899,9.5
Louisiana,2011,3,2081558,60.0,1923559,55.5,157999,7.6
Maine,2011,3,698343,64.8,643153,59.7,55190,7.9
Maryland,2011,3,3093519,68.2,2865617,63.1,227902,7.4
Massachusetts,2011,3,3479416,65.9,3221128,61.0,258288,7.4
Michigan,2011,3,4643729,60.0,4182090,54.0,461639,9.9
Minnesota,2011,3,2948872,71.2,2751699,66.5,197173,6.7
Mississippi,2011,3,1347717,60.1,1215162,54.2,132555,9.8
Missouri,2011,3,3038234,65.4,2763601,59.5,274633,9.0
Montana,2011,3,499536,63.8,465377,59.5,34159,6.8
Nebraska,2011,3,1000380,71.6,955070,68.4,45310,4.5
Nevada,2011,3,1357202,65.0,1173836,56.3,183366,13.5
New Hampshire,2011,3,735804,69.6,695715,65.8,40089,5.4
New Jersey,2011,3,4552802,65.9,4124964,59.7,427838,9.4
New Mexico,2011,3,923689,58.5,857730,54.3,65959,7.1
New York,2011,3,9536257,61.8,8752207,56.7,784050,8.2
New York city,2011,3,3963566,60.0,3610427,54.7,353139,8.9
North Carolina,2011,3,4643342,62.8,4167826,56.4,475516,10.2
North Dakota,2011,3,384923,72.6,371894,70.1,13029,3.4
Ohio,2011,3,5793724,64.5,5270128,58.6,523596,9.0
Oklahoma,2011,3,1759425,61.5,1660147,58.0,99278,5.6
Oregon,2011,3,1997052,65.3,1803636,59.0,193416,9.7
Pennsylvania,2011,3,6364495,63.0,5877895,58.2,486600,7.6
Rhode Island,2011,3,564558,66.9,502337,59.5,62221,11.0
South Carolina,2011,3,2181809,60.6,1948272,54.1,233537,10.7
South Dakota,2011,3,445721,71.7,424072,68.2,21649,4.9
Tennessee,2011,3,3124286,63.0,2830057,57.1,294229,9.4
Texas,2011,3,12426745,65.9,11416366,60.5,1010379,8.1
Utah,2011,3,1344706,67.9,1240829,62.6,103877,7.7
Vermont,2011,3,358981,70.5,337921,66.3,21060,5.9
Virginia,2011,3,4189997,67.4,3915249,62.9,274748,6.6
Washington,2011,3,3440138,65.0,3139014,59.3,301124,8.8
West Virginia,2011,3,805513,54.2,740073,49.8,65440,8.1
Wisconsin,2011,3,3069439,69.0,2835861,63.7,233578,7.6
Wyoming,2011,3,302188,69.3,283016,64.9,19172,6.3
Alabama,2011,4,2208488,59.4,1990933,53.5,217555,9.9
Alaska,2011,4,363367,69.0,335095,63.6,28272,7.8
Arizona,2011,4,3054212,62.2,2760059,56.2,294153,9.6
Arkansas,2011,4,1353056,60.1,1244909,55.3,108147,8.0
California,2011,4,18352428,63.6,16147585,55.9,2204843,12.0
Los Angeles County,2011,4,4940635,64.0,4333771,56.2,606864,12.3
Colorado,2011,4,2717501,69.5,2481268,63.5,236233,8.7
Connecticut,2011,4,1912529,67.7,1736438,61.5,176091,9.2
Delaware,2011,4,442904,62.4,408731,57.6,34173,7.7
District of Columbia,2011,4,351063,68.2,315027,61.2,36036,10.3
Florida,2011,4,9247888,61.0,8297312,54.7,950576,10.3
Georgia,2011,4,4720314,64.1,4235488,57.5,484826,10.3
Hawaii,2011,4,661862,62.8,617235,58.6,44627,6.7
Idaho,2011,4,761780,64.8,698168,59.4,63612,8.4
Illinois,2011,4,6547150,65.9,5917025,59.5,630125,9.6
Indiana,2011,4,3177281,63.6,2899609,58.0,277672,8.7
Iowa,2011,4,1671639,70.5,1576628,66.5,95011,5.7
Kansas,2011,4,1497707,69.4,1400475,64.9,97232,6.5
Kentucky,2011,4,2063457,61.3,1867982,55.5,195475,9.5
Louisiana,2011,4,2077821,59.9,1922007,55.4,155814,7.5
Maine,2011,4,697858,64.7,643097,59.6,54761,7.8
Maryland,2011,4,3092166,68.1,2865055,63.1,227111,7.3
Massachusetts,2011,4,3476255,65.8,3220663,61.0,255592,7.4
Michigan,2011,4,4649446,60.0,4182815,54.0,466631,10.0
Minnesota,2011,4,2950303,71.2,2753517,66.5,196786,6.7
Mississippi,2011,4,1347672,60.1,1214885,54.2,132787,9.9
Missouri,2011,4,3035428,65.4,2764617,59.5,270811,8.9
Montana,2011,4,499306,63.8,465514,59.4,33792,6.8
Nebraska,2011,4,1000982,71.6,955970,68.4,45012,4.5
Nevada,2011,4,1357102,65.0,1174492,56.3,182610,13.5
New Hampshire,2011,4,735460,69.5,695495,65.7,39965,5.4
New Jersey,2011,4,4552390,65.9,4125619,59.7,426771,9.4
New Mexico,2011,4,923136,58.4,857741,54.3,65395,7.1
New York,2011,4,9523346,61.6,8742652,56.6,780694,8.2
New York city,2011,4,3961810,59.9,3609046,54.6,352764,8.9
North Carolina,2011,4,4644273,62.8,4170634,56.4,473639,10.2
North Dakota,2011,4,385203,72.5,372188,70.1,13015,3.4
Ohio,2011,4,5784616,64.3,5264185,58.6,520431,9.0
Oklahoma,2011,4,1758254,61.4,1660641,58.0,97613,5.6
Oregon,2011,4,1995371,65.2,1803756,59.0,191615,9.6
Pennsylvania,2011,4,6362143,62.9,5875646,58.1,486497,7.6
Rhode Island,2011,4,563251,66.8,501528,59.4,61723,11.0
South Carolina,2011,4,2182071,60.6,1948677,54.1,233394,10.7
South Dakota,2011,4,445389,71.6,424206,68.2,21183,4.8
Tennessee,2011,4,3124721,63.0,2832937,57.1,291784,9.3
Texas,2011,4,12444275,65.9,11431447,60.5,1012828,8.1
Utah,2011,4,1344845,67.8,1241064,62.5,103781,7.7
Vermont,2011,4,358434,70.3,337692,66.2,20742,5.8
Virginia,2011,4,4191359,67.3,3917774,62.9,273585,6.5
Washington,2011,4,3437612,64.9,3138956,59.3,298656,8.7
West Virginia,2011,4,804257,54.1,740071,49.8,64186,8.0
Wisconsin,2011,4,3067488,68.9,2834768,63.7,232720,7.6
Wyoming,2011,4,301888,69.2,283155,65.0,18733,6.2
Alabama,2011,5,2205934,59.3,1989359,53.4,216575,9.8
Alaska,2011,5,363406,68.9,335267,63.6,28139,7.7
Arizona,2011,5,3051429,62.1,2758301,56.1,293128,9.6
Arkansas,2011,5,1352224,60.0,1244047,55.2,108177,8.0
California,2011,5,18358639,63.5,16155067,55.9,2203572,12.0
Los Angeles County,2011,5,4936762,63.9,4328878,56.1,607884,12.3
Colorado,2011,5,2719021,69.4,2483775,63.4,235246,8.7
Connecticut,2011,5,1911140,67.6,1736109,61.4,175031,9.2
Delaware,2011,5,443006,62.4,408994,57.6,34012,7.7
District of Columbia,2011,5,351149,68.1,314685,61.1,36464,10.4
Florida,2011,5,9246195,60.9,8302264,54.7,943931,10.2
Georgia,2011,5,4725451,64.1,4240831,57.6,484620,10.3
Hawaii,2011,5,661495,62.8,616453,58.5,45042,6.8
Idaho,2011,5,761901,64.7,698553,59.3,63348,8.3
Illinois,2011,5,6550817,65.9,5911356,59.5,639461,9.8
Indiana,2011,5,3181683,63.7,2901364,58.0,280319,8.8
Iowa,2011,5,1669479,70.3,1574841,66.3,94638,5.7
Kansas,2011,5,1496444,69.3,1400405,64.8,96039,6.4
Kentucky,2011,5,2061619,61.2,1866520,55.4,195099,9.5
Louisiana,2011,5,2074388,59.7,1920250,55.3,154138,7.4
Maine,2011,5,697593,64.7,643030,59.6,54563,7.8
Maryland,2011,5,3091054,68.0,2863648,63.0,227406,7.4
Massachusetts,2011,5,3474604,65.7,3220732,60.9,253872,7.3
Michigan,2011,5,4655295,60.1,4183535,54.0,471760,10.1
Minnesota,2011,5,2952020,71.2,2754433,66.4,197587,6.7
Mississippi,2011,5,1347406,60.1,1214100,54.1,133306,9.9
Missouri,2011,5,3032973,65.3,2764945,59.5,268028,8.8
Montana,2011,5,499226,63.7,465635,59.4,33591,6.7
Nebraska,2011,5,1001373,71.6,956621,68.4,44752,4.5
Nevada,2011,5,1357610,65.0,1175043,56.3,182567,13.4
New Hampshire,2011,5,735189,69.4,695005,65.6,40184,5.5
New Jersey,2011,5,4553143,65.9,4126387,59.7,426756,9.4
New Mexico,2011,5,923007,58.4,857556,54.2,65451,7.1
New York,2011,5,9513763,61.5,8731832,56.5,781931,8.2
New York city,2011,5,3961304,59.9,3606954,54.5,354350,8.9
North Carolina,2011,5,4646793,62.8,4172192,56.4,474601,10.2
North Dakota,2011,5,385579,72.5,372496,70.1,13083,3.4
Ohio,2011,5,5778681,64.3,5258057,58.5,520624,9.0
Oklahoma,2011,5,1758164,61.4,1661115,58.0,97049,5.5
Oregon,2011,5,1994438,65.1,1802840,58.9,191598,9.6
Pennsylvania,2011,5,6362257,62.9,5872236,58.1,490021,7.7
Rhode Island,2011,5,562055,66.6,500504,59.3,61551,11.0
South Carolina,2011,5,2182996,60.5,1949399,54.1,233597,10.7
South Dakota,2011,5,445018,71.5,424275,68.1,20743,4.7
Tennessee,2011,5,3123434,62.9,2833384,57.0,290050,9.3
Texas,2011,5,12467134,65.9,11445785,60.5,1021349,8.2
Utah,2011,5,1345294,67.7,1241349,62.5,103945,7.7
Vermont,2011,5,357830,70.2,337364,66.1,20466,5.7
Virginia,2011,5,4193417,67.3,3918828,62.9,274589,6.5
Washington,2011,5,3436211,64.8,3139194,59.2,297017,8.6
West Virginia,2011,5,803485,54.1,740139,49.8,63346,7.9
Wisconsin,2011,5,3066514,68.8,2833324,63.6,233190,7.6
Wyoming,2011,5,301719,69.2,283312,65.0,18407,6.1
Alabama,2011,6,2203524,59.2,1987938,53.4,215586,9.8
Alaska,2011,6,363679,68.8,335579,63.5,28100,7.7
Arizona,2011,6,3049264,62.0,2757097,56.0,292167,9.6
Arkansas,2011,6,1352740,60.0,1244430,55.2,108310,8.0
California,2011,6,18375161,63.5,16169321,55.9,2205840,12.0
Los Angeles County,2011,6,4935919,63.9,4326010,56.0,609909,12.4
Colorado,2011,6,2722599,69.4,2487089,63.4,235510,8.7
Connecticut,2011,6,1910692,67.6,1736564,61.4,174128,9.1
Delaware,2011,6,443112,62.3,409159,57.6,33953,7.7
District of Columbia,2011,6,351373,68.0,314624,60.9,36749,10.5
Florida,2011,6,9247380,60.9,8309731,54.7,937649,10.1
Georgia,2011,6,4732626,64.2,4247308,57.6,485318,10.3
Hawaii,2011,6,661170,62.7,615617,58.3,45553,6.9
Idaho,2011,6,762271,64.7,699223,59.3,63048,8.3
Illinois,2011,6,6558897,65.9,5908670,59.4,650227,9.9
Indiana,2011,6,3186877,63.7,2902198,58.0,284679,8.9
Iowa,2011,6,1668016,70.2,1573438,66.3,94578,5.7
Kansas,2011,6,1495824,69.2,1400534,64.8,95290,6.4
Kentucky,2011,6,2060245,61.1,1865052,55.3,195193,9.5
Louisiana,2011,6,2072589,59.6,1919502,55.2,153087,7.4
Maine,2011,6,697688,64.6,643236,59.6,54452,7.8
Maryland,2011,6,3091103,67.9,2862954,62.9,228149,7.4
Massachusetts,2011,6,3475347,65.7,3222636,60.9,252711,7.3
Michigan,2011,6,4661368,60.1,4186322,54.0,475046,10.2
Minnesota,2011,6,2953753,71.2,2755639,66.4,198114,6.7
Mississippi,2011,6,1347132,60.0,1213310,54.1,133822,9.9
Missouri,2011,6,3031540,65.2,2765678,59.5,265862,8.8
Montana,2011,6,499502,63.7,465976,59.4,33526,6.7
Nebraska,2011,6,1001954,71.6,957429,68.4,44525,4.4
Nevada,2011,6,1358808,65.0,1175945,56.3,182863,13.5
New Hampshire,2011,6,735206,69.4,694662,65.6,40544,5.5
New Jersey,2011,6,4555798,65.9,4128487,59.7,427311,9.4
New Mexico,2011,6,923370,58.3,857388,54.2,65982,7.1
New York,2011,6,9510326,61.5,8723753,56.4,786573,8.3
New York city,2011,6,3963574,59.8,3606012,54.4,357562,9.0
North Carolina,2011,6,4650932,62.8,4173283,56.3,477649,10.3
North Dakota,2011,6,386171,72.5,372985,70.1,13186,3.4
Ohio,2011,6,5774881,64.2,5253336,58.4,521545,9.0
Oklahoma,2011,6,1759602,61.4,1662261,58.0,97341,5.5
Oregon,2011,6,1994170,65.1,1801687,58.8,192483,9.7
Pennsylvania,2011,6,6366245,62.9,5870872,58.0,495373,7.8
Rhode Island,2011,6,561130,66.5,499522,59.2,61608,11.0
South Carolina,2011,6,2184648,60.5,1951312,54.1,233336,10.7
South Dakota,2011,6,444826,71.4,424436,68.1,20390,4.6
Tennessee,2011,6,3121176,62.8,2832604,57.0,288572,9.2
Texas,2011,6,12497108,66.0,11463413,60.5,1033695,8.3
Utah,2011,6,1346394,67.7,1242153,62.4,104241,7.7
Vermont,2011,6,357343,70.0,337129,66.1,20214,5.7
Virginia,2011,6,4197326,67.3,3920664,62.8,276662,6.6
Washington,2011,6,3435558,64.7,3139899,59.2,295659,8.6
West Virginia,2011,6,803534,54.1,740625,49.8,62909,7.8
Wisconsin,2011,6,3067022,68.8,2832807,63.6,234215,7.6
Wyoming,2011,6,301800,69.2,283564,65.0,18236,6.0
Alabama,2011,7,2201393,59.1,1987565,53.4,213828,9.7
Alaska,2011,7,364268,68.8,336147,63.5,28121,7.7
Arizona,2011,7,3047928,61.9,2757526,56.0,290402,9.5
Arkansas,2011,7,1354815,60.1,1246487,55.3,108328,8.0
California,2011,7,18400252,63.5,16196030,55.9,2204222,12.0
Los Angeles County,2011,7,4938064,63.9,4327332,56.0,610732,12.4
Colorado,2011,7,2728230,69.5,2492162,63.5,236068,8.7
Connecticut,2011,7,1911543,67.5,1738579,61.4,172964,9.0
Delaware,2011,7,443468,62.3,409601,57.6,33867,7.6
District of Columbia,2011,7,351799,68.0,315004,60.9,36795,10.5
Florida,2011,7,9251715,60.8,8322847,54.7,928868,10.0
Georgia,2011,7,4741366,64.2,4256369,57.7,484997,10.2
Hawaii,2011,7,660995,62.6,615010,58.2,45985,7.0
Idaho,2011,7,763074,64.7,700436,59.4,62638,8.2
Illinois,2011,7,6568779,66.0,5909893,59.4,658886,10.0
Indiana,2011,7,3192548,63.8,2903557,58.0,288991,9.1
Iowa,2011,7,1667412,70.2,1572853,66.2,94559,5.7
Kansas,2011,7,1496109,69.2,1401222,64.8,94887,6.3
Kentucky,2011,7,2059549,61.1,1864549,55.3,195000,9.5
Louisiana,2011,7,2073250,59.6,1920667,55.2,152583,7.4
Maine,2011,7,698174,64.7,643935,59.6,54239,7.8
Maryland,2011,7,3092882,67.9,2864451,62.9,228431,7.4
Massachusetts,2011,7,3478517,65.7,3227066,60.9,251451,7.2
Michigan,2011,7,4667917,60.2,4192853,54.1,475064,10.2
Minnesota,2011,7,2955400,71.2,2758359,66.4,197041,6.7
Mississippi,2011,7,1346784,60.0,1212959,54.0,133825,9.9
Missouri,2011,7,3031325,65.2,2767805,59.5,263520,8.7
Montana,2011,7,500212,63.8,466749,59.5,33463,6.7
Nebraska,2011,7,1003040,71.6,958709,68.5,44331,4.4
Nevada,2011,7,1360553,65.1,1177623,56.3,182930,13.4
New Hampshire,2011,7,735661,69.4,694880,65.5,40781,5.5
New Jersey,2011,7,4560254,65.9,4132540,59.7,427714,9.4
New Mexico,2011,7,924204,58.3,857471,54.1,66733,7.2
New York,2011,7,9514587,61.5,8722045,56.3,792542,8.3
New York city,2011,7,3969170,59.9,3607595,54.4,361575,9.1
North Carolina,2011,7,4656313,62.8,4175330,56.3,480983,10.3
North Dakota,2011,7,387021,72.6,373776,70.1,13245,3.4
Ohio,2011,7,5771503,64.1,5251468,58.4,520035,9.0
Oklahoma,2011,7,1762735,61.5,1664718,58.0,98017,5.6
Oregon,2011,7,1994525,65.0,1801501,58.7,193024,9.7
Pennsylvania,2011,7,6374425,63.0,5874119,58.0,500306,7.8
Rhode Island,2011,7,560553,66.4,498806,59.1,61747,11.0
South Carolina,2011,7,2186574,60.5,1954830,54.1,231744,10.6
South Dakota,2011,7,444961,71.3,424835,68.1,20126,4.5
Tennessee,2011,7,3118930,62.7,2832382,56.9,286548,9.2
Texas,2011,7,12534220,66.0,11487969,60.5,1046251,8.3
Utah,2011,7,1342776,67.4,1243911,62.4,98865,7.4
Vermont,2011,7,357058,69.9,337145,66.0,19913,5.6
Virginia,2011,7,4203699,67.3,3925109,62.8,278590,6.6
Washington,2011,7,3434917,64.7,3141096,59.1,293821,8.6
West Virginia,2011,7,804493,54.1,741792,49.9,62701,7.8
Wisconsin,2011,7,3069100,68.8,2834342,63.6,234758,7.6
Wyoming,2011,7,302182,69.2,283980,65.0,18202,6.0
Alabama,2011,8,2199378,59.0,1988543,53.4,210835,9.6
Alaska,2011,8,365018,68.9,336857,63.6,28161,7.7
Arizona,2011,8,3047345,61.8,2759876,55.9,287469,9.4
Arkansas,2011,8,1357919,60.2,1249882,55.4,108037,8.0
California,2011,8,18428801,63.6,16234039,56.0,2194762,11.9
Los Angeles County,2011,8,4941280,63.8,4332113,56.0,609167,12.3
Colorado,2011,8,2735039,69.5,2498664,63.5,236375,8.6
Connecticut,2011,8,1913385,67.6,1742023,61.5,171362,9.0
Delaware,2011,8,444138,62.3,410471,57.6,33667,7.6
District of Columbia,2011,8,352408,68.0,315803,60.9,36605,10.4
Florida,2011,8,9261107,60.8,8341528,54.8,919579,9.9
Georgia,2011,8,4750409,64.3,4267651,57.7,482758,10.2
Hawaii,2011,8,660874,62.5,614669,58.1,46205,7.0
Idaho,2011,8,764301,64.7,702187,59.5,62114,8.1
Illinois,2011,8,6577947,66.1,5914841,59.4,663106,10.1
Indiana,2011,8,3197873,63.9,2906147,58.0,291726,9.1
Iowa,2011,8,1667469,70.1,1573169,66.2,94300,5.7
Kansas,2011,8,1497076,69.2,1402453,64.8,94623,6.3
Kentucky,2011,8,2059402,61.0,1865360,55.3,194042,9.4
Louisiana,2011,8,2076019,59.6,1923582,55.2,152437,7.3
Maine,2011,8,698915,64.7,645058,59.7,53857,7.7
Maryland,2011,8,3096098,67.9,2868279,62.9,227819,7.4
Massachusetts,2011,8,3483335,65.7,3233573,61.0,249762,7.2
Michigan,2011,8,4674626,60.2,4202912,54.2,471714,10.1
Minnesota,2011,8,2956624,71.2,2762729,66.5,193895,6.6
Mississippi,2011,8,1346413,59.9,1213238,54.0,133175,9.9
Missouri,2011,8,3031636,65.2,2771395,59.6,260241,8.6
Montana,2011,8,501247,63.8,467977,59.6,33270,6.6
Nebraska,2011,8,1004575,71.7,960475,68.6,44100,4.4
Nevada,2011,8,1362462,65.1,1180132,56.4,182330,13.4
New Hampshire,2011,8,736515,69.4,695779,65.6,40736,5.5
New Jersey,2011,8,4565687,66.0,4138063,59.8,427624,9.4
New Mexico,2011,8,925288,58.4,857828,54.1,67460,7.3
New York,2011,8,9524566,61.5,8725968,56.3,798598,8.4
New York city,2011,8,3976594,59.9,3610814,54.4,365780,9.2
North Carolina,2011,8,4662440,62.8,4179593,56.3,482847,10.4
North Dakota,2011,8,388085,72.6,374881,70.2,13204,3.4
Ohio,2011,8,5767102,64.1,5252818,58.4,514284,8.9
Oklahoma,2011,8,1767198,61.6,1668501,58.1,98697,5.6
Oregon,2011,8,1995328,65.0,1802792,58.7,192536,9.6
Pennsylvania,2011,8,6385122,63.1,5881816,58.1,503306,7.9
Rhode Island,2011,8,560271,66.3,498401,59.0,61870,11.0
South Carolina,2011,8,2188150,60.5,1959427,54.2,228723,10.5
South Dakota,2011,8,445413,71.3,425492,68.1,19921,4.5
Tennessee,2011,8,3116910,62.6,2833535,56.9,283375,9.1
Texas,2011,8,12546014,66.0,11519770,60.6,1026244,8.2
Utah,2011,8,1340068,67.2,1246666,62.5,93402,7.0
Vermont,2011,8,356927,69.9,337389,66.1,19538,5.5
Virginia,2011,8,4211579,67.4,3932076,62.9,279503,6.6
Washington,2011,8,3434295,64.6,3143050,59.1,291245,8.5
West Virginia,2011,8,806051,54.2,743580,50.0,62471,7.8
Wisconsin,2011,8,3072085,68.9,2838003,63.6,234082,7.6
Wyoming,2011,8,302814,69.2,284545,65.1,18269,6.0
Alabama,2011,9,2197051,58.9,1990625,53.4,206426,9.4
Alaska,2011,9,365643,68.9,337487,63.6,28156,7.7
Arizona,2011,9,3047212,61.7,2763942,55.9,283270,9.3
Arkansas,2011,9,1361072,60.3,1253820,55.5,107252,7.9
California,2011,9,18453635,63.6,16277760,56.1,2175875,11.8
Los Angeles County,2011,9,4943073,63.8,4338342,56.0,604731,12.2
Colorado,2011,9,2741753,69.6,2505623,63.6,236130,8.6
Connecticut,2011,9,1915535,67.6,1746278,61.6,169257,8.8
Delaware,2011,9,444928,62.4,411634,57.7,33294,7.5
District of Columbia,2011,9,353073,68.0,316859,61.0,36214,10.3
Florida,2011,9,9265057,60.7,8363923,54.8,901134,9.7
Georgia,2011,9,4758203,64.3,4279885,57.8,478318,10.1
Hawaii,2011,9,660501,62.4,614430,58.1,46071,7.0
Idaho,2011,9,765783,64.8,704282,59.6,61501,8.0
Illinois,2011,9,6585180,66.1,5924042,59.5,661138,10.0
Indiana,2011,9,3201966,63.9,2910302,58.1,291664,9.1
Iowa,2011,9,1667811,70.1,1574205,66.2,93606,5.6
Kansas,2011,9,1498090,69.2,1403990,64.9,94100,6.3
Kentucky,2011,9,2059397,61.0,1867511,55.3,191886,9.3
Louisiana,2011,9,2079673,59.7,1927408,55.3,152265,7.3
Maine,2011,9,699670,64.8,646382,59.8,53288,7.6
Maryland,2011,9,3099892,67.9,2873749,63.0,226143,7.3
Massachusetts,2011,9,3488645,65.7,3241226,61.1,247419,7.1
Michigan,2011,9,4680596,60.3,4215213,54.3,465383,9.9
Minnesota,2011,9,2956803,71.1,2767696,66.6,189107,6.4
Mississippi,2011,9,1346047,59.9,1214189,54.0,131858,9.8
Missouri,2011,9,3031257,65.1,2775879,59.6,255378,8.4
Montana,2011,9,502388,63.9,469513,59.7,32875,6.5
Nebraska,2011,9,1006289,71.8,962554,68.7,43735,4.3
Nevada,2011,9,1364043,65.0,1183282,56.4,180761,13.3
New Hampshire,2011,9,737544,69.5,697156,65.7,40388,5.5
New Jersey,2011,9,4570767,66.0,4143983,59.8,426784,9.3
New Mexico,2011,9,926262,58.4,858392,54.1,67870,7.3
New York,2011,9,9536393,61.5,8732476,56.3,803917,8.4
New York city,2011,9,3983763,60.0,3614116,54.4,369647,9.3
North Carolina,2011,9,4668641,62.8,4186860,56.3,481781,10.3
North Dakota,2011,9,389260,72.7,376216,70.3,13044,3.4
Ohio,2011,9,5760793,64.0,5256975,58.4,503818,8.7
Oklahoma,2011,9,1772359,61.7,1673387,58.2,98972,5.6
Oregon,2011,9,1995988,64.9,1805189,58.7,190799,9.6
Pennsylvania,2011,9,6395422,63.1,5892027,58.2,503395,7.9
Rhode Island,2011,9,560162,66.3,498282,59.0,61880,11.0
South Carolina,2011,9,2189084,60.5,1964431,54.3,224653,10.3
South Dakota,2011,9,446041,71.3,426311,68.2,19730,4.4
Tennessee,2011,9,3114511,62.5,2835806,56.9,278705,8.9
Texas,2011,9,12559256,66.0,11556548,60.7,1002708,8.0
Utah,2011,9,1338091,67.0,1250211,62.6,87880,6.6
Vermont,2011,9,356866,69.9,337751,66.1,19115,5.4
Virginia,2011,9,4219107,67.4,3940336,62.9,278771,6.6
Washington,2011,9,3434445,64.5,3146622,59.1,287823,8.4
West Virginia,2011,9,807653,54.3,745687,50.1,61966,7.7
Wisconsin,2011,9,3074803,68.9,2842921,63.7,231882,7.5
Wyoming,2011,9,303525,69.3,285193,65.1,18332,6.0
Alabama,2011,10,2194108,58.8,1992980,53.4,201128,9.2
Alaska,2011,10,365963,68.9,337901,63.6,28062,7.7
Arizona,2011,10,3047502,61.6,2769137,55.9,278365,9.1
Arkansas,2011,10,1363485,60.4,1257461,55.7,106024,7.8
California,2011,10,18470587,63.6,16320810,56.2,2149777,11.6
Los Angeles County,2011,10,4942265,63.7,4344240,56.0,598025,12.1
Colorado,2011,10,2747237,69.6,2511976,63.7,235261,8.6
Connecticut,2011,10,1917084,67.6,1750252,61.7,166832,8.7
Delaware,2011,10,445636,62.4,412856,57.8,32780,7.4
District of Columbia,2011,10,353701,68.0,317989,61.1,35712,10.1
Florida,2011,10,9276833,60.7,8387525,54.9,889308,9.6
Georgia,2011,10,4764049,64.3,4291750,57.9,472299,9.9
Hawaii,2011,10,659648,62.3,614041,58.0,45607,6.9
Idaho,2011,10,767335,64.8,706484,59.7,60851,7.9
Illinois,2011,10,6589604,66.1,5936827,59.6,652777,9.9
Indiana,2011,10,3204480,63.9,2915887,58.2,288593,9.0
Iowa,2011,10,1668085,70.1,1575631,66.2,92454,5.5
Kansas,2011,10,1498563,69.2,1405412,64.9,93151,6.2
Kentucky,2011,10,2058960,61.0,1870409,55.4,188551,9.2
Louisiana,2011,10,2083093,59.7,1931181,55.4,151912,7.3
Maine,2011,10,700205,64.8,647591,59.9,52614,7.5
Maryland,2011,10,3103611,67.9,2879948,63.0,223663,7.2
Massachusetts,2011,10,3493484,65.8,3248942,61.2,244542,7.0
Michigan,2011,10,4684885,60.3,4227863,54.4,457022,9.8
Minnesota,2011,10,2955882,71.0,2772119,66.6,183763,6.2
Mississippi,2011,10,1345330,59.8,1215492,54.1,129838,9.7
Missouri,2011,10,3029495,65.1,2780269,59.7,249226,8.2
Montana,2011,10,503378,64.0,471088,59.9,32290,6.4
Nebraska,2011,10,1007812,71.8,964612,68.7,43200,4.3
Nevada,2011,10,1364991,65.0,1186737,56.5,178254,13.1
New Hampshire,2011,10,738453,69.5,698579,65.7,39874,5.4
New Jersey,2011,10,4574465,66.0,4148948,59.9,425517,9.3
New Mexico,2011,10,927035,58.4,859120,54.1,67915,7.3
New York,2011,10,9548032,61.6,8739046,56.4,808986,8.5
New York city,2011,10,3990025,60.0,3616646,54.4,373379,9.4
North Carolina,2011,10,4674451,62.8,4196794,56.4,477657,10.2
North Dakota,2011,10,390370,72.8,377584,70.4,12786,3.3
Ohio,2011,10,5753316,63.9,5263328,58.4,489988,8.5
Oklahoma,2011,10,1777478,61.8,1678931,58.4,98547,5.5
Oregon,2011,10,1996000,64.9,1807834,58.8,188166,9.4
Pennsylvania,2011,10,6403565,63.2,5903108,58.3,500457,7.8
Rhode Island,2011,10,560083,66.2,498375,59.0,61708,11.0
South Carolina,2011,10,2189390,60.4,1969230,54.3,220160,10.1
South Dakota,2011,10,446633,71.3,427114,68.2,19519,4.4
Tennessee,2011,10,3111419,62.4,2838553,56.9,272866,8.8
Texas,2011,10,12570673,65.9,11594803,60.8,975870,7.8
Utah,2011,10,1336631,66.8,1254196,62.7,82435,6.2
Vermont,2011,10,356776,69.8,338090,66.2,18686,5.2
Virginia,2011,10,4224836,67.4,3948490,63.0,276346,6.5
Washington,2011,10,3436373,64.4,3152344,59.1,284029,8.3
West Virginia,2011,10,808794,54.4,747742,50.3,61052,7.5
Wisconsin,2011,10,3076325,68.9,2847838,63.8,228487,7.4
Wyoming,2011,10,304140,69.3,285821,65.1,18319,6.0
Alabama,2011,11,2190069,58.7,1994495,53.4,195574,8.9
Alaska,2011,11,365959,68.8,338096,63.6,27863,7.6
Arizona,2011,11,3047623,61.5,2774329,56.0,273294,9.0
Arkansas,2011,11,1364537,60.4,1260075,55.8,104462,7.7
California,2011,11,18475806,63.5,16356584,56.2,2119222,11.5
Los Angeles County,2011,11,4937350,63.6,4347615,56.0,589735,11.9
Colorado,2011,11,2750166,69.6,2516276,63.7,233890,8.5
Connecticut,2011,11,1917061,67.6,1752728,61.8,164333,8.6
Delaware,2011,11,446063,62.4,413853,57.9,32210,7.2
District of Columbia,2011,11,354283,68.0,319110,61.2,35173,9.9
Florida,2011,11,9285382,60.7,8409108,55.0,876274,9.4
Georgia,2011,11,4767256,64.3,4301696,58.0,465560,9.8
Hawaii,2011,11,658261,62.1,613338,57.8,44923,6.8
Idaho,2011,11,768639,64.9,708451,59.8,60188,7.8
Illinois,2011,11,6590025,66.1,5950626,59.7,639399,9.7
Indiana,2011,11,3204528,63.9,2921443,58.3,283085,8.8
Iowa,2011,11,1667807,70.0,1576906,66.2,90901,5.5
Kansas,2011,11,1498063,69.1,1406203,64.9,91860,6.1
Kentucky,2011,11,2057306,60.9,1873049,55.4,184257,9.0
Louisiana,2011,11,2085470,59.8,1934241,55.4,151229,7.3
Maine,2011,11,700345,64.8,648450,60.0,51895,7.4
Maryland,2011,11,3106452,67.9,2885725,63.1,220727,7.1
Massachusetts,2011,11,3496743,65.8,3255358,61.2,241385,6.9
Michigan,2011,11,4686341,60.3,4238754,54.6,447587,9.6
Minnesota,2011,11,2953876,70.9,2775177,66.7,178699,6.0
Mississippi,2011,11,1343817,59.8,1216515,54.1,127302,9.5
Missouri,2011,11,3025832,65.0,2783434,59.8,242398,8.0
Montana,2011,11,503969,64.0,472384,60.0,31585,6.3
Nebraska,2011,11,1008729,71.8,966232,68.8,42497,4.2
Nevada,2011,11,1365040,64.9,1190017,56.6,175023,12.8
New Hampshire,2011,11,738938,69.5,699618,65.8,39320,5.3
New Jersey,2011,11,4575923,66.0,4151567,59.9,424356,9.3
New Mexico,2011,11,927454,58.4,859863,54.1,67591,7.3
New York,2011,11,9556997,61.6,8743315,56.4,813682,8.5
New York city,2011,11,3994408,60.1,3617683,54.4,376725,9.4
North Carolina,2011,11,4679145,62.8,4208165,56.5,470980,10.1
North Dakota,2011,11,391260,72.8,378801,70.5,12459,3.2
Ohio,2011,11,5745836,63.8,5270678,58.5,475158,8.3
Oklahoma,2011,11,1781679,61.9,1684282,58.5,97397,5.5
Oregon,2011,11,1994860,64.8,1809617,58.8,185243,9.3
Pennsylvania,2011,11,6408612,63.2,5913540,58.3,495072,7.7
Rhode Island,2011,11,559786,66.2,498474,58.9,61312,11.0
South Carolina,2011,11,2188894,60.3,1973095,54.4,215799,9.9
South Dakota,2011,11,446983,71.3,427729,68.2,19254,4.3
Tennessee,2011,11,3107219,62.3,2840913,56.9,266306,8.6
Texas,2011,11,12576962,65.8,11630243,60.9,946719,7.5
Utah,2011,11,1335333,66.6,1258132,62.8,77201,5.8
Vermont,2011,11,356508,69.8,338251,66.2,18257,5.1
Virginia,2011,11,4227390,67.4,3954876,63.0,272514,6.4
Washington,2011,11,3440275,64.4,3159925,59.2,280350,8.1
West Virginia,2011,11,809104,54.4,749353,50.4,59751,7.4
Wisconsin,2011,11,3075869,68.9,2851587,63.8,224282,7.3
Wyoming,2011,11,304504,69.3,286325,65.2,18179,6.0
Alabama,2011,12,2185010,58.5,1994618,53.4,190392,8.7
Alaska,2011,12,365671,68.7,338095,63.5,27576,7.5
Arizona,2011,12,3047727,61.4,2778825,56.0,268902,8.8
Arkansas,2011,12,1364056,60.3,1261291,55.8,102765,7.5
California,2011,12,18469241,63.4,16381644,56.3,2087597,11.3
Los Angeles County,2011,12,4928280,63.5,4347561,56.0,580719,11.8
Colorado,2011,12,2749769,69.5,2517876,63.6,231893,8.4
Connecticut,2011,12,1915340,67.5,1753314,61.8,162026,8.5
Delaware,2011,12,446201,62.4,414510,58.0,31691,7.1
District of Columbia,2011,12,354889,68.0,320236,61.3,34653,9.8
Florida,2011,12,9289835,60.7,8426736,55.0,863099,9.3
Georgia,2011,12,4767599,64.2,4308707,58.0,458892,9.6
Hawaii,2011,12,656523,61.9,612414,57.7,44109,6.7
Idaho,2011,12,769548,64.9,709965,59.9,59583,7.7
Illinois,2011,12,6586549,66.1,5962923,59.8,623626,9.5
Indiana,2011,12,3201486,63.8,2925295,58.3,276191,8.6
Iowa,2011,12,1666736,70.0,1577591,66.2,89145,5.3
Kansas,2011,12,1496515,69.0,1406144,64.9,90371,6.0
Kentucky,2011,12,2054336,60.8,1874902,55.5,179434,8.7
Louisiana,2011,12,2086631,59.8,1936543,55.5,150088,7.2
Maine,2011,12,700108,64.8,648912,60.0,51196,7.3
Maryland,2011,12,3107880,67.9,2890142,63.2,217738,7.0
Massachusetts,2011,12,3497899,65.7,3259580,61.3,238319,6.8
Michigan,2011,12,4684886,60.3,4246482,54.6,438404,9.4
Minnesota,2011,12,2950830,70.8,2776403,66.6,174427,5.9
Mississippi,2011,12,1341351,59.6,1216791,54.1,124560,9.3
Missouri,2011,12,3020372,64.8,2784865,59.8,235507,7.8
Montana,2011,12,504138,64.0,473258,60.1,30880,6.1
Nebraska,2011,12,1008982,71.8,967276,68.8,41706,4.1
Nevada,2011,12,1364376,64.8,1192847,56.7,171529,12.6
New Hampshire,2011,12,738885,69.4,700072,65.8,38813,5.3
New Jersey,2011,12,4575109,66.0,4151422,59.9,423687,9.3
New Mexico,2011,12,927394,58.4,860484,54.2,66910,7.2
New York,2011,12,9561987,61.6,8744223,56.3,817764,8.6
New York city,2011,12,3996640,60.0,3617463,54.3,379177,9.5
North Carolina,2011,12,4682632,62.8,4219676,56.6,462956,9.9
North Dakota,2011,12,391899,72.8,379791,70.6,12108,3.1
Ohio,2011,12,5739218,63.7,5277947,58.6,461271,8.0
Oklahoma,2011,12,1784491,62.0,1688775,58.6,95716,5.4
Oregon,2011,12,1992429,64.6,1809926,58.7,182503,9.2
Pennsylvania,2011,12,6411019,63.2,5922406,58.4,488613,7.6
Rhode Island,2011,12,559195,66.1,498490,58.9,60705,10.9
South Carolina,2011,12,2187724,60.2,1975735,54.4,211989,9.7
South Dakota,2011,12,447025,71.3,428081,68.2,18944,4.2
Tennessee,2011,12,3101996,62.1,2842262,56.9,259734,8.4
Texas,2011,12,12576704,65.7,11659891,60.9,916813,7.3
Utah,2011,12,1333971,66.5,1261754,62.9,72217,5.4
Vermont,2011,12,356006,69.7,338170,66.2,17836,5.0
Virginia,2011,12,4226121,67.3,3958263,63.0,267858,6.3
Washington,2011,12,3445721,64.5,3168491,59.3,277230,8.0
West Virginia,2011,12,808721,54.4,750368,50.4,58353,7.2
Wisconsin,2011,12,3073596,68.8,2853852,63.9,219744,7.1
Wyoming,2011,12,304580,69.2,286683,65.1,17897,5.9
Alabama,2012,1,2179750,58.3,1993523,53.4,186227,8.5
Alaska,2012,1,365200,68.6,337946,63.5,27254,7.5
Arizona,2012,1,3048161,61.3,2782738,56.0,265423,8.7
Arkansas,2012,1,1362428,60.2,1261262,55.8,101166,7.4
California,2012,1,18456650,63.3,16397835,56.3,2058815,11.2
Los Angeles County,2012,1,4917205,63.3,4345185,55.9,572020,11.6
Colorado,2012,1,2747283,69.3,2517729,63.5,229554,8.4
Connecticut,2012,1,1912351,67.4,1752189,61.7,160162,8.4
Delaware,2012,1,446183,62.3,414872,58.0,31311,7.0
District of Columbia,2012,1,355798,68.0,321609,61.5,34189,9.6
Florida,2012,1,9292160,60.6,8441097,55.0,851063,9.2
Georgia,2012,1,4765809,64.1,4312847,58.0,452962,9.5
Hawaii,2012,1,654711,61.7,611452,57.6,43259,6.6
Idaho,2012,1,770197,64.9,711077,59.9,59120,7.7
Illinois,2012,1,6580816,66.0,5972028,59.9,608788,9.3
Indiana,2012,1,3195782,63.7,2926439,58.3,269343,8.4
Iowa,2012,1,1665187,69.9,1577773,66.2,87414,5.2
Kansas,2012,1,1494362,68.9,1405492,64.8,88870,5.9
Kentucky,2012,1,2050998,60.7,1876189,55.5,174809,8.5
Louisiana,2012,1,2087233,59.8,1938549,55.5,148684,7.1
Maine,2012,1,699764,64.7,649142,60.0,50622,7.2
Maryland,2012,1,3108021,67.9,2892744,63.2,215277,6.9
Massachusetts,2012,1,3498166,65.7,3262377,61.3,235789,6.7
Michigan,2012,1,4681300,60.2,4250546,54.7,430754,9.2
Minnesota,2012,1,2947490,70.7,2776132,66.6,171358,5.8
Mississippi,2012,1,1338147,59.5,1216211,54.1,121936,9.1
Missouri,2012,1,3013958,64.7,2784819,59.7,229139,7.6
Montana,2012,1,504102,64.0,473787,60.1,30315,6.0
Nebraska,2012,1,1008839,71.8,967953,68.9,40886,4.1
Nevada,2012,1,1363603,64.7,1195245,56.7,168358,12.3
New Hampshire,2012,1,738518,69.4,700039,65.7,38479,5.2
New Jersey,2012,1,4573226,65.9,4149396,59.8,423830,9.3
New Mexico,2012,1,927044,58.3,861016,54.2,66028,7.1
New York,2012,1,9564435,61.6,8742699,56.3,821736,8.6
New York city,2012,1,3997850,60.0,3617028,54.3,380822,9.5
North Carolina,2012,1,4685349,62.8,4230281,56.7,455068,9.7
North Dakota,2012,1,392396,72.8,380609,70.6,11787,3.0
Ohio,2012,1,5734275,63.6,5284949,58.6,449326,7.8
Oklahoma,2012,1,1786242,62.0,1692448,58.7,93794,5.3
Oregon,2012,1,1988854,64.5,1808723,58.6,180131,9.1
Pennsylvania,2012,1,6412680,63.2,5929453,58.5,483227,7.5
Rhode Island,2012,1,558445,66.0,498475,58.9,59970,10.7
South Carolina,2012,1,2186464,60.2,1977447,54.4,209017,9.6
South Dakota,2012,1,446838,71.1,428215,68.2,18623,4.2
Tennessee,2012,1,3097157,62.0,2843050,56.9,254107,8.2
Texas,2012,1,12571937,65.6,11683759,61.0,888178,7.1
Utah,2012,1,1335279,66.4,1265082,62.9,70197,5.3
Vermont,2012,1,355362,69.5,337888,66.1,17474,4.9
Virginia,2012,1,4222321,67.2,3959095,63.0,263226,6.2
Washington,2012,1,3452355,64.5,3177413,59.4,274942,8.0
West Virginia,2012,1,808113,54.3,750875,50.5,57238,7.1
Wisconsin,2012,1,3070628,68.7,2854971,63.9,215657,7.0
Wyoming,2012,1,304445,69.1,286913,65.1,17532,5.8
Alabama,2012,2,2175635,58.2,1992089,53.3,183546,8.4
Alaska,2012,2,364748,68.4,337774,63.4,26974,7.4
Arizona,2012,2,3048882,61.3,2786310,56.0,262572,8.6
Arkansas,2012,2,1360339,60.1,1260404,55.7,99935,7.3
California,2012,2,18447162,63.2,16411184,56.3,2035978,11.0
Los Angeles County,2012,2,4907194,63.1,4342602,55.8,564592,11.5
Colorado,2012,2,2744941,69.2,2517116,63.4,227825,8.3
Connecticut,2012,2,1908624,67.2,1749642,61.6,158982,8.3
Delaware,2012,2,446164,62.3,415034,57.9,31130,7.0
District of Columbia,2012,2,357117,68.2,323319,61.7,33798,9.5
Florida,2012,2,9296328,60.6,8454837,55.1,841491,9.1
Georgia,2012,2,4764273,64.0,4315884,58.0,448389,9.4
Hawaii,2012,2,653076,61.5,610580,57.5,42496,6.5
Idaho,2012,2,770719,64.9,711923,59.9,58796,7.6
Illinois,2012,2,6576290,65.9,5978214,59.9,598076,9.1
Indiana,2012,2,3188573,63.5,2924640,58.2,263933,8.3
Iowa,2012,2,1663580,69.8,1577533,66.2,86047,5.2
Kansas,2012,2,1492333,68.8,1404669,64.7,87664,5.9
Kentucky,2012,2,2048659,60.6,1877591,55.5,171068,8.4
Louisiana,2012,2,2088242,59.8,1940786,55.5,147456,7.1
Maine,2012,2,699615,64.7,649301,60.0,50314,7.2
Maryland,2012,2,3108088,67.8,2894197,63.1,213891,6.9
Massachusetts,2012,2,3498974,65.6,3264746,61.3,234228,6.7
Michigan,2012,2,4677505,60.1,4251976,54.7,425529,9.1
Minnesota,2012,2,2944994,70.6,2775710,66.5,169284,5.7
Mississippi,2012,2,1334895,59.3,1215042,54.0,119853,9.0
Missouri,2012,2,3008235,64.5,2784077,59.7,224158,7.5
Montana,2012,2,504157,63.9,474178,60.1,29979,5.9
Nebraska,2012,2,1008717,71.7,968546,68.9,40171,4.0
Nevada,2012,2,1363319,64.6,1197373,56.7,165946,12.2
New Hampshire,2012,2,738232,69.3,699770,65.7,38462,5.2
New Jersey,2012,2,4572104,65.9,4146808,59.8,425296,9.3
New Mexico,2012,2,926718,58.3,861491,54.2,65227,7.0
New York,2012,2,9568747,61.6,8742066,56.3,826681,8.6
New York city,2012,2,4000423,60.0,3618134,54.3,382289,9.6
North Carolina,2012,2,4687985,62.7,4239253,56.7,448732,9.6
North Dakota,2012,2,392930,72.8,381373,70.6,11557,2.9
Ohio,2012,2,5731180,63.6,5291278,58.7,439902,7.7
Oklahoma,2012,2,1787662,62.0,1695613,58.8,92049,5.1
Oregon,2012,2,1984596,64.3,1806253,58.5,178343,9.0
Pennsylvania,2012,2,6416137,63.3,5935248,58.5,480889,7.5
Rhode Island,2012,2,557824,65.9,498546,58.9,59278,10.6
South Carolina,2012,2,2185903,60.1,1978893,54.4,207010,9.5
South Dakota,2012,2,446604,71.0,428238,68.1,18366,4.1
Tennessee,2012,2,3094096,61.8,2843731,56.8,250365,8.1
Texas,2012,2,12581835,65.5,11704383,61.0,877452,7.0
Utah,2012,2,1331198,66.2,1268263,63.0,62935,4.7
Vermont,2012,2,354783,69.4,337552,66.0,17231,4.9
Virginia,2012,2,4218049,67.0,3958507,62.9,259542,6.2
Washington,2012,2,3459848,64.6,3185999,59.5,273849,7.9
West Virginia,2012,2,807794,54.3,751038,50.5,56756,7.0
Wisconsin,2012,2,3068522,68.6,2855567,63.9,212955,6.9
Wyoming,2012,2,304220,68.9,287031,65.0,17189,5.7
Alabama,2012,3,2173644,58.1,1991104,53.2,182540,8.4
Alaska,2012,3,364426,68.3,337625,63.3,26801,7.4
Arizona,2012,3,3050044,61.2,2789251,56.0,260793,8.6
Arkansas,2012,3,1358109,60.0,1258810,55.6,99299,7.3
California,2012,3,18445792,63.2,16424830,56.3,2020962,11.0
Los Angeles County,2012,3,4900245,62.9,4341084,55.8,559161,11.4
Colorado,2012,3,2743601,69.1,2516649,63.3,226952,8.3
Connecticut,2012,3,1904314,67.0,1745620,61.4,158694,8.3
Delaware,2012,3,446185,62.2,414992,57.9,31193,7.0
District of Columbia,2012,3,358725,68.3,325222,62.0,33503,9.3
Florida,2012,3,9303773,60.5,8468399,55.1,835374,9.0
Georgia,2012,3,4764404,64.0,4318945,58.0,445459,9.3
Hawaii,2012,3,651755,61.3,609893,57.4,41862,6.4
Idaho,2012,3,771103,64.9,712536,59.9,58567,7.6
Illinois,2012,3,6574536,65.9,5981261,59.9,593275,9.0
Indiana,2012,3,3180618,63.3,2919810,58.1,260808,8.2
Iowa,2012,3,1662015,69.7,1576690,66.1,85325,5.1
Kansas,2012,3,1490738,68.7,1403751,64.7,86987,5.8
Kentucky,2012,3,2048252,60.5,1879434,55.5,168818,8.2
Louisiana,2012,3,2089768,59.8,1943114,55.6,146654,7.0
Maine,2012,3,699718,64.7,649374,60.0,50344,7.2
Maryland,2012,3,3108973,67.8,2895102,63.1,213871,6.9
Massachusetts,2012,3,3500416,65.6,3266409,61.2,234007,6.7
Michigan,2012,3,4674978,60.1,4251685,54.6,423293,9.1
Minnesota,2012,3,2943537,70.5,2775538,66.5,167999,5.7
Mississippi,2012,3,1332365,59.2,1213667,53.9,118698,8.9
Missouri,2012,3,3004112,64.4,2783008,59.7,221104,7.4
Montana,2012,3,504449,63.9,474559,60.1,29890,5.9
Nebraska,2012,3,1008820,71.7,969077,68.8,39743,3.9
Nevada,2012,3,1363757,64.5,1199248,56.7,164509,12.1
New Hampshire,2012,3,738277,69.2,699419,65.6,38858,5.3
New Jersey,2012,3,4572304,65.9,4143868,59.7,428436,9.4
New Mexico,2012,3,926490,58.2,861751,54.2,64739,7.0
New York,2012,3,9575456,61.6,8742131,56.3,833325,8.7
New York city,2012,3,4004593,60.0,3620502,54.3,384091,9.6
North Carolina,2012,3,4690963,62.7,4245775,56.8,445188,9.5
North Dakota,2012,3,393520,72.8,382069,70.7,11451,2.9
Ohio,2012,3,5727867,63.5,5294585,58.7,433282,7.6
Oklahoma,2012,3,1789039,62.0,1698086,58.8,90953,5.1
Oregon,2012,3,1980071,64.1,1802745,58.4,177326,9.0
Pennsylvania,2012,3,6422861,63.3,5939931,58.5,482930,7.5
Rhode Island,2012,3,557571,65.8,498778,58.9,58793,10.5
South Carolina,2012,3,2186140,60.0,1980232,54.4,205908,9.4
South Dakota,2012,3,446419,70.9,428181,68.0,18238,4.1
Tennessee,2012,3,3092834,61.8,2843922,56.8,248912,8.0
Texas,2012,3,12563758,65.4,11722322,61.0,841436,6.7
Utah,2012,3,1335297,66.3,1271263,63.1,64034,4.8
Vermont,2012,3,354381,69.3,337236,66.0,17145,4.8
Virginia,2012,3,4214269,66.9,3956965,62.8,257304,6.1
Washington,2012,3,3466956,64.7,3192664,59.6,274292,7.9
West Virginia,2012,3,807907,54.3,750858,50.5,57049,7.1
Wisconsin,2012,3,3067746,68.6,2855416,63.8,212330,6.9
Wyoming,2012,3,303990,68.8,287027,65.0,16963,5.6
Alabama,2012,4,2173494,58.1,1991037,53.2,182457,8.4
Alaska,2012,4,364174,68.2,337455,63.2,26719,7.3
Arizona,2012,4,3051345,61.2,2791656,56.0,259689,8.5
Arkansas,2012,4,1355831,59.9,1256764,55.5,99067,7.3
California,2012,4,18449665,63.1,16440520,56.3,2009145,10.9
Los Angeles County,2012,4,4895433,62.8,4340784,55.7,554649,11.3
Colorado,2012,4,2743294,69.0,2516847,63.3,226447,8.3
Connecticut,2012,4,1899200,66.8,1740242,61.2,158958,8.4
Delaware,2012,4,446181,62.2,414769,57.8,31412,7.0
District of Columbia,2012,4,360448,68.6,327187,62.2,33261,9.2
Florida,2012,4,9312582,60.5,8481558,55.1,831024,8.9
Georgia,2012,4,4765619,63.9,4322617,58.0,443002,9.3
Hawaii,2012,4,650783,61.2,609546,57.3,41237,6.3
Idaho,2012,4,771346,64.8,713010,59.9,58336,7.6
Illinois,2012,4,6574291,65.8,5981264,59.9,593027,9.0
Indiana,2012,4,3172844,63.1,2913076,58.0,259768,8.2
Iowa,2012,4,1660230,69.6,1575227,66.0,85003,5.1
Kansas,2012,4,1489485,68.6,1402934,64.6,86551,5.8
Kentucky,2012,4,2049721,60.6,1881638,55.6,168083,8.2
Louisiana,2012,4,2090997,59.8,1945016,55.6,145981,7.0
Maine,2012,4,699864,64.7,649294,60.0,50570,7.2
Maryland,2012,4,3110612,67.7,2895918,63.1,214694,6.9
Massachusetts,2012,4,3501752,65.6,3267063,61.2,234689,6.7
Michigan,2012,4,4673683,60.0,4250642,54.6,423041,9.1
Minnesota,2012,4,2942677,70.5,2775106,66.4,167571,5.7
Mississippi,2012,4,1330658,59.1,1212323,53.8,118335,8.9
Missouri,2012,4,3001221,64.3,2782139,59.6,219082,7.3
Montana,2012,4,504942,64.0,474995,60.2,29947,5.9
Nebraska,2012,4,1009179,71.7,969646,68.8,39533,3.9
Nevada,2012,4,1364616,64.5,1200986,56.8,163630,12.0
New Hampshire,2012,4,738620,69.2,699082,65.5,39538,5.4
New Jersey,2012,4,4572964,65.9,4140731,59.7,432233,9.5
New Mexico,2012,4,926207,58.2,861707,54.2,64500,7.0
New York,2012,4,9581857,61.6,8742019,56.2,839838,8.8
New York city,2012,4,4009178,60.0,3623612,54.3,385566,9.6
North Carolina,2012,4,4694447,62.7,4250182,56.8,444265,9.5
North Dakota,2012,4,394095,72.8,382664,70.6,11431,2.9
Ohio,2012,4,5721910,63.5,5293517,58.7,428393,7.5
Oklahoma,2012,4,1790363,62.0,1699795,58.9,90568,5.1
Oregon,2012,4,1975219,63.9,1798555,58.2,176664,8.9
Pennsylvania,2012,4,6431482,63.4,5943284,58.6,488198,7.6
Rhode Island,2012,4,557728,65.8,499229,58.9,58499,10.5
South Carolina,2012,4,2186592,60.0,1981691,54.4,204901,9.4
South Dakota,2012,4,446316,70.8,428107,68.0,18209,4.1
Tennessee,2012,4,3092229,61.7,2843514,56.8,248715,8.0
Texas,2012,4,12588954,65.4,11737849,61.0,851105,6.8
Utah,2012,4,1338994,66.4,1274152,63.1,64842,4.8
Vermont,2012,4,354130,69.3,336947,65.9,17183,4.9
Virginia,2012,4,4210876,66.8,3954894,62.7,255982,6.1
Washington,2012,4,3472271,64.7,3196410,59.6,275861,7.9
West Virginia,2012,4,808217,54.3,750339,50.4,57878,7.2
Wisconsin,2012,4,3067471,68.5,2854173,63.8,213298,7.0
Wyoming,2012,4,303802,68.6,286933,64.8,16869,5.6
Alabama,2012,5,2174754,58.1,1992484,53.2,182270,8.4
Alaska,2012,5,364032,68.1,337365,63.1,26667,7.3
Arizona,2012,5,3052719,61.1,2794227,55.9,258492,8.5
Arkansas,2012,5,1353594,59.8,1254657,55.4,98937,7.3
California,2012,5,18457489,63.1,16462781,56.3,1994708,10.8
Los Angeles County,2012,5,4892009,62.7,4342301,55.7,549708,11.2
Colorado,2012,5,2744233,68.9,2518570,63.2,225663,8.2
Connecticut,2012,5,1893644,66.6,1734363,61.0,159281,8.4
Delaware,2012,5,446177,62.1,414524,57.7,31653,7.1
District of Columbia,2012,5,362204,68.8,329200,62.5,33004,9.1
Florida,2012,5,9322199,60.5,8496177,55.1,826022,8.9
Georgia,2012,5,4767757,63.9,4327976,58.0,439781,9.2
Hawaii,2012,5,650165,61.1,609679,57.3,40486,6.2
Idaho,2012,5,771563,64.8,713524,59.9,58039,7.5
Illinois,2012,5,6576078,65.8,5981247,59.9,594831,9.0
Indiana,2012,5,3166824,63.0,2906905,57.8,259919,8.2
Iowa,2012,5,1658427,69.5,1573642,65.9,84785,5.1
Kansas,2012,5,1488736,68.5,1402661,64.6,86075,5.8
Kentucky,2012,5,2052837,60.6,1884530,55.7,168307,8.2
Louisiana,2012,5,2091414,59.8,1946434,55.6,144980,6.9
Maine,2012,5,700078,64.7,649263,60.0,50815,7.3
Maryland,2012,5,3113280,67.7,2897677,63.1,215603,6.9
Massachusetts,2012,5,3503312,65.6,3267718,61.2,235594,6.7
Michigan,2012,5,4674360,60.0,4250834,54.6,423526,9.1
Minnesota,2012,5,2942728,70.4,2775088,66.4,167640,5.7
Mississippi,2012,5,1329787,59.0,1211394,53.8,118393,8.9
Missouri,2012,5,2999746,64.3,2782417,59.6,217329,7.2
Montana,2012,5,505634,64.0,475624,60.2,30010,5.9
Nebraska,2012,5,1009977,71.7,970546,68.9,39431,3.9
Nevada,2012,5,1365728,64.5,1202977,56.8,162751,11.9
New Hampshire,2012,5,739300,69.2,699017,65.5,40283,5.4
New Jersey,2012,5,4574098,65.9,4138729,59.6,435369,9.5
New Mexico,2012,5,926085,58.2,861677,54.1,64408,7.0
New York,2012,5,9588258,61.7,8744437,56.2,843821,8.8
New York city,2012,5,4014061,60.1,3628211,54.3,385850,9.6
North Carolina,2012,5,4699826,62.7,4254632,56.8,445194,9.5
North Dakota,2012,5,394721,72.7,383260,70.6,11461,2.9
Ohio,2012,5,5714684,63.4,5290887,58.7,423797,7.4
Oklahoma,2012,5,1791951,62.0,1701275,58.9,90676,5.1
Oregon,2012,5,1970481,63.7,1794592,58.0,175889,8.9
Pennsylvania,2012,5,6440986,63.5,5946445,58.6,494541,7.7
Rhode Island,2012,5,558373,65.9,500092,59.0,58281,10.4
South Carolina,2012,5,2187077,59.9,1983929,54.4,203148,9.3
South Dakota,2012,5,446395,70.8,428150,67.9,18245,4.1
Tennessee,2012,5,3092082,61.7,2843398,56.7,248684,8.0
Texas,2012,5,12611625,65.4,11754758,61.0,856867,6.8
Utah,2012,5,1342475,66.4,1277306,63.2,65169,4.9
Vermont,2012,5,354020,69.2,336755,65.9,17265,4.9
Virginia,2012,5,4208645,66.7,3953818,62.7,254827,6.1
Washington,2012,5,3475950,64.7,3198232,59.5,277718,8.0
West Virginia,2012,5,808594,54.3,749734,50.4,58860,7.3
Wisconsin,2012,5,3067402,68.5,2852787,63.7,214615,7.0
Wyoming,2012,5,303711,68.5,286848,64.7,16863,5.6
Alabama,2012,6,2176818,58.1,1995546,53.3,181272,8.3
Alaska,2012,6,363960,68.0,337406,63.1,26554,7.3
Arizona,2012,6,3054066,61.0,2797416,55.9,256650,8.4
Arkansas,2012,6,1351226,59.6,1252563,55.3,98663,7.3
California,2012,6,18468110,63.1,16494261,56.3,1973849,10.7
Los Angeles County,2012,6,4890299,62.7,4346704,55.7,543595,11.1
Colorado,2012,6,2746042,68.8,2521989,63.2,224053,8.2
Connecticut,2012,6,1887999,66.4,1728720,60.8,159279,8.4
Delaware,2012,6,446176,62.1,414378,57.7,31798,7.1
District of Columbia,2012,6,364042,69.0,331349,62.8,32693,9.0
Florida,2012,6,9332286,60.5,8513758,55.2,818528,8.8
Georgia,2012,6,4770468,63.8,4335207,58.0,435261,9.1
Hawaii,2012,6,649786,61.0,610269,57.3,39517,6.1
Idaho,2012,6,771845,64.7,714218,59.9,57627,7.5
Illinois,2012,6,6579685,65.9,5983696,59.9,595989,9.1
Indiana,2012,6,3163404,62.9,2903332,57.7,260072,8.2
Iowa,2012,6,1657167,69.4,1572697,65.8,84470,5.1
Kansas,2012,6,1488524,68.5,1403130,64.5,85394,5.7
Kentucky,2012,6,2057041,60.7,1888219,55.7,168822,8.2
Louisiana,2012,6,2090759,59.7,1947689,55.6,143070,6.8
Maine,2012,6,700348,64.7,649429,60.0,50919,7.3
Maryland,2012,6,3116975,67.8,2900940,63.1,216035,6.9
Massachusetts,2012,6,3505430,65.5,3269278,61.1,236152,6.7
Michigan,2012,6,4676951,60.0,4253239,54.6,423712,9.1
Minnesota,2012,6,2944302,70.4,2776517,66.4,167785,5.7
Mississippi,2012,6,1329476,59.0,1211194,53.8,118282,8.9
Missouri,2012,6,2999577,64.2,2784194,59.6,215383,7.2
Montana,2012,6,506446,64.1,476486,60.3,29960,5.9
Nebraska,2012,6,1011216,71.7,971883,68.9,39333,3.9
Nevada,2012,6,1366798,64.4,1205447,56.8,161351,11.8
New Hampshire,2012,6,740199,69.3,699309,65.5,40890,5.5
New Jersey,2012,6,4575467,65.9,4138908,59.6,436559,9.5
New Mexico,2012,6,926467,58.2,862094,54.1,64373,6.9
New York,2012,6,9595186,61.7,8751630,56.2,843556,8.8
New York city,2012,6,4018648,60.1,3634283,54.3,384365,9.6
North Carolina,2012,6,4708084,62.8,4261249,56.8,446835,9.5
North Dakota,2012,6,395387,72.7,383880,70.6,11507,2.9
Ohio,2012,6,5708474,63.3,5289595,58.6,418879,7.3
Oklahoma,2012,6,1793879,62.0,1702959,58.9,90920,5.1
Oregon,2012,6,1966171,63.5,1791433,57.9,174738,8.9
Pennsylvania,2012,6,6450474,63.5,5950829,58.6,499645,7.7
Rhode Island,2012,6,559379,66.0,501371,59.1,58008,10.4
South Carolina,2012,6,2187672,59.9,1987341,54.4,200331,9.2
South Dakota,2012,6,446684,70.7,428374,67.8,18310,4.1
Tennessee,2012,6,3092371,61.6,2844370,56.7,248001,8.0
Texas,2012,6,12632078,65.4,11776105,61.0,855973,6.8
Utah,2012,6,1345980,66.5,1280955,63.3,65025,4.8
Vermont,2012,6,353999,69.2,336688,65.9,17311,4.9
Virginia,2012,6,4208558,66.6,3955368,62.6,253190,6.0
Washington,2012,6,3478835,64.7,3199945,59.5,278890,8.0
West Virginia,2012,6,808884,54.4,749257,50.4,59627,7.4
Wisconsin,2012,6,3067586,68.5,2852421,63.7,215165,7.0
Wyoming,2012,6,303733,68.4,286852,64.6,16881,5.6
Alabama,2012,7,2178985,58.2,1999860,53.4,179125,8.2
Alaska,2012,7,363887,67.9,337576,63.0,26311,7.2
Arizona,2012,7,3055366,61.0,2801303,55.9,254063,8.3
Arkansas,2012,7,1348643,59.5,1250599,55.2,98044,7.3
California,2012,7,18479876,63.1,16534689,56.4,1945187,10.5
Los Angeles County,2012,7,4891184,62.6,4355075,55.8,536109,11.0
Colorado,2012,7,2748077,68.8,2526809,63.2,221268,8.1
Connecticut,2012,7,1882615,66.1,1723907,60.6,158708,8.4
Delaware,2012,7,446132,62.0,414347,57.6,31785,7.1
District of Columbia,2012,7,365996,69.3,333656,63.1,32340,8.8
Florida,2012,7,9342026,60.5,8534305,55.3,807721,8.6
Georgia,2012,7,4773009,63.8,4343500,58.0,429509,9.0
Hawaii,2012,7,649583,60.9,611262,57.3,38321,5.9
Idaho,2012,7,772210,64.7,715144,59.9,57066,7.4
Illinois,2012,7,6583994,65.9,5989315,59.9,594679,9.0
Indiana,2012,7,3162320,62.8,2902854,57.7,259466,8.2
Iowa,2012,7,1656736,69.3,1572880,65.8,83856,5.1
Kansas,2012,7,1488847,68.4,1404335,64.6,84512,5.7
Kentucky,2012,7,2061588,60.8,1892555,55.8,169033,8.2
Louisiana,2012,7,2089201,59.6,1949077,55.6,140124,6.7
Maine,2012,7,700592,64.7,649809,60.0,50783,7.2
Maryland,2012,7,3121317,67.8,2905634,63.1,215683,6.9
Massachusetts,2012,7,3507770,65.5,3271778,61.1,235992,6.7
Michigan,2012,7,4680759,60.1,4257873,54.6,422886,9.0
Minnesota,2012,7,2947024,70.4,2779521,66.4,167503,5.7
Mississippi,2012,7,1329451,59.0,1211838,53.8,117613,8.8
Missouri,2012,7,3000439,64.2,2787304,59.7,213135,7.1
Montana,2012,7,507185,64.1,477470,60.4,29715,5.9
Nebraska,2012,7,1012787,71.8,973628,69.0,39159,3.9
Nevada,2012,7,1367483,64.4,1208382,56.9,159101,11.6
New Hampshire,2012,7,741133,69.3,699912,65.5,41221,5.6
New Jersey,2012,7,4576629,65.9,4141405,59.6,435224,9.5
New Mexico,2012,7,927463,58.2,863126,54.2,64337,6.9
New York,2012,7,9602750,61.7,8764316,56.3,838434,8.7
New York city,2012,7,4022788,60.1,3641679,54.4,381109,9.5
North Carolina,2012,7,4718993,62.9,4270883,56.9,448110,9.5
North Dakota,2012,7,396002,72.7,384458,70.6,11544,2.9
Ohio,2012,7,5703982,63.2,5290271,58.6,413711,7.3
Oklahoma,2012,7,1795981,62.0,1705012,58.9,90969,5.1
Oregon,2012,7,1962128,63.3,1789026,57.7,173102,8.8
Pennsylvania,2012,7,6458986,63.6,5957166,58.6,501820,7.8
Rhode Island,2012,7,560517,66.1,502970,59.3,57547,10.3
South Carolina,2012,7,2188604,59.9,1991994,54.5,196610,9.0
South Dakota,2012,7,447093,70.7,428772,67.8,18321,4.1
Tennessee,2012,7,3093294,61.6,2847096,56.7,246198,8.0
Texas,2012,7,12649825,65.4,11802014,61.0,847811,6.7
Utah,2012,7,1349636,66.6,1285107,63.4,64529,4.8
Vermont,2012,7,353993,69.2,336722,65.8,17271,4.9
Virginia,2012,7,4210712,66.6,3960179,62.6,250533,5.9
Washington,2012,7,3475293,64.5,3203044,59.5,272249,7.8
West Virginia,2012,7,808914,54.4,748988,50.3,59926,7.4
Wisconsin,2012,7,3068026,68.5,2853712,63.7,214314,7.0
Wyoming,2012,7,303794,68.3,286966,64.6,16828,5.5
Alabama,2012,8,2180942,58.2,2004716,53.5,176226,8.1
Alaska,2012,8,363879,67.9,337853,63.0,26026,7.2
Arizona,2012,8,3056822,60.9,2805561,55.9,251261,8.2
Arkansas,2012,8,1346157,59.3,1248907,55.1,97250,7.2
California,2012,8,18494681,63.0,16581684,56.5,1912997,10.3
Los Angeles County,2012,8,4895676,62.6,4367165,55.9,528511,10.8
Colorado,2012,8,2750560,68.7,2532901,63.3,217659,7.9
Connecticut,2012,8,1878205,66.0,1720408,60.4,157797,8.4
Delaware,2012,8,446071,62.0,414386,57.6,31685,7.1
District of Columbia,2012,8,368008,69.5,335940,63.4,32068,8.7
Florida,2012,8,9352027,60.5,8556664,55.3,795363,8.5
Georgia,2012,8,4775669,63.8,4351928,58.1,423741,8.9
Hawaii,2012,8,649534,60.9,612513,57.4,37021,5.7
Idaho,2012,8,772638,64.7,716202,59.9,56436,7.3
Illinois,2012,8,6588983,65.9,5997041,60.0,591942,9.0
Indiana,2012,8,3163313,62.8,2904676,57.7,258637,8.2
Iowa,2012,8,1657235,69.3,1574109,65.8,83126,5.0
Kansas,2012,8,1489743,68.5,1405991,64.6,83752,5.6
Kentucky,2012,8,2065968,60.9,1897095,55.9,168873,8.2
Louisiana,2012,8,2087894,59.6,1950819,55.7,137075,6.6
Maine,2012,8,700906,64.7,650411,60.1,50495,7.2
Maryland,2012,8,3126121,67.9,2911289,63.2,214832,6.9
Massachusetts,2012,8,3510235,65.5,3274743,61.1,235492,6.7
Michigan,2012,8,4685915,60.1,4264274,54.7,421641,9.0
Minnesota,2012,8,2950631,70.4,2783832,66.5,166799,5.7
Mississippi,2012,8,1329468,59.0,1212890,53.8,116578,8.8
Missouri,2012,8,3002370,64.2,2791175,59.7,211195,7.0
Montana,2012,8,507764,64.1,478438,60.4,29326,5.8
Nebraska,2012,8,1014558,71.8,975571,69.1,38987,3.8
Nevada,2012,8,1367955,64.3,1211574,57.0,156381,11.4
New Hampshire,2012,8,742064,69.4,700728,65.5,41336,5.6
New Jersey,2012,8,4578329,65.9,4145792,59.6,432537,9.4
New Mexico,2012,8,928991,58.3,864648,54.2,64343,6.9
New York,2012,8,9612652,61.7,8781926,56.4,830726,8.6
New York city,2012,8,4027658,60.1,3650267,54.5,377391,9.4
North Carolina,2012,8,4731208,63.0,4282400,57.0,448808,9.5
North Dakota,2012,8,396531,72.6,384938,70.5,11593,2.9
Ohio,2012,8,5701818,63.2,5292044,58.6,409774,7.2
Oklahoma,2012,8,1798319,62.1,1707423,58.9,90896,5.1
Oregon,2012,8,1958250,63.1,1786947,57.6,171303,8.7
Pennsylvania,2012,8,6466612,63.6,5964896,58.7,501716,7.8
Rhode Island,2012,8,561632,66.2,504721,59.5,56911,10.1
South Carolina,2012,8,2190380,59.8,1997580,54.6,192800,8.8
South Dakota,2012,8,447503,70.7,429274,67.8,18229,4.1
Tennessee,2012,8,3095301,61.6,2851322,56.7,243979,7.9
Texas,2012,8,12666216,65.4,11830108,61.1,836108,6.6
Utah,2012,8,1353555,66.7,1289584,63.5,63971,4.7
Vermont,2012,8,353956,69.2,336820,65.8,17136,4.8
Virginia,2012,8,4215085,66.6,3967765,62.7,247320,5.9
Washington,2012,8,3472450,64.4,3207615,59.5,264835,7.6
West Virginia,2012,8,808788,54.3,748953,50.3,59835,7.4
Wisconsin,2012,8,3068963,68.5,2856403,63.7,212560,6.9
Wyoming,2012,8,303836,68.3,287159,64.5,16677,5.5
Alabama,2012,9,2182771,58.2,2009352,53.6,173419,7.9
Alaska,2012,9,364057,67.9,338216,63.1,25841,7.1
Arizona,2012,9,3058702,60.9,2809750,55.9,248952,8.1
Arkansas,2012,9,1344172,59.2,1247567,55.0,96605,7.2
California,2012,9,18515366,63.0,16631825,56.6,1883541,10.2
Los Angeles County,2012,9,4904473,62.7,4382007,56.0,522466,10.7
Colorado,2012,9,2753956,68.7,2539967,63.4,213989,7.8
Connecticut,2012,9,1875209,65.8,1718236,60.3,156973,8.4
Delaware,2012,9,446070,61.9,414465,57.5,31605,7.1
District of Columbia,2012,9,369988,69.7,338002,63.7,31986,8.6
Florida,2012,9,9363037,60.5,8578931,55.4,784106,8.4
Georgia,2012,9,4778749,63.7,4359383,58.2,419366,8.8
Hawaii,2012,9,649620,60.9,613823,57.5,35797,5.5
Idaho,2012,9,773091,64.6,717238,60.0,55853,7.2
Illinois,2012,9,6594683,65.9,6003932,60.0,590751,9.0
Indiana,2012,9,3166249,62.8,2907739,57.7,258510,8.2
Iowa,2012,9,1658681,69.3,1576085,65.9,82596,5.0
Kansas,2012,9,1491050,68.5,1407653,64.7,83397,5.6
Kentucky,2012,9,2069786,61.0,1901222,56.0,168564,8.1
Louisiana,2012,9,2088122,59.5,1953077,55.7,135045,6.5
Maine,2012,9,701441,64.8,651204,60.1,50237,7.2
Maryland,2012,9,3131152,67.9,2917104,63.3,214048,6.8
Massachusetts,2012,9,3512915,65.5,3277612,61.1,235303,6.7
Michigan,2012,9,4692724,60.2,4271479,54.8,421245,9.0
Minnesota,2012,9,2955118,70.5,2789269,66.5,165849,5.6
Mississippi,2012,9,1329339,58.9,1213704,53.8,115635,8.7
Missouri,2012,9,3005264,64.3,2795016,59.8,210248,7.0
Montana,2012,9,508244,64.1,479327,60.5,28917,5.7
Nebraska,2012,9,1016381,71.9,977411,69.2,38970,3.8
Nevada,2012,9,1368573,64.3,1214739,57.0,153834,11.2
New Hampshire,2012,9,742994,69.4,701639,65.5,41355,5.6
New Jersey,2012,9,4581093,65.9,4151159,59.7,429934,9.4
New Mexico,2012,9,930861,58.4,866333,54.3,64528,6.9
New York,2012,9,9625882,61.8,8802411,56.5,823471,8.6
New York city,2012,9,4034092,60.2,3659522,54.6,374570,9.3
North Carolina,2012,9,4743200,63.0,4293726,57.1,449474,9.5
North Dakota,2012,9,397001,72.5,385324,70.4,11677,2.9
Ohio,2012,9,5702365,63.1,5293329,58.6,409036,7.2
Oklahoma,2012,9,1800762,62.1,1709795,59.0,90967,5.1
Oregon,2012,9,1954589,63.0,1784773,57.5,169816,8.7
Pennsylvania,2012,9,6473455,63.7,5972618,58.8,500837,7.7
Rhode Island,2012,9,562634,66.3,506423,59.7,56211,10.0
South Carolina,2012,9,2193195,59.8,2003396,54.7,189799,8.7
South Dakota,2012,9,447850,70.7,429788,67.8,18062,4.0
Tennessee,2012,9,3098402,61.6,2855937,56.8,242465,7.8
Texas,2012,9,12683588,65.4,11857386,61.1,826202,6.5
Utah,2012,9,1357700,66.8,1294133,63.6,63567,4.7
Vermont,2012,9,353835,69.1,336908,65.8,16927,4.8
Virginia,2012,9,4221076,66.6,3976567,62.8,244509,5.8
Washington,2012,9,3470187,64.3,3212569,59.5,257618,7.4
West Virginia,2012,9,808686,54.3,749108,50.3,59578,7.4
Wisconsin,2012,9,3070787,68.4,2859838,63.7,210949,6.9
Wyoming,2012,9,303842,68.2,287381,64.5,16461,5.4
Alabama,2012,10,2184006,58.2,2012918,53.6,171088,7.8
Alaska,2012,10,364283,67.9,338526,63.1,25757,7.1
Arizona,2012,10,3060209,60.8,2812844,55.9,247365,8.1
Arkansas,2012,10,1342472,59.1,1246289,54.9,96183,7.2
California,2012,10,18536565,63.1,16678616,56.7,1857949,10.0
Los Angeles County,2012,10,4915507,62.8,4397402,56.2,518105,10.5
Colorado,2012,10,2757466,68.7,2546891,63.4,210575,7.6
Connecticut,2012,10,1873204,65.7,1716902,60.2,156302,8.3
Delaware,2012,10,446007,61.8,414443,57.4,31564,7.1
District of Columbia,2012,10,371781,69.9,339713,63.9,32068,8.6
Florida,2012,10,9372631,60.4,8597972,55.4,774659,8.3
Georgia,2012,10,4780398,63.7,4364003,58.2,416395,8.7
Hawaii,2012,10,649565,60.8,614838,57.6,34727,5.3
Idaho,2012,10,773385,64.6,718040,59.9,55345,7.2
Illinois,2012,10,6598498,65.9,6006076,60.0,592422,9.0
Indiana,2012,10,3169729,62.9,2910539,57.7,259190,8.2
Iowa,2012,10,1660482,69.3,1578228,65.9,82254,5.0
Kansas,2012,10,1492122,68.5,1408760,64.7,83362,5.6
Kentucky,2012,10,2072317,61.0,1904250,56.1,168067,8.1
Louisiana,2012,10,2089992,59.5,1955491,55.7,134501,6.4
Maine,2012,10,702058,64.8,652017,60.2,50041,7.1
Maryland,2012,10,3135207,67.9,2921744,63.3,213463,6.8
Massachusetts,2012,10,3514788,65.5,3279317,61.1,235471,6.7
Michigan,2012,10,4699999,60.2,4278209,54.8,421790,9.0
Minnesota,2012,10,2959485,70.5,2795149,66.6,164336,5.6
Mississippi,2012,10,1328815,58.9,1213839,53.8,114976,8.7
Missouri,2012,10,3007710,64.3,2797738,59.8,209972,7.0
Montana,2012,10,508604,64.1,480064,60.5,28540,5.6
Nebraska,2012,10,1017762,72.0,978737,69.2,39025,3.8
Nevada,2012,10,1369063,64.2,1217434,57.1,151629,11.1
New Hampshire,2012,10,743749,69.4,702413,65.6,41336,5.6
New Jersey,2012,10,4583579,65.9,4156020,59.7,427559,9.3
New Mexico,2012,10,932379,58.4,867580,54.4,64799,6.9
New York,2012,10,9638067,61.8,8820734,56.6,817333,8.5
New York city,2012,10,4040062,60.2,3667327,54.7,372735,9.2
North Carolina,2012,10,4752900,63.1,4302880,57.1,450020,9.5
North Dakota,2012,10,397453,72.5,385682,70.3,11771,3.0
Ohio,2012,10,5703549,63.1,5291979,58.6,411570,7.2
Oklahoma,2012,10,1802490,62.1,1711251,59.0,91239,5.1
Oregon,2012,10,1950570,62.8,1782030,57.4,168540,8.6
Pennsylvania,2012,10,6477053,63.7,5977594,58.8,499459,7.7
Rhode Island,2012,10,563279,66.3,507798,59.8,55481,9.8
South Carolina,2012,10,2196167,59.9,2008369,54.7,187798,8.6
South Dakota,2012,10,448011,70.7,430176,67.8,17835,4.0
Tennessee,2012,10,3101365,61.6,2859257,56.8,242108,7.8
Texas,2012,10,12700534,65.4,11879763,61.1,820771,6.5
Utah,2012,10,1361555,66.8,1298314,63.7,63241,4.6
Vermont,2012,10,353543,69.1,336872,65.8,16671,4.7
Virginia,2012,10,4226595,66.7,3984368,62.8,242227,5.7
Washington,2012,10,3467617,64.2,3216647,59.6,250970,7.2
West Virginia,2012,10,808416,54.3,749232,50.3,59184,7.3
Wisconsin,2012,10,3072854,68.5,2862941,63.8,209913,6.8
Wyoming,2012,10,303715,68.1,287540,64.5,16175,5.3
Alabama,2012,11,2184400,58.2,2015057,53.7,169343,7.8
Alaska,2012,11,364384,67.9,338657,63.1,25727,7.1
Arizona,2012,11,3060910,60.8,2814217,55.9,246693,8.1
Arkansas,2012,11,1340897,59.0,1244873,54.8,96024,7.2
California,2012,11,18553309,63.0,16717341,56.8,1835968,9.9
Los Angeles County,2012,11,4926132,62.9,4410985,56.3,515147,10.5
Colorado,2012,11,2760368,68.7,2552987,63.5,207381,7.5
Connecticut,2012,11,1871522,65.6,1715773,60.2,155749,8.3
Delaware,2012,11,445776,61.7,414226,57.3,31550,7.1
District of Columbia,2012,11,373228,70.1,340978,64.0,32250,8.6
Florida,2012,11,9379264,60.4,8612023,55.5,767241,8.2
Georgia,2012,11,4779443,63.6,4365109,58.1,414334,8.7
Hawaii,2012,11,649173,60.7,615327,57.6,33846,5.2
Idaho,2012,11,773460,64.5,718524,59.9,54936,7.1
Illinois,2012,11,6598094,65.9,6001684,60.0,596410,9.0
Indiana,2012,11,3172886,62.9,2912626,57.7,260260,8.2
Iowa,2012,11,1661913,69.4,1579766,65.9,82147,4.9
Kansas,2012,11,1492672,68.5,1409248,64.7,83424,5.6
Kentucky,2012,11,2073384,61.0,1905934,56.1,167450,8.1
Louisiana,2012,11,2092996,59.6,1957453,55.7,135543,6.5
Maine,2012,11,702606,64.8,652681,60.2,49925,7.1
Maryland,2012,11,3137652,67.9,2924538,63.3,213114,6.8
Massachusetts,2012,11,3515318,65.4,3279422,61.0,235896,6.7
Michigan,2012,11,4706523,60.3,4283628,54.9,422895,9.0
Minnesota,2012,11,2962759,70.6,2800283,66.7,162476,5.5
Mississippi,2012,11,1327884,58.8,1213261,53.7,114623,8.6
Missouri,2012,11,3008994,64.3,2799168,59.8,209826,7.0
Montana,2012,11,508875,64.1,480628,60.5,28247,5.6
Nebraska,2012,11,1018499,72.0,979433,69.2,39066,3.8
Nevada,2012,11,1369310,64.1,1219490,57.1,149820,10.9
New Hampshire,2012,11,744167,69.4,702822,65.6,41345,5.6
New Jersey,2012,11,4584357,65.9,4159323,59.8,425034,9.3
New Mexico,2012,11,933099,58.4,868064,54.4,65035,7.0
New York,2012,11,9645668,61.8,8833612,56.6,812056,8.4
New York city,2012,11,4044055,60.3,3672533,54.7,371522,9.2
North Carolina,2012,11,4758979,63.1,4308809,57.1,450170,9.5
North Dakota,2012,11,397899,72.4,386044,70.2,11855,3.0
Ohio,2012,11,5703304,63.1,5287084,58.5,416220,7.3
Oklahoma,2012,11,1802927,62.1,1711235,58.9,91692,5.1
Oregon,2012,11,1945807,62.6,1778641,57.2,167166,8.6
Pennsylvania,2012,11,6475700,63.7,5977993,58.8,497707,7.7
Rhode Island,2012,11,563414,66.3,508614,59.9,54800,9.7
South Carolina,2012,11,2198590,59.8,2011982,54.8,186608,8.5
South Dakota,2012,11,447969,70.6,430360,67.8,17609,3.9
Tennessee,2012,11,3103321,61.6,2860286,56.8,243035,7.8
Texas,2012,11,12716045,65.3,11895325,61.1,820720,6.5
Utah,2012,11,1364818,66.9,1301946,63.8,62872,4.6
Vermont,2012,11,353111,69.0,336683,65.7,16428,4.7
Virginia,2012,11,4230245,66.7,3989727,62.9,240518,5.7
Washington,2012,11,3464221,64.1,3219140,59.6,245081,7.1
West Virginia,2012,11,807801,54.3,749142,50.3,58659,7.3
Wisconsin,2012,11,3074792,68.5,2864732,63.8,210060,6.8
Wyoming,2012,11,303456,68.0,287578,64.4,15878,5.2
Alabama,2012,12,2183700,58.1,2015725,53.7,167975,7.7
Alaska,2012,12,364287,67.8,338581,63.0,25706,7.1
Arizona,2012,12,3060362,60.7,2813704,55.8,246658,8.1
Arkansas,2012,12,1339452,58.9,1243386,54.7,96066,7.2
California,2012,12,18562700,63.0,16747321,56.9,1815379,9.8
Los Angeles County,2012,12,4934209,62.9,4421509,56.4,512700,10.4
Colorado,2012,12,2762211,68.6,2558031,63.5,204180,7.4
Connecticut,2012,12,1869431,65.6,1714212,60.1,155219,8.3
Delaware,2012,12,445343,61.6,413820,57.2,31523,7.1
District of Columbia,2012,12,374209,70.2,341766,64.1,32443,8.7
Florida,2012,12,9382701,60.3,8621568,55.5,761133,8.1
Georgia,2012,12,4776076,63.5,4363590,58.1,412486,8.6
Hawaii,2012,12,648487,60.6,615337,57.5,33150,5.1
Idaho,2012,12,773323,64.4,718703,59.9,54620,7.1
Illinois,2012,12,6592899,65.8,5991770,59.8,601129,9.1
Indiana,2012,12,3175152,62.9,2914128,57.7,261024,8.2
Iowa,2012,12,1662647,69.4,1580457,65.9,82190,4.9
Kansas,2012,12,1492648,68.5,1409265,64.7,83383,5.6
Kentucky,2012,12,2072953,61.0,1906182,56.1,166771,8.0
Louisiana,2012,12,2096245,59.7,1958519,55.7,137726,6.6
Maine,2012,12,703024,64.9,653171,60.3,49853,7.1
Maryland,2012,12,3138497,67.9,2925667,63.3,212830,6.8
Massachusetts,2012,12,3514801,65.3,3278423,61.0,236378,6.7
Michigan,2012,12,4711644,60.3,4287975,54.9,423669,9.0
Minnesota,2012,12,2964526,70.6,2803934,66.7,160592,5.4
Mississippi,2012,12,1326506,58.7,1212063,53.7,114443,8.6
Missouri,2012,12,3009177,64.3,2799741,59.8,209436,7.0
Montana,2012,12,509103,64.0,481061,60.5,28042,5.5
Nebraska,2012,12,1018587,71.9,979573,69.2,39014,3.8
Nevada,2012,12,1369233,64.0,1220968,57.1,148265,10.8
New Hampshire,2012,12,744222,69.4,702860,65.6,41362,5.6
New Jersey,2012,12,4582248,65.8,4160353,59.8,421895,9.2
New Mexico,2012,12,933029,58.4,867842,54.3,65187,7.0
New York,2012,12,9647282,61.8,8840572,56.7,806710,8.4
New York city,2012,12,4045919,60.3,3675466,54.7,370453,9.2
North Carolina,2012,12,4761413,63.1,4311658,57.1,449755,9.4
North Dakota,2012,12,398367,72.3,386448,70.1,11919,3.0
Ohio,2012,12,5701489,63.1,5279998,58.4,421491,7.4
Oklahoma,2012,12,1802218,62.0,1709988,58.8,92230,5.1
Oregon,2012,12,1940426,62.4,1775016,57.0,165410,8.5
Pennsylvania,2012,12,6469454,63.6,5974427,58.7,495027,7.7
Rhode Island,2012,12,562969,66.3,508737,59.9,54232,9.6
South Carolina,2012,12,2199962,59.8,2014398,54.8,185564,8.4
South Dakota,2012,12,447801,70.5,430364,67.7,17437,3.9
Tennessee,2012,12,3103871,61.6,2859008,56.7,244863,7.9
Texas,2012,12,12730458,65.3,11905455,61.1,825003,6.5
Utah,2012,12,1367434,66.9,1305067,63.9,62367,4.6
Vermont,2012,12,352575,68.8,336348,65.7,16227,4.6
Virginia,2012,12,4231663,66.6,3992299,62.9,239364,5.7
Washington,2012,12,3459702,64.0,3219911,59.5,239791,6.9
West Virginia,2012,12,806607,54.2,748703,50.3,57904,7.2
Wisconsin,2012,12,3076106,68.5,2864807,63.8,211299,6.9
Wyoming,2012,12,303094,67.9,287479,64.4,15615,5.2
Alabama,2013,1,2181651,58.1,2015043,53.6,166608,7.6
Alaska,2013,1,364023,67.7,338344,63.0,25679,7.1
Arizona,2013,1,3058620,60.6,2811785,55.7,246835,8.1
Arkansas,2013,1,1338053,58.9,1241811,54.6,96242,7.2
California,2013,1,18564212,63.0,16769858,56.9,1794354,9.7
Los Angeles County,2013,1,4939263,62.9,4429189,56.4,510074,10.3
Colorado,2013,1,2762675,68.5,2561687,63.5,200988,7.3
Connecticut,2013,1,1866718,65.4,1712022,60.0,154696,8.3
Delaware,2013,1,444691,61.4,413236,57.1,31455,7.1
District of Columbia,2013,1,374703,70.1,342127,64.0,32576,8.7
Florida,2013,1,9383321,60.3,8628007,55.4,755314,8.0
Georgia,2013,1,4771071,63.4,4360605,58.0,410466,8.6
Hawaii,2013,1,647730,60.5,615167,57.4,32563,5.0
Idaho,2013,1,773064,64.3,718684,59.8,54380,7.0
Illinois,2013,1,6584280,65.7,5978819,59.7,605461,9.2
Indiana,2013,1,3176337,62.9,2915330,57.7,261007,8.2
Iowa,2013,1,1662643,69.3,1580382,65.9,82261,4.9
Kansas,2013,1,1492010,68.4,1408859,64.6,83151,5.6
Kentucky,2013,1,2071047,60.9,1904810,56.0,166237,8.0
Louisiana,2013,1,2098900,59.7,1958670,55.7,140230,6.7
Maine,2013,1,703233,64.9,653477,60.3,49756,7.1
Maryland,2013,1,3138015,67.9,2925435,63.3,212580,6.8
Massachusetts,2013,1,3513585,65.3,3276681,60.9,236904,6.7
Michigan,2013,1,4715747,60.4,4292124,54.9,423623,9.0
Minnesota,2013,1,2964871,70.5,2806119,66.8,158752,5.4
Mississippi,2013,1,1316549,58.3,1202216,53.2,114333,8.7
Missouri,2013,1,3008594,64.3,2799781,59.8,208813,6.9
Montana,2013,1,509349,64.0,481423,60.5,27926,5.5
Nebraska,2013,1,1018110,71.9,979223,69.1,38887,3.8
Nevada,2013,1,1368931,64.0,1222071,57.1,146860,10.7
New Hampshire,2013,1,743915,69.4,702626,65.5,41289,5.6
New Jersey,2013,1,4576918,65.7,4158784,59.7,418134,9.1
New Mexico,2013,1,932257,58.3,867056,54.3,65201,7.0
New York,2013,1,9643243,61.8,8842773,56.6,800470,8.3
New York city,2013,1,4045886,60.2,3676776,54.7,369110,9.1
North Carolina,2013,1,4761137,63.0,4312086,57.1,449051,9.4
North Dakota,2013,1,398890,72.2,386941,70.1,11949,3.0
Ohio,2013,1,5699301,63.0,5272736,58.3,426565,7.5
Oklahoma,2013,1,1800908,61.9,1708092,58.7,92816,5.2
Oregon,2013,1,1934879,62.1,1771649,56.9,163230,8.4
Pennsylvania,2013,1,6459448,63.5,5968637,58.7,490811,7.6
Rhode Island,2013,1,562023,66.1,508212,59.8,53811,9.6
South Carolina,2013,1,2200061,59.8,2016002,54.8,184059,8.4
South Dakota,2013,1,447554,70.4,430244,67.7,17310,3.9
Tennessee,2013,1,3102423,61.5,2855543,56.6,246880,8.0
Texas,2013,1,12743658,65.3,11912520,61.0,831138,6.5
Utah,2013,1,1369579,66.9,1307839,63.9,61740,4.5
Vermont,2013,1,351969,68.7,335874,65.6,16095,4.6
Virginia,2013,1,4230986,66.6,3992211,62.8,238775,5.6
Washington,2013,1,3457127,63.9,3219092,59.5,238035,6.9
West Virginia,2013,1,804803,54.1,747905,50.3,56898,7.1
Wisconsin,2013,1,3076445,68.4,2863647,63.7,212798,6.9
Wyoming,2013,1,302668,67.7,287303,64.3,15365,5.1
Alabama,2013,2,2178756,58.0,2013876,53.6,164880,7.6
Alaska,2013,2,363684,67.7,338057,62.9,25627,7.0
Arizona,2013,2,3056893,60.5,2810201,55.6,246692,8.1
Arkansas,2013,2,1336764,58.8,1240366,54.6,96398,7.2
California,2013,2,18561589,62.9,16789624,56.9,1771965,9.5
Los Angeles County,2013,2,4942531,62.9,4435657,56.5,506874,10.3
Colorado,2013,2,2762415,68.4,2564483,63.5,197932,7.2
Connecticut,2013,2,1864254,65.3,1710153,59.9,154101,8.3
Delaware,2013,2,443906,61.3,412611,57.0,31295,7.0
District of Columbia,2013,2,374879,70.1,342281,64.0,32598,8.7
Florida,2013,2,9383328,60.2,8634844,55.4,748484,8.0
Georgia,2013,2,4765817,63.3,4357909,57.9,407908,8.6
Hawaii,2013,2,647257,60.4,615252,57.4,32005,4.9
Idaho,2013,2,773031,64.3,718812,59.8,54219,7.0
Illinois,2013,2,6574749,65.6,5966349,59.6,608400,9.3
Indiana,2013,2,3177057,62.9,2917239,57.7,259818,8.2
Iowa,2013,2,1662690,69.3,1580469,65.9,82221,4.9
Kansas,2013,2,1491109,68.4,1408465,64.6,82644,5.5
Kentucky,2013,2,2068320,60.8,1902317,55.9,166003,8.0
Louisiana,2013,2,2100577,59.7,1958498,55.7,142079,6.8
Maine,2013,2,703337,64.9,653775,60.3,49562,7.0
Maryland,2013,2,3136770,67.8,2924605,63.2,212165,6.8
Massachusetts,2013,2,3512599,65.2,3275220,60.8,237379,6.8
Michigan,2013,2,4719805,60.4,4297093,55.0,422712,9.0
Minnesota,2013,2,2964112,70.5,2807168,66.7,156944,5.3
Mississippi,2013,2,1306538,57.8,1192627,52.8,113911,8.7
Missouri,2013,2,3008137,64.2,2800121,59.8,208016,6.9
Montana,2013,2,509687,64.0,481801,60.5,27886,5.5
Nebraska,2013,2,1017500,71.8,978771,69.1,38729,3.8
Nevada,2013,2,1368771,63.9,1223325,57.1,145446,10.6
New Hampshire,2013,2,743386,69.3,702355,65.5,41031,5.5
New Jersey,2013,2,4569169,65.6,4155701,59.7,413468,9.0
New Mexico,2013,2,931106,58.2,866088,54.2,65018,7.0
New York,2013,2,9637148,61.7,8844420,56.6,792728,8.2
New York city,2013,2,4045599,60.2,3678376,54.7,367223,9.1
North Carolina,2013,2,4743684,62.7,4311836,57.0,431848,9.1
North Dakota,2013,2,399469,72.2,387536,70.0,11933,3.0
Ohio,2013,2,5698685,63.0,5268265,58.2,430420,7.6
Oklahoma,2013,2,1799714,61.8,1706445,58.6,93269,5.2
Oregon,2013,2,1929899,62.0,1769268,56.8,160631,8.3
Pennsylvania,2013,2,6448317,63.4,5963576,58.6,484741,7.5
Rhode Island,2013,2,560911,66.0,507392,59.7,53519,9.5
South Carolina,2013,2,2199344,59.7,2017705,54.7,181639,8.3
South Dakota,2013,2,447340,70.3,430138,67.6,17202,3.8
Tennessee,2013,2,3099418,61.4,2851148,56.5,248270,8.0
Texas,2013,2,12757010,65.3,11921233,61.0,835777,6.6
Utah,2013,2,1371797,67.0,1310766,64.0,61031,4.4
Vermont,2013,2,351387,68.6,335357,65.5,16030,4.6
Virginia,2013,2,4229626,66.5,3991100,62.7,238526,5.6
Washington,2013,2,3447914,63.6,3217874,59.4,230040,6.7
West Virginia,2013,2,802827,54.0,747084,50.2,55743,6.9
Wisconsin,2013,2,3076554,68.4,2862894,63.7,213660,6.9
Wyoming,2013,2,302300,67.6,287193,64.2,15107,5.0
Alabama,2013,3,2175993,57.9,2013323,53.5,162670,7.5
Alaska,2013,3,363411,67.6,337876,62.8,25535,7.0
Arizona,2013,3,3056334,60.4,2810619,55.5,245715,8.0
Arkansas,2013,3,1335682,58.7,1239345,54.5,96337,7.2
California,2013,3,18560032,62.9,16812502,56.9,1747530,9.4
Los Angeles County,2013,3,4945644,62.9,4442932,56.5,502712,10.2
Colorado,2013,3,2762705,68.3,2567602,63.5,195103,7.1
Connecticut,2013,3,1863120,65.3,1709824,59.9,153296,8.2
Delaware,2013,3,443158,61.1,412171,56.9,30987,7.0
District of Columbia,2013,3,374852,69.9,342391,63.9,32461,8.7
Florida,2013,3,9385906,60.2,8646346,55.4,739560,7.9
Georgia,2013,3,4761620,63.2,4357295,57.8,404325,8.5
Hawaii,2013,3,647266,60.4,615831,57.4,31435,4.9
Idaho,2013,3,773507,64.3,719407,59.8,54100,7.0
Illinois,2013,3,6567333,65.6,5958222,59.5,609111,9.3
Indiana,2013,3,3178518,62.9,2921428,57.8,257090,8.1
Iowa,2013,3,1664171,69.3,1582269,65.9,81902,4.9
Kansas,2013,3,1490526,68.4,1408599,64.6,81927,5.5
Kentucky,2013,3,2065701,60.7,1899808,55.8,165893,8.0
Louisiana,2013,3,2101504,59.7,1958880,55.7,142624,6.8
Maine,2013,3,703516,64.9,654325,60.4,49191,7.0
Maryland,2013,3,3135411,67.7,2924180,63.2,211231,6.7
Massachusetts,2013,3,3513023,65.2,3275474,60.8,237549,6.8
Michigan,2013,3,4724478,60.4,4303586,55.1,420892,8.9
Minnesota,2013,3,2962646,70.4,2807616,66.7,155030,5.2
Mississippi,2013,3,1296897,57.4,1183985,52.4,112912,8.7
Missouri,2013,3,3008816,64.2,2801682,59.8,207134,6.9
Montana,2013,3,510119,64.0,482245,60.5,27874,5.5
Nebraska,2013,3,1017147,71.7,978654,69.0,38493,3.8
Nevada,2013,3,1368999,63.8,1225232,57.1,143767,10.5
New Hampshire,2013,3,742974,69.2,702439,65.4,40535,5.5
New Jersey,2013,3,4560491,65.5,4152943,59.6,407548,8.9
New Mexico,2013,3,930071,58.2,865458,54.1,64613,6.9
New York,2013,3,9634141,61.7,8850795,56.7,783346,8.1
New York city,2013,3,4047400,60.2,3682548,54.8,364852,9.0
North Carolina,2013,3,4728352,62.5,4313036,57.0,415316,8.8
North Dakota,2013,3,400112,72.1,388244,70.0,11868,3.0
Ohio,2013,3,5701127,63.0,5269020,58.2,432107,7.6
Oklahoma,2013,3,1799353,61.8,1706007,58.6,93346,5.2
Oregon,2013,3,1926144,61.8,1768464,56.7,157680,8.2
Pennsylvania,2013,3,6439008,63.3,5961886,58.6,477122,7.4
Rhode Island,2013,3,559931,65.9,506604,59.6,53327,9.5
South Carolina,2013,3,2198641,59.6,2020519,54.8,178122,8.1
South Dakota,2013,3,447292,70.2,430213,67.6,17079,3.8
Tennessee,2013,3,3095898,61.3,2847593,56.4,248305,8.0
Texas,2013,3,12772688,65.2,11936855,61.0,835833,6.5
Utah,2013,3,1374623,67.0,1314333,64.1,60290,4.4
Vermont,2013,3,350931,68.5,334949,65.4,15982,4.6
Virginia,2013,3,4229584,66.5,3991308,62.7,238276,5.6
Washington,2013,3,3449293,63.6,3218064,59.4,231229,6.7
West Virginia,2013,3,801204,53.9,746643,50.2,54561,6.8
Wisconsin,2013,3,3077411,68.4,2864201,63.7,213210,6.9
Wyoming,2013,3,302083,67.5,287262,64.2,14821,4.9
Alabama,2013,4,2174613,57.8,2014210,53.5,160403,7.4
Alaska,2013,4,363341,67.6,337923,62.8,25418,7.0
Arizona,2013,4,3057784,60.3,2813639,55.5,244145,8.0
Arkansas,2013,4,1334874,58.7,1238821,54.5,96053,7.2
California,2013,4,18565682,62.8,16842626,57.0,1723056,9.3
Los Angeles County,2013,4,4951161,63.0,4453164,56.6,497997,10.1
Colorado,2013,4,2764238,68.3,2571622,63.5,192616,7.0
Connecticut,2013,4,1863931,65.3,1711614,60.0,152317,8.2
Delaware,2013,4,442681,61.0,412135,56.8,30546,6.9
District of Columbia,2013,4,374770,69.8,342590,63.8,32180,8.6
Florida,2013,4,9394008,60.2,8664776,55.5,729232,7.8
Georgia,2013,4,4759649,63.1,4359853,57.8,399796,8.4
Hawaii,2013,4,647794,60.4,616903,57.5,30891,4.8
Idaho,2013,4,774575,64.3,720581,59.8,53994,7.0
Illinois,2013,4,6564365,65.5,5956555,59.4,607810,9.3
Indiana,2013,4,3181648,62.9,2928625,57.9,253023,8.0
Iowa,2013,4,1668153,69.5,1586806,66.1,81347,4.9
Kansas,2013,4,1490653,68.3,1409461,64.6,81192,5.4
Kentucky,2013,4,2064135,60.6,1898417,55.7,165718,8.0
Louisiana,2013,4,2102390,59.7,1960578,55.7,141812,6.7
Maine,2013,4,704005,64.9,655326,60.4,48679,6.9
Maryland,2013,4,3134729,67.7,2925125,63.2,209604,6.7
Massachusetts,2013,4,3515403,65.2,3278014,60.8,237389,6.8
Michigan,2013,4,4730864,60.5,4311970,55.2,418894,8.9
Minnesota,2013,4,2961290,70.3,2808242,66.7,153048,5.2
Mississippi,2013,4,1288199,57.0,1176746,52.0,111453,8.7
Missouri,2013,4,3011278,64.3,2804770,59.9,206508,6.9
Montana,2013,4,510594,64.0,482766,60.5,27828,5.5
Nebraska,2013,4,1017223,71.7,978991,69.0,38232,3.8
Nevada,2013,4,1369806,63.8,1227979,57.2,141827,10.4
New Hampshire,2013,4,743014,69.2,703126,65.5,39888,5.4
New Jersey,2013,4,4552734,65.3,4152015,59.6,400719,8.8
New Mexico,2013,4,929563,58.1,865440,54.1,64123,6.9
New York,2013,4,9638121,61.7,8864330,56.7,773791,8.0
New York city,2013,4,4052849,60.2,3690072,54.8,362777,9.0
North Carolina,2013,4,4716914,62.3,4317396,57.0,399518,8.5
North Dakota,2013,4,400851,72.1,389070,70.0,11781,2.9
Ohio,2013,4,5706929,63.1,5274989,58.3,431940,7.6
Oklahoma,2013,4,1800235,61.8,1707161,58.6,93074,5.2
Oregon,2013,4,1924158,61.7,1769494,56.7,154664,8.0
Pennsylvania,2013,4,6433901,63.2,5964767,58.6,469134,7.3
Rhode Island,2013,4,559297,65.8,506046,59.5,53251,9.5
South Carolina,2013,4,2198847,59.5,2024897,54.8,173950,7.9
South Dakota,2013,4,447485,70.2,430546,67.6,16939,3.8
Tennessee,2013,4,3092912,61.2,2845925,56.3,246987,8.0
Texas,2013,4,12793456,65.3,11962083,61.0,831373,6.5
Utah,2013,4,1378344,67.1,1318709,64.2,59635,4.3
Vermont,2013,4,350684,68.4,334772,65.3,15912,4.5
Virginia,2013,4,4232119,66.4,3994223,62.7,237896,5.6
Washington,2013,4,3452380,63.6,3220670,59.4,231710,6.7
West Virginia,2013,4,800277,53.8,746757,50.2,53520,6.7
Wisconsin,2013,4,3079639,68.5,2868180,63.8,211459,6.9
Wyoming,2013,4,302063,67.4,287539,64.2,14524,4.8
Alabama,2013,5,2174482,57.8,2015808,53.6,158674,7.3
Alaska,2013,5,363431,67.5,338083,62.8,25348,7.0
Arizona,2013,5,3060694,60.3,2818192,55.5,242502,7.9
Arkansas,2013,5,1334104,58.6,1238431,54.4,95673,7.2
California,2013,5,18576563,62.8,16874399,57.0,1702164,9.2
Los Angeles County,2013,5,4959134,63.0,4465499,56.7,493635,10.0
Colorado,2013,5,2766305,68.2,2575647,63.5,190658,6.9
Connecticut,2013,5,1866153,65.4,1714775,60.1,151378,8.1
Delaware,2013,5,442526,60.9,412480,56.8,30046,6.8
District of Columbia,2013,5,374621,69.7,342718,63.7,31903,8.5
Florida,2013,5,9405649,60.2,8686257,55.6,719392,7.6
Georgia,2013,5,4758784,63.1,4363716,57.8,395068,8.3
Hawaii,2013,5,648702,60.4,618211,57.6,30491,4.7
Idaho,2013,5,776008,64.3,722073,59.9,53935,7.0
Illinois,2013,5,6564150,65.5,5958543,59.4,605607,9.2
Indiana,2013,5,3185716,63.0,2937252,58.1,248464,7.8
Iowa,2013,5,1673821,69.7,1593137,66.3,80684,4.8
Kansas,2013,5,1491094,68.3,1410482,64.6,80612,5.4
Kentucky,2013,5,2063352,60.5,1897711,55.7,165641,8.0
Louisiana,2013,5,2103144,59.7,1963094,55.7,140050,6.7
Maine,2013,5,704715,65.0,656605,60.6,48110,6.8
Maryland,2013,5,3134344,67.6,2926541,63.1,207803,6.6
Massachusetts,2013,5,3518522,65.2,3281377,60.8,237145,6.7
Michigan,2013,5,4738195,60.6,4320494,55.2,417701,8.8
Minnesota,2013,5,2960131,70.3,2808881,66.7,151250,5.1
Mississippi,2013,5,1280192,56.6,1170333,51.7,109859,8.6
Missouri,2013,5,3014209,64.3,2808028,59.9,206181,6.8
Montana,2013,5,510966,64.0,483222,60.5,27744,5.4
Nebraska,2013,5,1017337,71.7,979326,69.0,38011,3.7
Nevada,2013,5,1370943,63.8,1231067,57.3,139876,10.2
New Hampshire,2013,5,743406,69.2,704110,65.5,39296,5.3
New Jersey,2013,5,4545446,65.2,4151597,59.6,393849,8.7
New Mexico,2013,5,929480,58.1,865698,54.1,63782,6.9
New York,2013,5,9646461,61.7,8880236,56.8,766225,7.9
New York city,2013,5,4060929,60.3,3698921,54.9,362008,8.9
North Carolina,2013,5,4708233,62.1,4324012,57.0,384221,8.2
North Dakota,2013,5,401517,72.1,389822,70.0,11695,2.9
Ohio,2013,5,5713147,63.1,5281766,58.3,431381,7.6
Oklahoma,2013,5,1801681,61.8,1708925,58.6,92756,5.1
Oregon,2013,5,1923376,61.6,1771464,56.8,151912,7.9
Pennsylvania,2013,5,6431705,63.2,5969205,58.7,462500,7.2
Rhode Island,2013,5,558940,65.7,505643,59.5,53297,9.5
South Carolina,2013,5,2199734,59.5,2029943,54.9,169791,7.7
South Dakota,2013,5,447737,70.2,430933,67.6,16804,3.8
Tennessee,2013,5,3089865,61.1,2844913,56.2,244952,7.9
Texas,2013,5,12816378,65.3,11991479,61.1,824899,6.4
Utah,2013,5,1382531,67.2,1323353,64.3,59178,4.3
Vermont,2013,5,350554,68.4,334741,65.3,15813,4.5
Virginia,2013,5,4236152,66.4,3998446,62.7,237706,5.6
Washington,2013,5,3456355,63.6,3224598,59.4,231757,6.7
West Virginia,2013,5,799870,53.8,747059,50.2,52811,6.6
Wisconsin,2013,5,3082194,68.5,2873099,63.8,209095,6.8
Wyoming,2013,5,302153,67.4,287874,64.2,14279,4.7
Alabama,2013,6,2174677,57.8,2016898,53.6,157779,7.3
Alaska,2013,6,363613,67.6,338220,62.8,25393,7.0
Arizona,2013,6,3064094,60.3,2822985,55.6,241109,7.9
Arkansas,2013,6,1333280,58.6,1237985,54.4,95295,7.1
California,2013,6,18587359,62.8,16900895,57.1,1686464,9.1
Los Angeles County,2013,6,4967200,63.1,4477164,56.9,490036,9.9
Colorado,2013,6,2768303,68.2,2579085,63.5,189218,6.8
Connecticut,2013,6,1868813,65.4,1718256,60.2,150557,8.1
Delaware,2013,6,442641,60.9,413085,56.8,29556,6.7
District of Columbia,2013,6,374318,69.5,342566,63.6,31752,8.5
Florida,2013,6,9417639,60.2,8706200,55.6,711439,7.6
Georgia,2013,6,4757233,63.0,4366608,57.8,390625,8.2
Hawaii,2013,6,649806,60.5,619477,57.7,30329,4.7
Idaho,2013,6,777564,64.4,723613,59.9,53951,6.9
Illinois,2013,6,6564252,65.5,5960949,59.5,603303,9.2
Indiana,2013,6,3190582,63.0,2946381,58.2,244201,7.7
Iowa,2013,6,1679506,69.9,1599483,66.5,80023,4.8
Kansas,2013,6,1491270,68.3,1411118,64.7,80152,5.4
Kentucky,2013,6,2062469,60.5,1896774,55.6,165695,8.0
Louisiana,2013,6,2103648,59.7,1965593,55.8,138055,6.6
Maine,2013,6,705441,65.0,657855,60.7,47586,6.7
Maryland,2013,6,3133645,67.6,2927329,63.1,206316,6.6
Massachusetts,2013,6,3520920,65.1,3284024,60.8,236896,6.7
Michigan,2013,6,4745039,60.6,4327389,55.3,417650,8.8
Minnesota,2013,6,2959310,70.2,2809549,66.6,149761,5.1
Mississippi,2013,6,1272370,56.2,1163744,51.4,108626,8.5
Missouri,2013,6,3015995,64.3,2810122,59.9,205873,6.8
Montana,2013,6,511208,64.0,483568,60.5,27640,5.4
Nebraska,2013,6,1017004,71.6,979203,69.0,37801,3.7
Nevada,2013,6,1372012,63.8,1233932,57.3,138080,10.1
New Hampshire,2013,6,743863,69.2,704956,65.6,38907,5.2
New Jersey,2013,6,4537662,65.1,4150253,59.5,387409,8.5
New Mexico,2013,6,929499,58.1,865780,54.1,63719,6.9
New York,2013,6,9655330,61.8,8893914,56.9,761416,7.9
New York city,2013,6,4070290,60.4,3707583,55.0,362707,8.9
North Carolina,2013,6,4700202,61.9,4331352,57.1,368850,7.8
North Dakota,2013,6,402024,72.0,390402,69.9,11622,2.9
Ohio,2013,6,5717334,63.1,5285529,58.4,431805,7.6
Oklahoma,2013,6,1802864,61.7,1710192,58.6,92672,5.1
Oregon,2013,6,1923051,61.6,1773458,56.8,149593,7.8
Pennsylvania,2013,6,6429380,63.2,5971295,58.7,458085,7.1
Rhode Island,2013,6,558786,65.7,505369,59.4,53417,9.6
South Carolina,2013,6,2200680,59.5,2034640,55.0,166040,7.5
South Dakota,2013,6,447878,70.1,431179,67.5,16699,3.7
Tennessee,2013,6,3085954,61.0,2843190,56.2,242764,7.9
Texas,2013,6,12837490,65.3,12018765,61.1,818725,6.4
Utah,2013,6,1386526,67.3,1327663,64.4,58863,4.2
Vermont,2013,6,350425,68.3,334728,65.3,15697,4.5
Virginia,2013,6,4240224,66.5,4002240,62.7,237984,5.6
Washington,2013,6,3460427,63.7,3228621,59.4,231806,6.7
West Virginia,2013,6,799704,53.8,747163,50.2,52541,6.6
Wisconsin,2013,6,3083584,68.5,2876730,63.9,206854,6.7
Wyoming,2013,6,302234,67.4,288123,64.2,14111,4.7
Alabama,2013,7,2174320,57.7,2016720,53.5,157600,7.2
Alaska,2013,7,363803,67.5,338308,62.8,25495,7.0
Arizona,2013,7,3067255,60.3,2827358,55.6,239897,7.8
Arkansas,2013,7,1332281,58.5,1237390,54.3,94891,7.1
California,2013,7,18593103,62.7,16919448,57.1,1673655,9.0
Los Angeles County,2013,7,4972582,63.1,4485974,56.9,486608,9.8
Colorado,2013,7,2769662,68.1,2581932,63.5,187730,6.8
Connecticut,2013,7,1870801,65.5,1721124,60.2,149677,8.0
Delaware,2013,7,442935,60.9,413831,56.9,29104,6.6
District of Columbia,2013,7,373956,69.3,342280,63.4,31676,8.5
Florida,2013,7,9427528,60.1,8722512,55.6,705016,7.5
Georgia,2013,7,4753872,62.9,4367542,57.8,386330,8.1
Hawaii,2013,7,650974,60.6,620569,57.8,30405,4.7
Idaho,2013,7,779087,64.4,725099,60.0,53988,6.9
Illinois,2013,7,6562584,65.4,5961642,59.4,600942,9.2
Indiana,2013,7,3196530,63.1,2956324,58.4,240206,7.5
Iowa,2013,7,1683993,70.0,1604608,66.7,79385,4.7
Kansas,2013,7,1490847,68.3,1411224,64.6,79623,5.3
Kentucky,2013,7,2060497,60.4,1894998,55.5,165499,8.0
Louisiana,2013,7,2103958,59.7,1967784,55.8,136174,6.5
Maine,2013,7,705989,65.1,658878,60.7,47111,6.7
Maryland,2013,7,3132042,67.5,2927100,63.1,204942,6.5
Massachusetts,2013,7,3521770,65.1,3285397,60.7,236373,6.7
Michigan,2013,7,4749853,60.7,4332010,55.3,417843,8.8
Minnesota,2013,7,2959245,70.1,2810761,66.6,148484,5.0
Mississippi,2013,7,1268048,56.0,1160302,51.2,107746,8.5
Missouri,2013,7,3015876,64.3,2810658,59.9,205218,6.8
Montana,2013,7,511458,64.0,483921,60.5,27537,5.4
Nebraska,2013,7,1015997,71.5,978454,68.9,37543,3.7
Nevada,2013,7,1372712,63.7,1236337,57.4,136375,9.9
New Hampshire,2013,7,744128,69.2,705399,65.6,38729,5.2
New Jersey,2013,7,4528808,64.9,4147947,59.5,380861,8.4
New Mexico,2013,7,929444,58.0,865549,54.0,63895,6.9
New York,2013,7,9660293,61.8,8902869,56.9,757424,7.8
New York city,2013,7,4078252,60.5,3714662,55.1,363590,8.9
North Carolina,2013,7,4691444,61.7,4338744,57.1,352700,7.5
North Dakota,2013,7,402383,71.9,390809,69.8,11574,2.9
Ohio,2013,7,5718793,63.1,5285992,58.3,432801,7.6
Oklahoma,2013,7,1803164,61.7,1710369,58.5,92795,5.1
Oregon,2013,7,1922652,61.5,1775086,56.8,147566,7.7
Pennsylvania,2013,7,6424767,63.1,5969474,58.6,455293,7.1
Rhode Island,2013,7,558732,65.7,505219,59.4,53513,9.6
South Carolina,2013,7,2201018,59.4,2038451,55.0,162567,7.4
South Dakota,2013,7,447845,70.1,431221,67.5,16624,3.7
Tennessee,2013,7,3080892,60.8,2840265,56.1,240627,7.8
Texas,2013,7,12855277,65.3,12041788,61.1,813489,6.3
Utah,2013,7,1389933,67.3,1331380,64.5,58553,4.2
Vermont,2013,7,350240,68.3,334676,65.3,15564,4.4
Virginia,2013,7,4243322,66.5,4005011,62.7,238311,5.6
Washington,2013,7,3464183,63.7,3232372,59.4,231811,6.7
West Virginia,2013,7,799498,53.8,746886,50.2,52612,6.6
Wisconsin,2013,7,3083217,68.4,2878077,63.9,205140,6.7
Wyoming,2013,7,302271,67.3,288226,64.2,14045,4.6
Alabama,2013,8,2172637,57.7,2015204,53.5,157433,7.2
Alaska,2013,8,363845,67.5,338340,62.8,25505,7.0
Arizona,2013,8,3069196,60.2,2831079,55.6,238117,7.8
Arkansas,2013,8,1330709,58.4,1236614,54.3,94095,7.1
California,2013,8,18587188,62.7,16930930,57.1,1656258,8.9
Los Angeles County,2013,8,4972668,63.1,4491390,57.0,481278,9.7
Colorado,2013,8,2769322,68.0,2584166,63.4,185156,6.7
Connecticut,2013,8,1871349,65.5,1723188,60.3,148161,7.9
Delaware,2013,8,443283,60.8,414660,56.9,28623,6.5
District of Columbia,2013,8,373632,69.1,342129,63.3,31503,8.4
Florida,2013,8,9432470,60.1,8735091,55.6,697379,7.4
Georgia,2013,8,4747684,62.7,4366691,57.7,380993,8.0
Hawaii,2013,8,652138,60.6,621567,57.8,30571,4.7
Idaho,2013,8,780447,64.5,726569,60.0,53878,6.9
Illinois,2013,8,6556695,65.4,5960397,59.4,596298,9.1
Indiana,2013,8,3201733,63.2,2966614,58.5,235119,7.3
Iowa,2013,8,1686408,70.1,1607835,66.8,78573,4.7
Kansas,2013,8,1489665,68.2,1411057,64.6,78608,5.3
Kentucky,2013,8,2056498,60.2,1892207,55.4,164291,8.0
Louisiana,2013,8,2103449,59.6,1969745,55.8,133704,6.4
Maine,2013,8,705978,65.0,659479,60.8,46499,6.6
Maryland,2013,8,3128842,67.4,2925935,63.0,202907,6.5
Massachusetts,2013,8,3520422,65.0,3285726,60.7,234696,6.7
Michigan,2013,8,4750495,60.7,4334709,55.4,415786,8.8
Minnesota,2013,8,2959719,70.1,2812839,66.6,146880,5.0
Mississippi,2013,8,1254811,55.4,1148171,50.7,106640,8.5
Missouri,2013,8,3013797,64.2,2810184,59.9,203613,6.8
Montana,2013,8,511695,63.9,484345,60.5,27350,5.3
Nebraska,2013,8,1014398,71.3,977305,68.7,37093,3.7
Nevada,2013,8,1372608,63.6,1238307,57.4,134301,9.8
New Hampshire,2013,8,743974,69.1,705430,65.6,38544,5.2
New Jersey,2013,8,4517350,64.7,4144838,59.4,372512,8.2
New Mexico,2013,8,929189,58.0,865146,54.0,64043,6.9
New York,2013,8,9655577,61.7,8906160,56.9,749417,7.8
New York city,2013,8,4081804,60.5,3719839,55.2,361965,8.9
North Carolina,2013,8,4688961,61.6,4346556,57.1,342405,7.3
North Dakota,2013,8,402531,71.8,391018,69.7,11513,2.9
Ohio,2013,8,5716629,63.1,5284908,58.3,431721,7.6
Oklahoma,2013,8,1802134,61.6,1709443,58.5,92691,5.1
Oregon,2013,8,1921985,61.4,1776755,56.8,145230,7.6
Pennsylvania,2013,8,6416123,63.0,5964676,58.6,451447,7.0
Rhode Island,2013,8,558488,65.6,505098,59.3,53390,9.6
South Carolina,2013,8,2200075,59.3,2041415,55.0,158660,7.2
South Dakota,2013,8,447657,70.0,431138,67.4,16519,3.7
Tennessee,2013,8,3074336,60.6,2836800,56.0,237536,7.7
Texas,2013,8,12867238,65.2,12061310,61.1,805928,6.3
Utah,2013,8,1392500,67.3,1334511,64.5,57989,4.2
Vermont,2013,8,349953,68.2,334580,65.2,15373,4.4
Virginia,2013,8,4244602,66.4,4007012,62.7,237590,5.6
Washington,2013,8,3466584,63.6,3235962,59.4,230622,6.7
West Virginia,2013,8,798902,53.7,746160,50.2,52742,6.6
Wisconsin,2013,8,3080977,68.3,2877730,63.8,203247,6.6
Wyoming,2013,8,302231,67.3,288200,64.2,14031,4.6
Alabama,2013,9,2169847,57.6,2013022,53.4,156825,7.2
Alaska,2013,9,363710,67.5,338320,62.7,25390,7.0
Arizona,2013,9,3069703,60.2,2834283,55.5,235420,7.7
Arkansas,2013,9,1328616,58.3,1235898,54.2,92718,7.0
California,2013,9,18570217,62.5,16939401,57.0,1630816,8.8
Los Angeles County,2013,9,4967133,62.9,4494004,56.9,473129,9.5
Colorado,2013,9,2767570,67.8,2586419,63.4,181151,6.5
Connecticut,2013,9,1870764,65.4,1724994,60.3,145770,7.8
Delaware,2013,9,443676,60.8,415572,57.0,28104,6.3
District of Columbia,2013,9,373434,69.0,342277,63.2,31157,8.3
Florida,2013,9,9433614,60.0,8746255,55.6,687359,7.3
Georgia,2013,9,4739785,62.6,4365522,57.6,374263,7.9
Hawaii,2013,9,653325,60.7,622633,57.9,30692,4.7
Idaho,2013,9,781625,64.5,728067,60.1,53558,6.9
Illinois,2013,9,6547345,65.2,5959101,59.4,588244,9.0
Indiana,2013,9,3204516,63.2,2976182,58.7,228334,7.1
Iowa,2013,9,1686554,70.0,1609044,66.8,77510,4.6
Kansas,2013,9,1488146,68.1,1411091,64.6,77055,5.2
Kentucky,2013,9,2050680,60.0,1888658,55.3,162022,7.9
Louisiana,2013,9,2102001,59.5,1971714,55.8,130287,6.2
Maine,2013,9,705310,65.0,659610,60.7,45700,6.5
Maryland,2013,9,3124472,67.2,2924492,62.9,199980,6.4
Massachusetts,2013,9,3517704,64.9,3286121,60.6,231583,6.6
Michigan,2013,9,4747499,60.6,4336984,55.4,410515,8.6
Minnesota,2013,9,2960319,70.0,2815492,66.6,144827,4.9
Mississippi,2013,9,1252815,55.3,1147763,50.6,105052,8.4
Missouri,2013,9,3011160,64.1,2809780,59.8,201380,6.7
Montana,2013,9,511880,63.9,484863,60.5,27017,5.3
Nebraska,2013,9,1012637,71.2,976235,68.6,36402,3.6
Nevada,2013,9,1371772,63.5,1240084,57.4,131688,9.6
New Hampshire,2013,9,743413,69.0,705246,65.5,38167,5.1
New Jersey,2013,9,4503664,64.5,4141572,59.3,362092,8.0
New Mexico,2013,9,928819,58.0,864817,54.0,64002,6.9
New York,2013,9,9640261,61.6,8905146,56.9,735115,7.6
New York city,2013,9,4081018,60.5,3724442,55.2,356576,8.7
North Carolina,2013,9,4667427,61.3,4354108,57.2,313319,6.7
North Dakota,2013,9,402511,71.7,391090,69.6,11421,2.8
Ohio,2013,9,5711245,63.0,5284794,58.3,426451,7.5
Oklahoma,2013,9,1800109,61.5,1707972,58.4,92137,5.1
Oregon,2013,9,1921524,61.3,1778975,56.8,142549,7.4
Pennsylvania,2013,9,6404340,62.9,5959318,58.5,445022,6.9
Rhode Island,2013,9,557966,65.5,505026,59.3,52940,9.5
South Carolina,2013,9,2197737,59.2,2043945,55.0,153792,7.0
South Dakota,2013,9,447422,69.9,431095,67.4,16327,3.6
Tennessee,2013,9,3066803,60.4,2833931,55.9,232872,7.6
Texas,2013,9,12873858,65.1,12079341,61.1,794517,6.2
Utah,2013,9,1394372,67.3,1337267,64.6,57105,4.1
Vermont,2013,9,349601,68.1,334486,65.2,15115,4.3
Virginia,2013,9,4244434,66.4,4009047,62.7,235387,5.5
Washington,2013,9,3467375,63.6,3239639,59.4,227736,6.6
West Virginia,2013,9,797953,53.7,745123,50.1,52830,6.6
Wisconsin,2013,9,3077408,68.2,2877039,63.8,200369,6.5
Wyoming,2013,9,302130,67.2,288119,64.1,14011,4.6
Alabama,2013,10,2167230,57.5,2011093,53.3,156137,7.2
Alaska,2013,10,363558,67.4,338279,62.7,25279,7.0
Arizona,2013,10,3070375,60.1,2837884,55.5,232491,7.6
Arkansas,2013,10,1326715,58.2,1235660,54.2,91055,6.9
California,2013,10,18553825,62.4,16951113,57.0,1602712,8.6
Los Angeles County,2013,10,4959561,62.8,4495706,56.9,463855,9.4
Colorado,2013,10,2766264,67.7,2589867,63.4,176397,6.4
Connecticut,2013,10,1870128,65.4,1727081,60.4,143047,7.6
Delaware,2013,10,444215,60.8,416563,57.0,27652,6.2
District of Columbia,2013,10,373515,68.9,342762,63.3,30753,8.2
Florida,2013,10,9436839,59.9,8759566,55.6,677273,7.2
Georgia,2013,10,4733883,62.4,4366214,57.6,367669,7.8
Hawaii,2013,10,654646,60.8,623909,58.0,30737,4.7
Idaho,2013,10,782755,64.5,729577,60.1,53178,6.8
Illinois,2013,10,6539322,65.2,5960606,59.4,578716,8.8
Indiana,2013,10,3205501,63.2,2984597,58.8,220904,6.9
Iowa,2013,10,1685404,69.9,1608832,66.8,76572,4.5
Kansas,2013,10,1487170,68.0,1411799,64.6,75371,5.1
Kentucky,2013,10,2044372,59.8,1884947,55.2,159425,7.8
Louisiana,2013,10,2100686,59.5,1974140,55.9,126546,6.0
Maine,2013,10,704366,64.8,659476,60.7,44890,6.4
Maryland,2013,10,3120510,67.1,2923641,62.9,196869,6.3
Massachusetts,2013,10,3516257,64.8,3288254,60.6,228003,6.5
Michigan,2013,10,4744156,60.5,4340565,55.4,403591,8.5
Minnesota,2013,10,2961292,70.0,2818328,66.6,142964,4.8
Mississippi,2013,10,1250602,55.2,1147147,50.6,103455,8.3
Missouri,2013,10,3010507,64.1,2810589,59.8,199918,6.6
Montana,2013,10,512116,63.9,485480,60.5,26636,5.2
Nebraska,2013,10,1011485,71.0,975674,68.5,35811,3.5
Nevada,2013,10,1371166,63.3,1242032,57.4,129134,9.4
New Hampshire,2013,10,742734,68.9,705115,65.4,37619,5.1
New Jersey,2013,10,4490616,64.3,4139153,59.3,351463,7.8
New Mexico,2013,10,928678,57.9,864770,54.0,63908,6.9
New York,2013,10,9620358,61.4,8902906,56.9,717452,7.5
New York city,2013,10,4079036,60.4,3730124,55.3,348912,8.6
North Carolina,2013,10,4668675,61.2,4360357,57.2,308318,6.6
North Dakota,2013,10,402486,71.5,391157,69.5,11329,2.8
Ohio,2013,10,5705087,62.9,5287632,58.3,417455,7.3
Oklahoma,2013,10,1798068,61.4,1706719,58.3,91349,5.1
Oregon,2013,10,1922159,61.3,1781810,56.8,140349,7.3
Pennsylvania,2013,10,6393597,62.7,5956291,58.5,437306,6.8
Rhode Island,2013,10,557392,65.4,505095,59.3,52297,9.4
South Carolina,2013,10,2195205,59.0,2046797,55.0,148408,6.8
South Dakota,2013,10,447347,69.8,431256,67.3,16091,3.6
Tennessee,2013,10,3059810,60.3,2832394,55.8,227416,7.4
Texas,2013,10,12880739,65.1,12099121,61.1,781618,6.1
Utah,2013,10,1396158,67.3,1339974,64.6,56184,4.0
Vermont,2013,10,349300,68.1,334450,65.2,14850,4.3
Virginia,2013,10,4244667,66.3,4011855,62.7,232812,5.5
Washington,2013,10,3467791,63.5,3243553,59.4,224238,6.5
West Virginia,2013,10,797136,53.6,744107,50.0,53029,6.7
Wisconsin,2013,10,3073994,68.1,2877113,63.8,196881,6.4
Wyoming,2013,10,302077,67.2,288075,64.1,14002,4.6
Alabama,2013,11,2165715,57.4,2010028,53.3,155687,7.2
Alaska,2013,11,363547,67.4,338306,62.7,25241,6.9
Arizona,2013,11,3072551,60.0,2843115,55.5,229436,7.5
Arkansas,2013,11,1325461,58.1,1236175,54.2,89286,6.7
California,2013,11,18547876,62.3,16971722,57.0,1576154,8.5
Los Angeles County,2013,11,4954109,62.7,4499214,56.9,454895,9.2
Colorado,2013,11,2767651,67.6,2595558,63.4,172093,6.2
Connecticut,2013,11,1870266,65.4,1729880,60.5,140386,7.5
Delaware,2013,11,444909,60.8,417594,57.1,27315,6.1
District of Columbia,2013,11,373797,68.9,343424,63.3,30373,8.1
Florida,2013,11,9446215,59.9,8777668,55.7,668547,7.1
Georgia,2013,11,4732267,62.3,4370024,57.6,362243,7.7
Hawaii,2013,11,656212,61.0,625532,58.1,30680,4.7
Idaho,2013,11,781042,64.3,731179,60.2,49863,6.4
Illinois,2013,11,6536335,65.1,5967239,59.4,569096,8.7
Indiana,2013,11,3206192,63.2,2992216,58.9,213976,6.7
Iowa,2013,11,1684452,69.9,1608558,66.7,75894,4.5
Kansas,2013,11,1487212,68.0,1413405,64.6,73807,5.0
Kentucky,2013,11,2038670,59.6,1881766,55.0,156904,7.7
Louisiana,2013,11,2100476,59.4,1977442,56.0,123034,5.9
Maine,2013,11,703474,64.7,659283,60.7,44191,6.3
Maryland,2013,11,3118057,67.0,2924041,62.8,194016,6.2
Massachusetts,2013,11,3517745,64.8,3293116,60.7,224629,6.4
Michigan,2013,11,4743413,60.5,4346689,55.4,396724,8.4
Minnesota,2013,11,2962764,70.0,2821182,66.7,141582,4.8
Mississippi,2013,11,1248764,55.1,1146573,50.6,102191,8.2
Missouri,2013,11,3012981,64.1,2813239,59.9,199742,6.6
Montana,2013,11,512380,63.9,486132,60.6,26248,5.1
Nebraska,2013,11,1011351,71.0,975833,68.5,35518,3.5
Nevada,2013,11,1371342,63.2,1244462,57.4,126880,9.3
New Hampshire,2013,11,742214,68.8,705282,65.4,36932,5.0
New Jersey,2013,11,4480939,64.2,4139036,59.3,341903,7.6
New Mexico,2013,11,928846,57.9,865040,54.0,63806,6.9
New York,2013,11,9601154,61.3,8901935,56.8,699219,7.3
New York city,2013,11,4078203,60.4,3737594,55.4,340609,8.4
North Carolina,2013,11,4669501,61.2,4365537,57.2,303964,6.5
North Dakota,2013,11,402613,71.5,391386,69.5,11227,2.8
Ohio,2013,11,5700211,62.8,5294623,58.3,405588,7.1
Oklahoma,2013,11,1796614,61.3,1706259,58.2,90355,5.0
Oregon,2013,11,1924468,61.3,1785385,56.9,139083,7.2
Pennsylvania,2013,11,6387329,62.7,5958121,58.5,429208,6.7
Rhode Island,2013,11,556987,65.4,505441,59.3,51546,9.3
South Carolina,2013,11,2193757,58.9,2050570,55.1,143187,6.5
South Dakota,2013,11,447564,69.8,431702,67.4,15862,3.5
Tennessee,2013,11,3054206,60.1,2832369,55.7,221837,7.3
Texas,2013,11,12892128,65.0,12124031,61.1,768097,6.0
Utah,2013,11,1398215,67.3,1342906,64.7,55309,4.0
Vermont,2013,11,349089,68.0,334466,65.2,14623,4.2
Virginia,2013,11,4246742,66.3,4016111,62.7,230631,5.4
Washington,2013,11,3468654,63.4,3247718,59.4,220936,6.4
West Virginia,2013,11,796772,53.6,743443,50.0,53329,6.7
Wisconsin,2013,11,3071951,68.0,2878978,63.8,192973,6.3
Wyoming,2013,11,302109,67.2,288157,64.1,13952,4.6
Alabama,2013,12,2165388,57.4,2009949,53.2,155439,7.2
Alaska,2013,12,363695,67.4,338449,62.7,25246,6.9
Arizona,2013,12,3076382,60.0,2850146,55.6,226236,7.4
Arkansas,2013,12,1324767,58.1,1237331,54.2,87436,6.6
California,2013,12,18554149,62.3,17001882,57.1,1552267,8.4
Los Angeles County,2013,12,4952329,62.6,4505468,57.0,446861,9.0
Colorado,2013,12,2772177,67.6,2603433,63.5,168744,6.1
Connecticut,2013,12,1871503,65.4,1733625,60.6,137878,7.4
Delaware,2013,12,445675,60.9,418596,57.2,27079,6.1
District of Columbia,2013,12,374139,68.9,344093,63.3,30046,8.0
Florida,2013,12,9461489,59.9,8800149,55.7,661340,7.0
Georgia,2013,12,4734481,62.3,4376243,57.6,358238,7.6
Hawaii,2013,12,657879,61.1,627380,58.2,30499,4.6
Idaho,2013,12,779488,64.1,732868,60.2,46620,6.0
Illinois,2013,12,6537549,65.1,5978331,59.5,559218,8.6
Indiana,2013,12,3207647,63.2,2999291,59.1,208356,6.5
Iowa,2013,12,1684792,69.8,1609386,66.7,75406,4.5
Kansas,2013,12,1488263,68.0,1415787,64.7,72476,4.9
Kentucky,2013,12,2034084,59.5,1879552,55.0,154532,7.6
Louisiana,2013,12,2101607,59.4,1981332,56.0,120275,5.7
Maine,2013,12,702632,64.6,659022,60.6,43610,6.2
Maryland,2013,12,3117158,67.0,2925695,62.9,191463,6.1
Massachusetts,2013,12,3522182,64.8,3300577,60.7,221605,6.3
Michigan,2013,12,4745607,60.5,4354920,55.5,390687,8.2
Minnesota,2013,12,2964246,70.0,2823768,66.7,140478,4.7
Mississippi,2013,12,1247492,55.0,1146243,50.5,101249,8.1
Missouri,2013,12,3017799,64.2,2817410,59.9,200389,6.6
Montana,2013,12,512516,63.8,486660,60.6,25856,5.0
Nebraska,2013,12,1012031,71.0,976601,68.5,35430,3.5
Nevada,2013,12,1372217,63.2,1247354,57.4,124863,9.1
New Hampshire,2013,12,741895,68.7,705727,65.4,36168,4.9
New Jersey,2013,12,4475815,64.1,4142292,59.3,333523,7.5
New Mexico,2013,12,929082,57.9,865489,54.0,63593,6.8
New York,2013,12,9583747,61.2,8901999,56.8,681748,7.1
New York city,2013,12,4078585,60.4,3745978,55.5,332607,8.2
North Carolina,2013,12,4671157,61.2,4370197,57.2,300960,6.4
North Dakota,2013,12,402945,71.4,391849,69.4,11096,2.8
Ohio,2013,12,5696553,62.7,5304884,58.4,391669,6.9
Oklahoma,2013,12,1795533,61.2,1706508,58.2,89025,5.0
Oregon,2013,12,1928211,61.4,1789567,56.9,138644,7.2
Pennsylvania,2013,12,6386175,62.6,5964685,58.5,421490,6.6
Rhode Island,2013,12,556785,65.3,506086,59.4,50699,9.1
South Carolina,2013,12,2193803,58.8,2055149,55.1,138654,6.3
South Dakota,2013,12,448026,69.9,432363,67.4,15663,3.5
Tennessee,2013,12,3049904,60.0,2833383,55.7,216521,7.1
Texas,2013,12,12907972,65.0,12154284,61.2,753688,5.8
Utah,2013,12,1400436,67.3,1346017,64.7,54419,3.9
Vermont,2013,12,348937,68.0,334491,65.2,14446,4.1
Virginia,2013,12,4250846,66.3,4021840,62.7,229006,5.4
Washington,2013,12,3469934,63.4,3251784,59.4,218150,6.3
West Virginia,2013,12,796988,53.6,743337,50.0,53651,6.7
Wisconsin,2013,12,3071403,68.0,2882705,63.8,188698,6.1
Wyoming,2013,12,302194,67.2,288374,64.2,13820,4.6
Alabama,2014,1,2165971,57.4,2010942,53.3,155029,7.2
Alaska,2014,1,363966,67.4,338735,62.8,25231,6.9
Arizona,2014,1,3081484,60.0,2858474,55.7,223010,7.2
Arkansas,2014,1,1324443,58.0,1238994,54.3,85449,6.5
California,2014,1,18569356,62.3,17040259,57.2,1529097,8.2
Los Angeles County,2014,1,4953680,62.6,4514259,57.1,439421,8.9
Colorado,2014,1,2778644,67.7,2613030,63.6,165614,6.0
Connecticut,2014,1,1873722,65.4,1738339,60.7,135383,7.2
Delaware,2014,1,446546,60.9,419663,57.3,26883,6.0
District of Columbia,2014,1,374474,68.8,344720,63.4,29754,7.9
Florida,2014,1,9479786,59.9,8825090,55.8,654696,6.9
Georgia,2014,1,4738716,62.3,4383593,57.6,355123,7.5
Hawaii,2014,1,659402,61.2,629214,58.4,30188,4.6
Idaho,2014,1,778076,63.9,734548,60.3,43528,5.6
Illinois,2014,1,6539433,65.1,5991934,59.7,547499,8.4
Indiana,2014,1,3210348,63.2,3006208,59.2,204140,6.4
Iowa,2014,1,1686880,69.9,1611910,66.8,74970,4.4
Kansas,2014,1,1490102,68.1,1418761,64.8,71341,4.8
Kentucky,2014,1,2030616,59.4,1878659,54.9,151957,7.5
Louisiana,2014,1,2103844,59.5,1985316,56.1,118528,5.6
Maine,2014,1,701831,64.5,658792,60.6,43039,6.1
Maryland,2014,1,3117343,66.9,2928422,62.9,188921,6.1
Massachusetts,2014,1,3528825,64.9,3310181,60.9,218644,6.2
Michigan,2014,1,4749538,60.5,4364414,55.6,385124,8.1
Minnesota,2014,1,2965437,70.0,2826045,66.7,139392,4.7
Mississippi,2014,1,1246805,54.9,1146363,50.5,100442,8.1
Missouri,2014,1,3023454,64.3,2822595,60.0,200859,6.6
Montana,2014,1,512421,63.8,486983,60.6,25438,5.0
Nebraska,2014,1,1013076,71.0,977740,68.5,35336,3.5
Nevada,2014,1,1373421,63.2,1250571,57.5,122850,8.9
New Hampshire,2014,1,741760,68.7,706392,65.4,35368,4.8
New Jersey,2014,1,4474601,64.0,4148926,59.4,325675,7.3
New Mexico,2014,1,929249,57.9,866039,54.0,63210,6.8
New York,2014,1,9568507,61.1,8903251,56.8,665256,7.0
New York city,2014,1,4080570,60.4,3755435,55.6,325135,8.0
North Carolina,2014,1,4674182,61.1,4375293,57.2,298889,6.4
North Dakota,2014,1,403489,71.4,392552,69.4,10937,2.7
Ohio,2014,1,5693500,62.7,5316915,58.5,376585,6.6
Oklahoma,2014,1,1794313,61.1,1707122,58.2,87191,4.9
Oregon,2014,1,1932624,61.4,1794235,57.0,138389,7.2
Pennsylvania,2014,1,6388276,62.7,5974041,58.6,414235,6.5
Rhode Island,2014,1,556711,65.3,507010,59.5,49701,8.9
South Carolina,2014,1,2195170,58.8,2060182,55.2,134988,6.1
South Dakota,2014,1,448617,69.9,433108,67.5,15509,3.5
Tennessee,2014,1,3046560,59.9,2834891,55.7,211669,6.9
Texas,2014,1,12926206,65.0,12188294,61.2,737912,5.7
Utah,2014,1,1402644,67.4,1349185,64.8,53459,3.8
Vermont,2014,1,348806,68.0,334528,65.2,14278,4.1
Virginia,2014,1,4256299,66.3,4028612,62.8,227687,5.3
Washington,2014,1,3471141,63.3,3255449,59.4,215692,6.2
West Virginia,2014,1,797557,53.7,743740,50.0,53817,6.7
Wisconsin,2014,1,3071739,68.0,2887465,63.9,184274,6.0
Wyoming,2014,1,302308,67.3,288675,64.2,13633,4.5
Alabama,2014,2,2166876,57.4,2012653,53.3,154223,7.1
Alaska,2014,2,364333,67.5,339157,62.9,25176,6.9
Arizona,2014,2,3087246,60.0,2867319,55.8,219927,7.1
Arkansas,2014,2,1324270,58.0,1240888,54.4,83382,6.3
California,2014,2,18588369,62.3,17083487,57.3,1504882,8.1
Los Angeles County,2014,2,4957081,62.6,4524906,57.2,432175,8.7
Colorado,2014,2,2785590,67.8,2623718,63.8,161872,5.8
Connecticut,2014,2,1876435,65.5,1743577,60.9,132858,7.1
Delaware,2014,2,447591,61.0,420921,57.4,26670,6.0
District of Columbia,2014,2,374892,68.8,345390,63.4,29502,7.9
Florida,2014,2,9497821,60.0,8849988,55.9,647833,6.8
Georgia,2014,2,4743210,62.3,4390706,57.7,352504,7.4
Hawaii,2014,2,660678,61.3,630881,58.5,29797,4.5
Idaho,2014,2,776745,63.7,736121,60.4,40624,5.2
Illinois,2014,2,6539294,65.1,6006418,59.8,532876,8.1
Indiana,2014,2,3214183,63.2,3013026,59.3,201157,6.3
Iowa,2014,2,1690118,70.0,1615655,66.9,74463,4.4
Kansas,2014,2,1492219,68.1,1421820,64.9,70399,4.7
Kentucky,2014,2,2027674,59.3,1878905,54.9,148769,7.3
Louisiana,2014,2,2107066,59.5,1989022,56.2,118044,5.6
Maine,2014,2,701068,64.5,658705,60.6,42363,6.0
Maryland,2014,2,3118114,66.9,2931696,62.9,186418,6.0
Massachusetts,2014,2,3536741,65.0,3321159,61.0,215582,6.1
Michigan,2014,2,4754121,60.6,4374624,55.7,379497,8.0
Minnesota,2014,2,2966801,70.0,2828846,66.7,137955,4.6
Mississippi,2014,2,1246453,54.9,1146767,50.5,99686,8.0
Missouri,2014,2,3028252,64.4,2827952,60.1,200300,6.6
Montana,2014,2,512169,63.7,487185,60.6,24984,4.9
Nebraska,2014,2,1013940,71.0,978832,68.6,35108,3.5
Nevada,2014,2,1374578,63.1,1253863,57.6,120715,8.8
New Hampshire,2014,2,741867,68.7,707296,65.5,34571,4.7
New Jersey,2014,2,4475891,64.1,4157794,59.5,318097,7.1
New Mexico,2014,2,929329,58.0,866611,54.0,62718,6.7
New York,2014,2,9555038,61.0,8905204,56.8,649834,6.8
New York city,2014,2,4083624,60.4,3765329,55.7,318295,7.8
North Carolina,2014,2,4678328,61.1,4381465,57.3,296863,6.3
North Dakota,2014,2,404290,71.4,393523,69.5,10767,2.7
Ohio,2014,2,5691029,62.7,5328838,58.7,362191,6.4
Oklahoma,2014,2,1792880,61.1,1707926,58.2,84954,4.7
Oregon,2014,2,1936905,61.5,1799250,57.1,137655,7.1
Pennsylvania,2014,2,6390970,62.7,5983678,58.7,407292,6.4
Rhode Island,2014,2,556646,65.3,508127,59.6,48519,8.7
South Carolina,2014,2,2197611,58.8,2065174,55.3,132437,6.0
South Dakota,2014,2,449189,70.0,433800,67.6,15389,3.4
Tennessee,2014,2,3043669,59.8,2835964,55.7,207705,6.8
Texas,2014,2,12944743,64.9,12223189,61.3,721554,5.6
Utah,2014,2,1404680,67.4,1352211,64.8,52469,3.7
Vermont,2014,2,348678,67.9,334573,65.2,14105,4.0
Virginia,2014,2,4261740,66.4,4035391,62.9,226349,5.3
Washington,2014,2,3471891,63.2,3258702,59.4,213189,6.1
West Virginia,2014,2,797946,53.7,744294,50.1,53652,6.7
Wisconsin,2014,2,3072006,68.0,2892285,64.0,179721,5.9
Wyoming,2014,2,302412,67.3,288990,64.3,13422,4.4
Alabama,2014,3,2167429,57.4,2014263,53.3,153166,7.1
Alaska,2014,3,364723,67.6,339585,62.9,25138,6.9
Arizona,2014,3,3093246,60.1,2875911,55.8,217335,7.0
Arkansas,2014,3,1324213,58.0,1242674,54.4,81539,6.2
California,2014,3,18608224,62.3,17126546,57.4,1481678,8.0
Los Angeles County,2014,3,4962042,62.6,4536217,57.3,425825,8.6
Colorado,2014,3,2791859,67.8,2634418,64.0,157441,5.6
Connecticut,2014,3,1879255,65.6,1748668,61.0,130587,6.9
Delaware,2014,3,448826,61.1,422367,57.5,26459,5.9
District of Columbia,2014,3,375490,68.9,346115,63.5,29375,7.8
Florida,2014,3,9513557,60.0,8872130,55.9,641427,6.7
Georgia,2014,3,4746928,62.3,4396047,57.7,350881,7.4
Hawaii,2014,3,661775,61.4,632329,58.6,29446,4.4
Idaho,2014,3,775559,63.5,737567,60.4,37992,4.9
Illinois,2014,3,6535796,65.1,6019511,59.9,516285,7.9
Indiana,2014,3,3218859,63.3,3019531,59.4,199328,6.2
Iowa,2014,3,1693311,70.1,1619332,67.0,73979,4.4
Kansas,2014,3,1494043,68.2,1424398,65.0,69645,4.7
Kentucky,2014,3,2024499,59.1,1879447,54.9,145052,7.2
Louisiana,2014,3,2111847,59.7,1992426,56.3,119421,5.7
Maine,2014,3,700376,64.4,658761,60.5,41615,5.9
Maryland,2014,3,3119340,66.9,2934794,63.0,184546,5.9
Massachusetts,2014,3,3544719,65.1,3331902,61.2,212817,6.0
Michigan,2014,3,4758378,60.6,4384836,55.9,373542,7.9
Minnesota,2014,3,2969112,70.0,2833095,66.8,136017,4.6
Mississippi,2014,3,1246033,54.9,1147012,50.5,99021,7.9
Missouri,2014,3,3030991,64.4,2832619,60.2,198372,6.5
Montana,2014,3,511966,63.6,487393,60.6,24573,4.8
Nebraska,2014,3,1014248,71.0,979472,68.6,34776,3.4
Nevada,2014,3,1375605,63.1,1256934,57.7,118671,8.6
New Hampshire,2014,3,742090,68.6,708203,65.5,33887,4.6
New Jersey,2014,3,4478887,64.1,4167358,59.6,311529,7.0
New Mexico,2014,3,929411,58.0,867098,54.1,62313,6.7
New York,2014,3,9543233,60.9,8906972,56.8,636261,6.7
New York city,2014,3,4086615,60.4,3774372,55.8,312243,7.6
North Carolina,2014,3,4683224,61.1,4388272,57.3,294952,6.3
North Dakota,2014,3,405352,71.5,394726,69.6,10626,2.6
Ohio,2014,3,5690228,62.6,5339396,58.8,350832,6.2
Oklahoma,2014,3,1791504,61.0,1708779,58.2,82725,4.6
Oregon,2014,3,1940643,61.6,1804298,57.3,136345,7.0
Pennsylvania,2014,3,6392273,62.7,5991065,58.7,401208,6.3
Rhode Island,2014,3,556615,65.3,509375,59.7,47240,8.5
South Carolina,2014,3,2201104,58.8,2069541,55.3,131563,6.0
South Dakota,2014,3,449621,70.0,434322,67.6,15299,3.4
Tennessee,2014,3,3041048,59.7,2835726,55.7,205322,6.8
Texas,2014,3,12962485,64.9,12254958,61.4,707527,5.5
Utah,2014,3,1406514,67.4,1354871,64.9,51643,3.7
Vermont,2014,3,348585,67.9,334605,65.2,13980,4.0
Virginia,2014,3,4265948,66.4,4040682,62.9,225266,5.3
Washington,2014,3,3472850,63.2,3261947,59.4,210903,6.1
West Virginia,2014,3,797830,53.7,744590,50.1,53240,6.7
Wisconsin,2014,3,3072114,68.0,2896598,64.1,175516,5.7
Wyoming,2014,3,302506,67.3,289248,64.4,13258,4.4
Alabama,2014,4,2166887,57.3,2015052,53.3,151835,7.0
Alaska,2014,4,364982,67.6,339829,62.9,25153,6.9
Arizona,2014,4,3098896,60.1,2883663,55.9,215233,6.9
Arkansas,2014,4,1324212,58.0,1244129,54.5,80083,6.0
California,2014,4,18624963,62.3,17164661,57.4,1460302,7.8
Los Angeles County,2014,4,4967532,62.7,4546936,57.4,420596,8.5
Colorado,2014,4,2796320,67.8,2644060,64.1,152260,5.4
Connecticut,2014,4,1882025,65.7,1753324,61.2,128701,6.8
Delaware,2014,4,450102,61.2,423844,57.7,26258,5.8
District of Columbia,2014,4,376260,68.9,346875,63.5,29385,7.8
Florida,2014,4,9525298,60.0,8890013,56.0,635285,6.7
Georgia,2014,4,4748750,62.2,4398631,57.6,350119,7.4
Hawaii,2014,4,662692,61.4,633518,58.7,29174,4.4
Idaho,2014,4,774476,63.4,738865,60.4,35611,4.6
Illinois,2014,4,6528094,65.0,6029065,60.0,499029,7.6
Indiana,2014,4,3222985,63.4,3024974,59.5,198011,6.1
Iowa,2014,4,1695751,70.2,1622168,67.1,73583,4.3
Kansas,2014,4,1495057,68.2,1426026,65.1,69031,4.6
Kentucky,2014,4,2020074,59.0,1879242,54.9,140832,7.0
Louisiana,2014,4,2118328,59.8,1995649,56.3,122679,5.8
Maine,2014,4,699680,64.3,658856,60.5,40824,5.8
Maryland,2014,4,3120501,66.9,2937114,63.0,183387,5.9
Massachusetts,2014,4,3551300,65.2,3340784,61.3,210516,5.9
Michigan,2014,4,4760730,60.6,4393862,56.0,366868,7.7
Minnesota,2014,4,2971996,70.0,2838498,66.9,133498,4.5
Mississippi,2014,4,1245010,54.8,1146757,50.5,98253,7.9
Missouri,2014,4,3031462,64.4,2836109,60.2,195353,6.4
Montana,2014,4,511934,63.6,487669,60.6,24265,4.7
Nebraska,2014,4,1013835,71.0,979454,68.5,34381,3.4
Nevada,2014,4,1376354,63.0,1259583,57.7,116771,8.5
New Hampshire,2014,4,742196,68.6,708849,65.5,33347,4.5
New Jersey,2014,4,4482331,64.1,4175971,59.7,306360,6.8
New Mexico,2014,4,929509,58.0,867421,54.1,62088,6.7
New York,2014,4,9531922,60.8,8907932,56.8,623990,6.5
New York city,2014,4,4088313,60.4,3782023,55.9,306290,7.5
North Carolina,2014,4,4687746,61.1,4394339,57.3,293407,6.3
North Dakota,2014,4,406510,71.6,395968,69.7,10542,2.6
Ohio,2014,4,5691744,62.6,5348627,58.9,343117,6.0
Oklahoma,2014,4,1790356,60.9,1709600,58.2,80756,4.5
Oregon,2014,4,1943538,61.6,1808969,57.3,134569,6.9
Pennsylvania,2014,4,6390305,62.7,5994857,58.8,395448,6.2
Rhode Island,2014,4,556609,65.3,510641,59.9,45968,8.3
South Carolina,2014,4,2205386,58.9,2072892,55.3,132494,6.0
South Dakota,2014,4,449846,70.0,434622,67.6,15224,3.4
Tennessee,2014,4,3038521,59.6,2834046,55.6,204475,6.7
Texas,2014,4,12977478,64.9,12280595,61.4,696883,5.4
Utah,2014,4,1408112,67.3,1357035,64.9,51077,3.6
Vermont,2014,4,348513,67.9,334580,65.2,13933,4.0
Virginia,2014,4,4267774,66.4,4043315,62.9,224459,5.3
Washington,2014,4,3474684,63.1,3265637,59.3,209047,6.0
West Virginia,2014,4,797081,53.7,744377,50.1,52704,6.6
Wisconsin,2014,4,3072178,67.9,2900257,64.1,171921,5.6
Wyoming,2014,4,302590,67.3,289389,64.4,13201,4.4
Alabama,2014,5,2165427,57.3,2015410,53.3,150017,6.9
Alaska,2014,5,365047,67.6,339891,62.9,25156,6.9
Arizona,2014,5,3104438,60.1,2891087,56.0,213351,6.9
Arkansas,2014,5,1324336,58.0,1245446,54.5,78890,6.0
California,2014,5,18638929,62.3,17200175,57.5,1438754,7.7
Los Angeles County,2014,5,4973152,62.7,4557395,57.5,415757,8.4
Colorado,2014,5,2799033,67.8,2652822,64.2,146211,5.2
Connecticut,2014,5,1884757,65.8,1757743,61.3,127014,6.7
Delaware,2014,5,451305,61.3,425282,57.8,26023,5.8
District of Columbia,2014,5,377323,69.0,347911,63.7,29412,7.8
Florida,2014,5,9534040,59.9,8905898,56.0,628142,6.6
Georgia,2014,5,4748727,62.2,4399795,57.6,348932,7.3
Hawaii,2014,5,663424,61.5,634545,58.8,28879,4.4
Idaho,2014,5,774878,63.3,740193,60.5,34685,4.5
Illinois,2014,5,6518261,64.9,6036226,60.1,482035,7.4
Indiana,2014,5,3226182,63.4,3030027,59.5,196155,6.1
Iowa,2014,5,1697727,70.2,1624533,67.2,73194,4.3
Kansas,2014,5,1495273,68.2,1426868,65.1,68405,4.6
Kentucky,2014,5,2014317,58.8,1878442,54.8,135875,6.7
Louisiana,2014,5,2126535,60.0,1999443,56.4,127092,6.0
Maine,2014,5,698898,64.2,658932,60.5,39966,5.7
Maryland,2014,5,3121400,66.9,2939236,63.0,182164,5.8
Massachusetts,2014,5,3556705,65.2,3348340,61.4,208365,5.9
Michigan,2014,5,4760984,60.6,4402006,56.0,358978,7.5
Minnesota,2014,5,2975113,70.0,2844737,67.0,130376,4.4
Mississippi,2014,5,1243633,54.8,1146391,50.5,97242,7.8
Missouri,2014,5,3030820,64.4,2839226,60.3,191594,6.3
Montana,2014,5,512134,63.6,488112,60.6,24022,4.7
Nebraska,2014,5,1012989,70.8,979097,68.5,33892,3.3
Nevada,2014,5,1376943,63.0,1262099,57.7,114844,8.3
New Hampshire,2014,5,742270,68.6,709446,65.5,32824,4.4
New Jersey,2014,5,4486012,64.2,4183785,59.8,302227,6.7
New Mexico,2014,5,929764,58.0,867859,54.1,61905,6.7
New York,2014,5,9521136,60.7,8909964,56.8,611172,6.4
New York city,2014,5,4088604,60.4,3789417,56.0,299187,7.3
North Carolina,2014,5,4691864,61.1,4399972,57.3,291892,6.2
North Dakota,2014,5,407697,71.7,397170,69.8,10527,2.6
Ohio,2014,5,5696376,62.7,5358794,58.9,337582,5.9
Oklahoma,2014,5,1790090,60.9,1711113,58.2,78977,4.4
Oregon,2014,5,1945984,61.6,1813583,57.4,132401,6.8
Pennsylvania,2014,5,6385963,62.6,5997076,58.8,388887,6.1
Rhode Island,2014,5,556598,65.2,511878,60.0,44720,8.0
South Carolina,2014,5,2210478,58.9,2075727,55.3,134751,6.1
South Dakota,2014,5,449972,70.0,434863,67.6,15109,3.4
Tennessee,2014,5,3036563,59.5,2832484,55.5,204079,6.7
Texas,2014,5,12990622,64.9,12302615,61.4,688007,5.3
Utah,2014,5,1409831,67.3,1359074,64.9,50757,3.6
Vermont,2014,5,348496,67.9,334560,65.2,13936,4.0
Virginia,2014,5,4267161,66.3,4043979,62.9,223182,5.2
Washington,2014,5,3478313,63.1,3270893,59.4,207420,6.0
West Virginia,2014,5,795967,53.6,743871,50.1,52096,6.5
Wisconsin,2014,5,3072776,67.9,2904115,64.2,168661,5.5
Wyoming,2014,5,302688,67.4,289475,64.4,13213,4.4
Alabama,2014,6,2164102,57.2,2016249,53.3,147853,6.8
Alaska,2014,6,364977,67.6,339893,62.9,25084,6.9
Arizona,2014,6,3110915,60.1,2899220,56.1,211695,6.8
Arkansas,2014,6,1324928,58.0,1247064,54.6,77864,5.9
California,2014,6,18656005,62.3,17238675,57.6,1417330,7.6
Los Angeles County,2014,6,4979468,62.7,4568321,57.6,411147,8.3
Colorado,2014,6,2800957,67.7,2661226,64.3,139731,5.0
Connecticut,2014,6,1887936,65.8,1762463,61.5,125473,6.6
Delaware,2014,6,452472,61.4,426731,57.9,25741,5.7
District of Columbia,2014,6,378844,69.2,349461,63.9,29383,7.8
Florida,2014,6,9543064,59.9,8923099,56.0,619965,6.5
Georgia,2014,6,4748412,62.1,4401903,57.6,346509,7.3
Hawaii,2014,6,664120,61.5,635619,58.9,28501,4.3
Idaho,2014,6,772518,63.0,741711,60.5,30807,4.0
Illinois,2014,6,6510457,64.8,6043882,60.1,466575,7.2
Indiana,2014,6,3228715,63.4,3035235,59.6,193480,6.0
Iowa,2014,6,1699665,70.3,1626906,67.2,72759,4.3
Kansas,2014,6,1495152,68.2,1427461,65.1,67691,4.5
Kentucky,2014,6,2008207,58.6,1877753,54.8,130454,6.5
Louisiana,2014,6,2136367,60.3,2004372,56.5,131995,6.2
Maine,2014,6,698129,64.1,659052,60.5,39077,5.6
Maryland,2014,6,3122644,66.9,2942245,63.0,180399,5.8
Massachusetts,2014,6,3562788,65.3,3356523,61.5,206265,5.8
Michigan,2014,6,4760581,60.6,4410586,56.1,349995,7.4
Minnesota,2014,6,2978678,70.1,2851608,67.1,127070,4.3
Mississippi,2014,6,1242518,54.7,1146590,50.5,95928,7.7
Missouri,2014,6,3030914,64.3,2843247,60.3,187667,6.2
Montana,2014,6,512539,63.6,488704,60.6,23835,4.7
Nebraska,2014,6,1012254,70.7,978935,68.4,33319,3.3
Nevada,2014,6,1377865,62.9,1264946,57.8,112919,8.2
New Hampshire,2014,6,742605,68.6,710355,65.6,32250,4.3
New Jersey,2014,6,4490716,64.2,4191512,59.9,299204,6.7
New Mexico,2014,6,930470,58.0,868766,54.2,61704,6.6
New York,2014,6,9512596,60.6,8914743,56.8,597853,6.3
New York city,2014,6,4088525,60.4,3797541,56.1,290984,7.1
North Carolina,2014,6,4696574,61.1,4406318,57.4,290256,6.2
North Dakota,2014,6,408963,71.8,398374,69.9,10589,2.6
Ohio,2014,6,5704592,62.7,5372122,59.1,332470,5.8
Oklahoma,2014,6,1791491,60.9,1714066,58.2,77425,4.3
Oregon,2014,6,1948765,61.7,1818552,57.5,130213,6.7
Pennsylvania,2014,6,6382223,62.5,6001094,58.8,381129,6.0
Rhode Island,2014,6,556619,65.2,513087,60.1,43532,7.8
South Carolina,2014,6,2216695,59.0,2078892,55.4,137803,6.2
South Dakota,2014,6,450202,70.0,435243,67.6,14959,3.3
Tennessee,2014,6,3036228,59.5,2832894,55.5,203334,6.7
Texas,2014,6,13005331,64.8,12325395,61.4,679936,5.2
Utah,2014,6,1412233,67.3,1361525,64.9,50708,3.6
Vermont,2014,6,348595,67.9,334637,65.2,13958,4.0
Virginia,2014,6,4265150,66.3,4044124,62.8,221026,5.2
Washington,2014,6,3484570,63.2,3278515,59.4,206055,5.9
West Virginia,2014,6,794976,53.5,743439,50.1,51537,6.5
Wisconsin,2014,6,3074787,67.9,2909425,64.3,165362,5.4
Wyoming,2014,6,302902,67.4,289593,64.4,13309,4.4
Alabama,2014,7,2163245,57.2,2017648,53.3,145597,6.7
Alaska,2014,7,364744,67.5,339820,62.9,24924,6.8
Arizona,2014,7,3118643,60.2,2908222,56.1,210421,6.7
Arkansas,2014,7,1326166,58.0,1249184,54.6,76982,5.8
California,2014,7,18677566,62.3,17279967,57.7,1397599,7.5
Los Angeles County,2014,7,4986277,62.8,4579294,57.7,406983,8.2
Colorado,2014,7,2802732,67.6,2669021,64.4,133711,4.8
Connecticut,2014,7,1891461,65.9,1767363,61.6,124098,6.6
Delaware,2014,7,453608,61.5,428207,58.1,25401,5.6
District of Columbia,2014,7,380511,69.4,351174,64.1,29337,7.7
Florida,2014,7,9553381,59.9,8941700,56.1,611681,6.4
Georgia,2014,7,4748222,62.0,4405529,57.6,342693,7.2
Hawaii,2014,7,664779,61.5,636723,58.9,28056,4.2
Idaho,2014,7,774415,63.1,743273,60.6,31142,4.0
Illinois,2014,7,6506321,64.7,6053007,60.2,453314,7.0
Indiana,2014,7,3230459,63.4,3039980,59.7,190479,5.9
Iowa,2014,7,1701256,70.3,1628984,67.3,72272,4.2
Kansas,2014,7,1494899,68.1,1427996,65.1,66903,4.5
Kentucky,2014,7,2002336,58.4,1877122,54.8,125214,6.3
Louisiana,2014,7,2146989,60.5,2010030,56.7,136959,6.4
Maine,2014,7,697406,64.0,659150,60.5,38256,5.5
Maryland,2014,7,3124415,66.9,2946042,63.1,178373,5.7
Massachusetts,2014,7,3570532,65.3,3366302,61.6,204230,5.7
Michigan,2014,7,4760410,60.6,4419845,56.2,340565,7.2
Minnesota,2014,7,2982337,70.1,2858156,67.2,124181,4.2
Mississippi,2014,7,1241849,54.6,1147388,50.5,94461,7.6
Missouri,2014,7,3032475,64.3,2848329,60.4,184146,6.1
Montana,2014,7,512909,63.5,489212,60.6,23697,4.6
Nebraska,2014,7,1011874,70.7,979130,68.4,32744,3.2
Nevada,2014,7,1379296,62.9,1268140,57.8,111156,8.1
New Hampshire,2014,7,743222,68.6,711566,65.6,31656,4.3
New Jersey,2014,7,4496114,64.3,4198635,60.0,297479,6.6
New Mexico,2014,7,931549,58.1,870102,54.2,61447,6.6
New York,2014,7,9506832,60.6,8921190,56.8,585642,6.2
New York city,2014,7,4089108,60.4,3806182,56.2,282926,6.9
North Carolina,2014,7,4701014,61.1,4412779,57.4,288235,6.1
North Dakota,2014,7,410272,71.9,399572,70.0,10700,2.6
Ohio,2014,7,5714956,62.8,5387836,59.2,327120,5.7
Oklahoma,2014,7,1794276,60.9,1718123,58.3,76153,4.2
Oregon,2014,7,1951938,61.7,1823499,57.6,128439,6.6
Pennsylvania,2014,7,6380460,62.5,6007565,58.9,372895,5.8
Rhode Island,2014,7,556618,65.2,514189,60.2,42429,7.6
South Carolina,2014,7,2223807,59.1,2082702,55.4,141105,6.3
South Dakota,2014,7,450600,70.0,435765,67.7,14835,3.3
Tennessee,2014,7,3037420,59.4,2835451,55.5,201969,6.6
Texas,2014,7,13020533,64.8,12348864,61.4,671669,5.2
Utah,2014,7,1415313,67.4,1364434,65.0,50879,3.6
Vermont,2014,7,348732,67.9,334745,65.2,13987,4.0
Virginia,2014,7,4261973,66.1,4043653,62.8,218320,5.1
Washington,2014,7,3493179,63.2,3287937,59.5,205242,5.9
West Virginia,2014,7,794363,53.5,743221,50.1,51142,6.4
Wisconsin,2014,7,3077724,68.0,2915883,64.4,161841,5.3
Wyoming,2014,7,303175,67.5,289739,64.5,13436,4.4
Alabama,2014,8,2162943,57.1,2019514,53.4,143429,6.6
Alaska,2014,8,364445,67.4,339777,62.9,24668,6.8
Arizona,2014,8,3127937,60.3,2918301,56.2,209636,6.7
Arkansas,2014,8,1328224,58.0,1251928,54.7,76296,5.7
California,2014,8,18704813,62.3,17324005,57.7,1380808,7.4
Los Angeles County,2014,8,4993737,62.8,4590239,57.8,403498,8.1
Colorado,2014,8,2805239,67.6,2676304,64.5,128935,4.6
Connecticut,2014,8,1894819,66.0,1771979,61.8,122840,6.5
Delaware,2014,8,454713,61.6,429692,58.2,25021,5.5
District of Columbia,2014,8,382074,69.6,352769,64.3,29305,7.7
Florida,2014,8,9565595,59.9,8961454,56.1,604141,6.3
Georgia,2014,8,4748449,62.0,4410760,57.5,337689,7.1
Hawaii,2014,8,665410,61.6,637809,59.0,27601,4.1
Idaho,2014,8,776184,63.2,744890,60.6,31294,4.0
Illinois,2014,8,6505638,64.7,6063338,60.3,442300,6.8
Indiana,2014,8,3233023,63.4,3044917,59.7,188106,5.8
Iowa,2014,8,1702696,70.3,1630943,67.3,71753,4.2
Kansas,2014,8,1494750,68.1,1428614,65.1,66136,4.4
Kentucky,2014,8,1997344,58.2,1876646,54.7,120698,6.0
Louisiana,2014,8,2157540,60.8,2015914,56.8,141626,6.6
Maine,2014,8,696893,63.9,659284,60.5,37609,5.4
Maryland,2014,8,3126888,66.9,2950361,63.1,176527,5.6
Massachusetts,2014,8,3580091,65.5,3377865,61.8,202226,5.6
Michigan,2014,8,4761597,60.5,4429841,56.3,331756,7.0
Minnesota,2014,8,2985812,70.1,2863719,67.3,122093,4.1
Mississippi,2014,8,1241705,54.6,1148638,50.5,93067,7.5
Missouri,2014,8,3035691,64.4,2854353,60.5,181338,6.0
Montana,2014,8,513167,63.5,489580,60.6,23587,4.6
Nebraska,2014,8,1011897,70.6,979646,68.4,32251,3.2
Nevada,2014,8,1381318,62.9,1271663,57.9,109655,7.9
New Hampshire,2014,8,744071,68.6,712953,65.7,31118,4.2
New Jersey,2014,8,4502037,64.3,4205182,60.1,296855,6.6
New Mexico,2014,8,932840,58.1,871735,54.3,61105,6.6
New York,2014,8,9505320,60.6,8929372,56.9,575948,6.1
New York city,2014,8,4091325,60.4,3815153,56.3,276172,6.8
North Carolina,2014,8,4705145,61.1,4419198,57.4,285947,6.1
North Dakota,2014,8,411625,72.0,400807,70.1,10818,2.6
Ohio,2014,8,5726029,62.9,5404261,59.4,321768,5.6
Oklahoma,2014,8,1798094,61.0,1722930,58.4,75164,4.2
Oregon,2014,8,1955313,61.7,1828180,57.7,127133,6.5
Pennsylvania,2014,8,6382229,62.5,6016409,58.9,365820,5.7
Rhode Island,2014,8,556677,65.2,515271,60.3,41406,7.4
South Carolina,2014,8,2231509,59.3,2087391,55.4,144118,6.5
South Dakota,2014,8,451166,70.0,436382,67.7,14784,3.3
Tennessee,2014,8,3040492,59.4,2840279,55.5,200213,6.6
Texas,2014,8,13036080,64.7,12373428,61.5,662652,5.1
Utah,2014,8,1418964,67.5,1367794,65.0,51170,3.6
Vermont,2014,8,348863,67.9,334843,65.2,14020,4.0
Virginia,2014,8,4258573,66.0,4043065,62.7,215508,5.1
Washington,2014,8,3503437,63.3,3298328,59.6,205109,5.9
West Virginia,2014,8,794272,53.5,743335,50.1,50937,6.4
Wisconsin,2014,8,3081114,68.0,2922633,64.5,158481,5.1
Wyoming,2014,8,303393,67.5,289922,64.5,13471,4.4
Alabama,2014,9,2162865,57.1,2021615,53.4,141250,6.5
Alaska,2014,9,364135,67.3,339845,62.8,24290,6.7
Arizona,2014,9,3138216,60.4,2929099,56.3,209117,6.7
Arkansas,2014,9,1330805,58.1,1255079,54.8,75726,5.7
California,2014,9,18735234,62.4,17369795,57.8,1365439,7.3
Los Angeles County,2014,9,5001208,62.9,4600980,57.9,400228,8.0
Colorado,2014,9,2808186,67.5,2682837,64.5,125349,4.5
Connecticut,2014,9,1897546,66.1,1776030,61.9,121516,6.4
Delaware,2014,9,455690,61.7,431084,58.3,24606,5.4
District of Columbia,2014,9,383397,69.7,354127,64.4,29270,7.6
Florida,2014,9,9577872,59.8,8980727,56.1,597145,6.2
Georgia,2014,9,4748685,61.9,4416904,57.6,331781,7.0
Hawaii,2014,9,666039,61.6,638866,59.1,27173,4.1
Idaho,2014,9,777919,63.2,746662,60.7,31257,4.0
Illinois,2014,9,6506203,64.7,6073599,60.4,432604,6.6
Indiana,2014,9,3237161,63.5,3050703,59.8,186458,5.8
Iowa,2014,9,1704150,70.3,1633086,67.4,71064,4.2
Kansas,2014,9,1494751,68.0,1429313,65.1,65438,4.4
Kentucky,2014,9,1993235,58.1,1876403,54.7,116832,5.9
Louisiana,2014,9,2166638,61.0,2021167,56.9,145471,6.7
Maine,2014,9,696540,63.9,659456,60.5,37084,5.3
Maryland,2014,9,3129613,66.9,2954694,63.2,174919,5.6
Massachusetts,2014,9,3590220,65.6,3390213,61.9,200007,5.6
Michigan,2014,9,4763243,60.5,4439814,56.4,323429,6.8
Minnesota,2014,9,2988734,70.2,2868043,67.3,120691,4.0
Mississippi,2014,9,1241870,54.6,1150211,50.6,91659,7.4
Missouri,2014,9,3039992,64.4,2860932,60.6,179060,5.9
Montana,2014,9,513367,63.5,489884,60.6,23483,4.6
Nebraska,2014,9,1012111,70.6,980321,68.4,31790,3.1
Nevada,2014,9,1383739,62.9,1275356,58.0,108383,7.8
New Hampshire,2014,9,745108,68.7,714436,65.8,30672,4.1
New Jersey,2014,9,4507583,64.4,4211077,60.2,296506,6.6
New Mexico,2014,9,934149,58.2,873427,54.4,60722,6.5
New York,2014,9,9507458,60.6,8938865,56.9,568593,6.0
New York city,2014,9,4094623,60.4,3823550,56.4,271073,6.6
North Carolina,2014,9,4709906,61.1,4426731,57.4,283175,6.0
North Dakota,2014,9,412889,72.1,401994,70.2,10895,2.6
Ohio,2014,9,5735306,63.0,5419107,59.5,316199,5.5
Oklahoma,2014,9,1802468,61.1,1728111,58.6,74357,4.1
Oregon,2014,9,1958331,61.7,1832536,57.7,125795,6.4
Pennsylvania,2014,9,6387480,62.6,6026772,59.0,360708,5.6
Rhode Island,2014,9,556814,65.2,516395,60.4,40419,7.3
South Carolina,2014,9,2239247,59.4,2092822,55.5,146425,6.5
South Dakota,2014,9,451792,70.1,437009,67.8,14783,3.3
Tennessee,2014,9,3045235,59.5,2846964,55.6,198271,6.5
Texas,2014,9,13050337,64.7,12398563,61.5,651774,5.0
Utah,2014,9,1422899,67.5,1371451,65.1,51448,3.6
Vermont,2014,9,348966,67.9,334944,65.2,14022,4.0
Virginia,2014,9,4255711,65.9,4042931,62.6,212780,5.0
Washington,2014,9,3513688,63.4,3308405,59.7,205283,5.8
West Virginia,2014,9,794534,53.5,743734,50.1,50800,6.4
Wisconsin,2014,9,3084262,68.1,2928668,64.6,155594,5.0
Wyoming,2014,9,303460,67.4,290127,64.5,13333,4.4
Alabama,2014,10,2162682,57.1,2023989,53.4,138693,6.4
Alaska,2014,10,363829,67.2,340035,62.8,23794,6.5
Arizona,2014,10,3147375,60.4,2939396,56.4,207979,6.6
Arkansas,2014,10,1333104,58.2,1258078,54.9,75026,5.6
California,2014,10,18760622,62.4,17413762,57.9,1346860,7.2
Los Angeles County,2014,10,5006179,62.9,4610325,57.9,395854,7.9
Colorado,2014,10,2810762,67.4,2688227,64.5,122535,4.4
Connecticut,2014,10,1899432,66.2,1779699,62.0,119733,6.3
Delaware,2014,10,456448,61.7,432329,58.4,24119,5.3
District of Columbia,2014,10,384299,69.8,355165,64.5,29134,7.6
Florida,2014,10,9586098,59.8,8996931,56.1,589167,6.1
Georgia,2014,10,4747387,61.8,4422548,57.6,324839,6.8
Hawaii,2014,10,666609,61.6,639868,59.1,26741,4.0
Idaho,2014,10,779643,63.3,748640,60.8,31003,4.0
Illinois,2014,10,6504445,64.7,6081936,60.5,422509,6.5
Indiana,2014,10,3241264,63.5,3056667,59.9,184597,5.7
Iowa,2014,10,1705341,70.3,1635343,67.5,69998,4.1
Kansas,2014,10,1494702,68.0,1429984,65.0,64718,4.3
Kentucky,2014,10,1989610,58.0,1876386,54.7,113224,5.7
Louisiana,2014,10,2172611,61.1,2024800,57.0,147811,6.8
Maine,2014,10,696052,63.8,659532,60.5,36520,5.2
Maryland,2014,10,3131723,66.9,2958485,63.2,173238,5.5
Massachusetts,2014,10,3598416,65.7,3401460,62.1,196956,5.5
Michigan,2014,10,4763011,60.5,4448646,56.5,314365,6.6
Minnesota,2014,10,2990545,70.2,2871022,67.4,119523,4.0
Mississippi,2014,10,1242310,54.6,1152316,50.6,89994,7.2
Missouri,2014,10,3044054,64.5,2867348,60.7,176706,5.8
Montana,2014,10,513525,63.4,490239,60.6,23286,4.5
Nebraska,2014,10,1012100,70.5,980917,68.4,31183,3.1
Nevada,2014,10,1385877,62.9,1278928,58.0,106949,7.7
New Hampshire,2014,10,746217,68.7,715986,65.9,30231,4.1
New Jersey,2014,10,4510847,64.4,4215767,60.2,295080,6.5
New Mexico,2014,10,935256,58.2,874941,54.5,60315,6.4
New York,2014,10,9510169,60.6,8948744,57.0,561425,5.9
New York city,2014,10,4097501,60.4,3830840,56.5,266661,6.5
North Carolina,2014,10,4715147,61.1,4435823,57.5,279324,5.9
North Dakota,2014,10,413859,72.1,402968,70.2,10891,2.6
Ohio,2014,10,5740022,63.0,5429896,59.6,310126,5.4
Oklahoma,2014,10,1806752,61.2,1733263,58.7,73489,4.1
Oregon,2014,10,1960334,61.7,1836625,57.8,123709,6.3
Pennsylvania,2014,10,6393131,62.6,6036120,59.1,357011,5.6
Rhode Island,2014,10,556941,65.2,517546,60.6,39395,7.1
South Carolina,2014,10,2245849,59.5,2098372,55.6,147477,6.6
South Dakota,2014,10,452319,70.1,437549,67.8,14770,3.3
Tennessee,2014,10,3049884,59.5,2854160,55.7,195724,6.4
Texas,2014,10,13058380,64.6,12420918,61.5,637462,4.9
Utah,2014,10,1426616,67.6,1375102,65.1,51514,3.6
Vermont,2014,10,348999,67.9,335064,65.2,13935,4.0
Virginia,2014,10,4252749,65.8,4042841,62.6,209908,4.9
Washington,2014,10,3521452,63.4,3316839,59.8,204613,5.8
West Virginia,2014,10,794725,53.5,744126,50.1,50599,6.4
Wisconsin,2014,10,3086117,68.1,2933222,64.7,152895,5.0
Wyoming,2014,10,303319,67.4,290316,64.5,13003,4.3
Alabama,2014,11,2162723,57.1,2026910,53.5,135813,6.3
Alaska,2014,11,363530,67.2,340262,62.9,23268,6.4
Arizona,2014,11,3153926,60.5,2947951,56.5,205975,6.5
Arkansas,2014,11,1334565,58.2,1260362,55.0,74203,5.6
California,2014,11,18775765,62.4,17451977,58.0,1323788,7.1
Los Angeles County,2014,11,5006793,62.9,4616746,58.0,390047,7.8
Colorado,2014,11,2811968,67.3,2691945,64.5,120023,4.3
Connecticut,2014,11,1900520,66.2,1783052,62.1,117468,6.2
Delaware,2014,11,457025,61.7,433436,58.5,23589,5.2
District of Columbia,2014,11,384899,69.8,356027,64.6,28872,7.5
Florida,2014,11,9588482,59.7,9008617,56.1,579865,6.0
Georgia,2014,11,4744010,61.7,4426681,57.5,317329,6.7
Hawaii,2014,11,667024,61.6,640728,59.2,26296,3.9
Idaho,2014,11,781294,63.3,750676,60.8,30618,3.9
Illinois,2014,11,6498807,64.6,6086861,60.5,411946,6.3
Indiana,2014,11,3243507,63.5,3061704,60.0,181803,5.6
Iowa,2014,11,1705842,70.3,1637265,67.5,68577,4.0
Kansas,2014,11,1494484,68.0,1430308,65.0,64176,4.3
Kentucky,2014,11,1986279,57.8,1876349,54.6,109930,5.5
Louisiana,2014,11,2174782,61.2,2026322,57.0,148460,6.8
Maine,2014,11,695222,63.7,659414,60.5,35808,5.2
Maryland,2014,11,3132751,66.9,2961418,63.2,171333,5.5
Massachusetts,2014,11,3602853,65.7,3409823,62.2,193030,5.4
Michigan,2014,11,4759649,60.5,4455559,56.6,304090,6.4
Minnesota,2014,11,2991030,70.1,2872957,67.4,118073,3.9
Mississippi,2014,11,1243119,54.6,1155075,50.8,88044,7.1
Missouri,2014,11,3047123,64.5,2872738,60.8,174385,5.7
Montana,2014,11,513751,63.4,490786,60.6,22965,4.5
Nebraska,2014,11,1011615,70.5,981159,68.4,30456,3.0
Nevada,2014,11,1387386,62.8,1282078,58.1,105308,7.6
New Hampshire,2014,11,747167,68.8,717428,66.0,29739,4.0
New Jersey,2014,11,4510783,64.4,4218647,60.2,292136,6.5
New Mexico,2014,11,936040,58.2,876027,54.5,60013,6.4
New York,2014,11,9512399,60.6,8958578,57.0,553821,5.8
New York city,2014,11,4099323,60.4,3836889,56.6,262434,6.4
North Carolina,2014,11,4719503,61.1,4444742,57.5,274761,5.8
North Dakota,2014,11,414357,72.1,403536,70.2,10821,2.6
Ohio,2014,11,5738510,63.0,5434432,59.6,304078,5.3
Oklahoma,2014,11,1810599,61.2,1737920,58.8,72679,4.0
Oregon,2014,11,1960742,61.6,1840037,57.8,120705,6.2
Pennsylvania,2014,11,6396471,62.6,6042204,59.2,354267,5.5
Rhode Island,2014,11,557010,65.2,518689,60.7,38321,6.9
South Carolina,2014,11,2250477,59.5,2103434,55.6,147043,6.5
South Dakota,2014,11,452605,70.1,437918,67.8,14687,3.2
Tennessee,2014,11,3052910,59.5,2860333,55.8,192577,6.3
Texas,2014,11,13057664,64.5,12436708,61.4,620956,4.8
Utah,2014,11,1429762,67.6,1378419,65.2,51343,3.6
Vermont,2014,11,348937,67.9,335207,65.2,13730,3.9
Virginia,2014,11,4249011,65.7,4042113,62.5,206898,4.9
Washington,2014,11,3525535,63.4,3323022,59.8,202513,5.7
West Virginia,2014,11,794615,53.5,744200,50.1,50415,6.3
Wisconsin,2014,11,3085929,68.0,2935868,64.7,150061,4.9
Wyoming,2014,11,302997,67.3,290435,64.5,12562,4.1
Alabama,2014,12,2163996,57.1,2030603,53.6,133393,6.2
Alaska,2014,12,363338,67.1,340470,62.9,22868,6.3
Arizona,2014,12,3158664,60.5,2954989,56.6,203675,6.4
Arkansas,2014,12,1335449,58.2,1261924,55.0,73525,5.5
California,2014,12,18785368,62.4,17484592,58.0,1300776,6.9
Los Angeles County,2014,12,5004957,62.8,4620879,58.0,384078,7.7
Colorado,2014,12,2812244,67.2,2694387,64.4,117857,4.2
Connecticut,2014,12,1901233,66.2,1786010,62.2,115223,6.1
Delaware,2014,12,457575,61.7,434437,58.6,23138,5.1
District of Columbia,2014,12,385365,69.8,356775,64.6,28590,7.4
Florida,2014,12,9588236,59.6,9017099,56.0,571137,6.0
Georgia,2014,12,4740275,61.5,4429609,57.5,310666,6.6
Hawaii,2014,12,667398,61.6,641508,59.2,25890,3.9
Idaho,2014,12,783031,63.4,752712,60.9,30319,3.9
Illinois,2014,12,6492057,64.6,6089359,60.6,402698,6.2
Indiana,2014,12,3243867,63.5,3065804,60.0,178063,5.5
Iowa,2014,12,1705596,70.3,1638437,67.5,67159,3.9
Kansas,2014,12,1494280,67.9,1430176,65.0,64104,4.3
Kentucky,2014,12,1983555,57.7,1876205,54.6,107350,5.4
Louisiana,2014,12,2174213,61.1,2026255,57.0,147958,6.8
Maine,2014,12,694247,63.7,659254,60.4,34993,5.0
Maryland,2014,12,3133445,66.9,2963878,63.3,169567,5.4
Massachusetts,2014,12,3603769,65.7,3414729,62.3,189040,5.2
Michigan,2014,12,4754985,60.4,4461008,56.7,293977,6.2
Minnesota,2014,12,2991295,70.1,2874858,67.4,116437,3.9
Mississippi,2014,12,1244773,54.7,1158482,50.9,86291,6.9
Missouri,2014,12,3049812,64.6,2877073,60.9,172739,5.7
Montana,2014,12,514253,63.4,491643,60.6,22610,4.4
Nebraska,2014,12,1010872,70.4,980970,68.3,29902,3.0
Nevada,2014,12,1388719,62.8,1284896,58.1,103823,7.5
New Hampshire,2014,12,747903,68.8,718654,66.1,29249,3.9
New Jersey,2014,12,4508668,64.4,4220057,60.2,288611,6.4
New Mexico,2014,12,936723,58.3,876625,54.5,60098,6.4
New York,2014,12,9517113,60.6,8969792,57.1,547321,5.8
New York city,2014,12,4101133,60.4,3842353,56.6,258780,6.3
North Carolina,2014,12,4723623,61.1,4452536,57.6,271087,5.7
North Dakota,2014,12,414356,72.0,403589,70.1,10767,2.6
Ohio,2014,12,5732637,62.9,5433117,59.6,299520,5.2
Oklahoma,2014,12,1814538,61.3,1742065,58.9,72473,4.0
Oregon,2014,12,1960168,61.5,1842745,57.8,117423,6.0
Pennsylvania,2014,12,6397976,62.6,6045102,59.2,352874,5.5
Rhode Island,2014,12,557152,65.2,519822,60.8,37330,6.7
South Carolina,2014,12,2253950,59.5,2108022,55.7,145928,6.5
South Dakota,2014,12,452708,70.1,438149,67.8,14559,3.2
Tennessee,2014,12,3054766,59.5,2865175,55.8,189591,6.2
Texas,2014,12,13051833,64.3,12446054,61.4,605779,4.6
Utah,2014,12,1432638,67.7,1381478,65.2,51160,3.6
Vermont,2014,12,348838,67.8,335378,65.2,13460,3.9
Virginia,2014,12,4245503,65.6,4041135,62.5,204368,4.8
Washington,2014,12,3527147,63.4,3327558,59.8,199589,5.7
West Virginia,2014,12,794247,53.5,743765,50.1,50482,6.4
Wisconsin,2014,12,3084481,68.0,2937011,64.7,147470,4.8
Wyoming,2014,12,302631,67.2,290474,64.5,12157,4.0
Alabama,2015,1,2166771,57.1,2034786,53.6,131985,6.1
Alaska,2015,1,363226,67.1,340538,62.9,22688,6.2
Arizona,2015,1,3162393,60.4,2961081,56.6,201312,6.4
Arkansas,2015,1,1336169,58.2,1263086,55.1,73083,5.5
California,2015,1,18794302,62.3,17513360,58.1,1280942,6.8
Los Angeles County,2015,1,5002865,62.8,4624204,58.0,378661,7.6
Colorado,2015,1,2812740,67.1,2696305,64.3,116435,4.1
Connecticut,2015,1,1901701,66.2,1788370,62.3,113331,6.0
Delaware,2015,1,458168,61.7,435330,58.7,22838,5.0
District of Columbia,2015,1,385655,69.7,357301,64.6,28354,7.4
Florida,2015,1,9588873,59.5,9024705,56.0,564168,5.9
Georgia,2015,1,4737642,61.4,4431983,57.5,305659,6.5
Hawaii,2015,1,667875,61.6,642329,59.3,25546,3.8
Idaho,2015,1,785010,63.5,754789,61.0,30221,3.8
Illinois,2015,1,6487628,64.5,6091476,60.6,396152,6.1
Indiana,2015,1,3243609,63.5,3069876,60.1,173733,5.4
Iowa,2015,1,1704798,70.2,1638800,67.5,65998,3.9
Kansas,2015,1,1494068,67.9,1429606,65.0,64462,4.3
Kentucky,2015,1,1981477,57.7,1875886,54.6,105591,5.3
Louisiana,2015,1,2172224,61.0,2025344,56.9,146880,6.8
Maine,2015,1,693272,63.6,659092,60.4,34180,4.9
Maryland,2015,1,3134640,66.9,2966550,63.3,168090,5.4
Massachusetts,2015,1,3602272,65.6,3416690,62.3,185582,5.2
Michigan,2015,1,4751121,60.3,4465483,56.7,285638,6.0
Minnesota,2015,1,2992386,70.1,2877365,67.4,115021,3.8
Mississippi,2015,1,1247332,54.8,1162332,51.1,85000,6.8
Missouri,2015,1,3052395,64.6,2880669,61.0,171726,5.6
Montana,2015,1,515033,63.5,492735,60.7,22298,4.3
Nebraska,2015,1,1010079,70.3,980427,68.2,29652,2.9
Nevada,2015,1,1390075,62.7,1287564,58.1,102511,7.4
New Hampshire,2015,1,748374,68.8,719581,66.2,28793,3.8
New Jersey,2015,1,4506245,64.3,4221064,60.2,285181,6.3
New Mexico,2015,1,937449,58.3,876798,54.5,60651,6.5
New York,2015,1,9524954,60.6,8982601,57.2,542353,5.7
New York city,2015,1,4102656,60.4,3847113,56.7,255543,6.2
North Carolina,2015,1,4728780,61.1,4459141,57.6,269639,5.7
North Dakota,2015,1,413890,71.8,403094,69.9,10796,2.6
Ohio,2015,1,5725314,62.8,5428302,59.5,297012,5.2
Oklahoma,2015,1,1819030,61.4,1745819,59.0,73211,4.0
Oregon,2015,1,1959718,61.4,1845083,57.8,114635,5.8
Pennsylvania,2015,1,6399411,62.6,6046534,59.2,352877,5.5
Rhode Island,2015,1,557431,65.2,520872,60.9,36559,6.6
South Carolina,2015,1,2257193,59.5,2112314,55.7,144879,6.4
South Dakota,2015,1,452732,70.1,438302,67.8,14430,3.2
Tennessee,2015,1,3056389,59.5,2869136,55.9,187253,6.1
Texas,2015,1,13045727,64.2,12451402,61.3,594325,4.6
Utah,2015,1,1435490,67.7,1384452,65.3,51038,3.6
Vermont,2015,1,348721,67.8,335527,65.2,13194,3.8
Virginia,2015,1,4242711,65.6,4040145,62.4,202566,4.8
Washington,2015,1,3528211,63.3,3331515,59.8,196696,5.6
West Virginia,2015,1,793820,53.5,742884,50.1,50936,6.4
Wisconsin,2015,1,3082864,67.9,2937399,64.7,145465,4.7
Wyoming,2015,1,302350,67.1,290427,64.5,11923,3.9
Alabama,2015,2,2170601,57.2,2038928,53.7,131673,6.1
Alaska,2015,2,363134,67.0,340415,62.8,22719,6.3
Arizona,2015,2,3165741,60.4,2966433,56.6,199308,6.3
Arkansas,2015,2,1336952,58.3,1264167,55.1,72785,5.4
California,2015,2,18804573,62.3,17539526,58.1,1265047,6.7
Los Angeles County,2015,2,5001244,62.7,4627501,58.0,373743,7.5
Colorado,2015,2,2813690,67.0,2698184,64.3,115506,4.1
Connecticut,2015,2,1901730,66.2,1789810,62.3,111920,5.9
Delaware,2015,2,458835,61.8,436141,58.7,22694,4.9
District of Columbia,2015,2,385829,69.7,357663,64.6,28166,7.3
Florida,2015,2,9592040,59.4,9032822,56.0,559218,5.8
Georgia,2015,2,4736239,61.4,4433957,57.4,302282,6.4
Hawaii,2015,2,668343,61.6,643165,59.3,25178,3.8
Idaho,2015,2,787221,63.6,756853,61.1,30368,3.9
Illinois,2015,2,6487282,64.5,6094125,60.6,393157,6.1
Indiana,2015,2,3243958,63.5,3074662,60.2,169296,5.2
Iowa,2015,2,1703904,70.2,1638715,67.5,65189,3.8
Kansas,2015,2,1493764,67.9,1428745,64.9,65019,4.4
Kentucky,2015,2,1979937,57.6,1875247,54.6,104690,5.3
Louisiana,2015,2,2169594,60.9,2024043,56.8,145551,6.7
Maine,2015,2,692242,63.5,658825,60.4,33417,4.8
Maryland,2015,2,3136563,66.9,2969832,63.3,166731,5.3
Massachusetts,2015,2,3599631,65.6,3416731,62.2,182900,5.1
Michigan,2015,2,4748842,60.3,4469325,56.8,279517,5.9
Minnesota,2015,2,2994638,70.1,2880470,67.4,114168,3.8
Mississippi,2015,2,1250514,54.9,1166324,51.2,84190,6.7
Missouri,2015,2,3054756,64.6,2883759,61.0,170997,5.6
Montana,2015,2,515924,63.6,493824,60.8,22100,4.3
Nebraska,2015,2,1009386,70.2,979687,68.2,29699,2.9
Nevada,2015,2,1391547,62.7,1290189,58.1,101358,7.3
New Hampshire,2015,2,748424,68.8,720050,66.2,28374,3.8
New Jersey,2015,2,4504414,64.3,4222229,60.3,282185,6.3
New Mexico,2015,2,938267,58.3,876702,54.5,61565,6.6
New York,2015,2,9533927,60.7,8995441,57.3,538486,5.6
New York city,2015,2,4103202,60.4,3851046,56.7,252156,6.1
North Carolina,2015,2,4735727,61.1,4464853,57.6,270874,5.7
North Dakota,2015,2,413044,71.6,402107,69.7,10937,2.6
Ohio,2015,2,5719068,62.7,5423145,59.5,295923,5.2
Oklahoma,2015,2,1823885,61.6,1749030,59.0,74855,4.1
Oregon,2015,2,1960323,61.4,1847488,57.8,112835,5.8
Pennsylvania,2015,2,6402054,62.7,6048226,59.2,353828,5.5
Rhode Island,2015,2,557723,65.2,521694,61.0,36029,6.5
South Carolina,2015,2,2260446,59.5,2116354,55.7,144092,6.4
South Dakota,2015,2,452748,70.0,438409,67.8,14339,3.2
Tennessee,2015,2,3058800,59.5,2873342,55.9,185458,6.1
Texas,2015,2,13042678,64.1,12455072,61.2,587606,4.5
Utah,2015,2,1438477,67.7,1387444,65.3,51033,3.5
Vermont,2015,2,348536,67.7,335570,65.2,12966,3.7
Virginia,2015,2,4240767,65.5,4039464,62.4,201303,4.7
Washington,2015,2,3530246,63.3,3335608,59.8,194638,5.5
West Virginia,2015,2,793628,53.5,741810,50.0,51818,6.5
Wisconsin,2015,2,3081614,67.9,2937529,64.7,144085,4.7
Wyoming,2015,2,302209,67.0,290287,64.4,11922,3.9
Alabama,2015,3,2174960,57.3,2042936,53.8,132024,6.1
Alaska,2015,3,363053,67.0,340222,62.8,22831,6.3
Arizona,2015,3,3169469,60.4,2971786,56.6,197683,6.2
Arkansas,2015,3,1337920,58.3,1265637,55.1,72283,5.4
California,2015,3,18816299,62.3,17566611,58.2,1249688,6.6
Los Angeles County,2015,3,4999337,62.7,4631293,58.0,368044,7.4
Colorado,2015,3,2815196,66.9,2700859,64.2,114337,4.1
Connecticut,2015,3,1900978,66.2,1790269,62.4,110709,5.8
Delaware,2015,3,459628,61.8,437007,58.8,22621,4.9
District of Columbia,2015,3,386175,69.6,358225,64.6,27950,7.2
Florida,2015,3,9598497,59.4,9043681,55.9,554816,5.8
Georgia,2015,3,4735865,61.3,4436481,57.4,299384,6.3
Hawaii,2015,3,668758,61.7,644078,59.4,24680,3.7
Idaho,2015,3,789517,63.7,758877,61.2,30640,3.9
Illinois,2015,3,6491517,64.6,6098798,60.7,392719,6.0
Indiana,2015,3,3245723,63.5,3080816,60.3,164907,5.1
Iowa,2015,3,1703231,70.1,1638687,67.5,64544,3.8
Kansas,2015,3,1493443,67.8,1428091,64.9,65352,4.4
Kentucky,2015,3,1978823,57.5,1874526,54.5,104297,5.3
Louisiana,2015,3,2166522,60.8,2022881,56.8,143641,6.6
Maine,2015,3,691110,63.4,658472,60.4,32638,4.7
Maryland,2015,3,3139033,66.9,2974094,63.4,164939,5.3
Massachusetts,2015,3,3597341,65.5,3416770,62.2,180571,5.0
Michigan,2015,3,4748857,60.3,4473859,56.8,274998,5.8
Minnesota,2015,3,2998186,70.2,2884337,67.5,113849,3.8
Mississippi,2015,3,1253923,55.1,1170356,51.4,83567,6.7
Missouri,2015,3,3056791,64.6,2887036,61.1,169755,5.6
Montana,2015,3,516734,63.6,494730,60.9,22004,4.3
Nebraska,2015,3,1009054,70.2,979132,68.1,29922,3.0
Nevada,2015,3,1393136,62.7,1292980,58.2,100156,7.2
New Hampshire,2015,3,748091,68.8,720208,66.2,27883,3.7
New Jersey,2015,3,4503300,64.3,4224426,60.3,278874,6.2
New Mexico,2015,3,939088,58.4,876587,54.5,62501,6.7
New York,2015,3,9542416,60.7,9008594,57.3,533822,5.6
New York city,2015,3,4103094,60.4,3855298,56.8,247796,6.0
North Carolina,2015,3,4744251,61.1,4470715,57.6,273536,5.8
North Dakota,2015,3,412032,71.3,400873,69.3,11159,2.7
Ohio,2015,3,5715533,62.7,5421129,59.5,294404,5.2
Oklahoma,2015,3,1828473,61.7,1751584,59.1,76889,4.2
Oregon,2015,3,1962380,61.4,1850584,57.9,111796,5.7
Pennsylvania,2015,3,6406408,62.7,6052263,59.3,354145,5.5
Rhode Island,2015,3,557822,65.2,522242,61.1,35580,6.4
South Carolina,2015,3,2263671,59.5,2120647,55.8,143024,6.3
South Dakota,2015,3,452826,70.0,438548,67.8,14278,3.2
Tennessee,2015,3,3062426,59.5,2878956,56.0,183470,6.0
Texas,2015,3,13044962,64.0,12461125,61.1,583837,4.5
Utah,2015,3,1441814,67.8,1390696,65.4,51118,3.5
Vermont,2015,3,348217,67.7,335461,65.2,12756,3.7
Virginia,2015,3,4239843,65.4,4040318,62.4,199525,4.7
Washington,2015,3,3533904,63.2,3340601,59.8,193303,5.5
West Virginia,2015,3,793761,53.6,740877,50.0,52884,6.7
Wisconsin,2015,3,3080867,67.9,2938085,64.7,142782,4.6
Wyoming,2015,3,302218,67.0,290102,64.3,12116,4.0
Alabama,2015,4,2170166,57.2,2037552,53.7,132614,6.1
Alaska,2015,4,362975,67.0,340096,62.8,22879,6.3
Arizona,2015,4,3174046,60.4,2977647,56.7,196399,6.2
Arkansas,2015,4,1338983,58.3,1267673,55.2,71310,5.3
California,2015,4,18826398,62.3,17594659,58.2,1231739,6.5
Los Angeles County,2015,4,4995004,62.6,4634545,58.0,360459,7.2
Colorado,2015,4,2817304,66.9,2704794,64.2,112510,4.0
Connecticut,2015,4,1899181,66.1,1789732,62.3,109449,5.8
Delaware,2015,4,460528,61.9,437998,58.9,22530,4.9
District of Columbia,2015,4,386792,69.6,359132,64.7,27660,7.2
Florida,2015,4,9607811,59.3,9058084,55.9,549727,5.7
Georgia,2015,4,4735991,61.2,4439804,57.4,296187,6.3
Hawaii,2015,4,669187,61.7,645104,59.5,24083,3.6
Idaho,2015,4,791724,63.8,760809,61.3,30915,3.9
Illinois,2015,4,6499013,64.7,6106082,60.7,392931,6.0
Indiana,2015,4,3249285,63.6,3088493,60.4,160792,4.9
Iowa,2015,4,1702323,70.1,1638444,67.5,63879,3.8
Kansas,2015,4,1493226,67.8,1428104,64.9,65122,4.4
Kentucky,2015,4,1977936,57.5,1873917,54.5,104019,5.3
Louisiana,2015,4,2162787,60.7,2021790,56.7,140997,6.5
Maine,2015,4,689909,63.3,658087,60.3,31822,4.6
Maryland,2015,4,3141417,66.9,2978798,63.5,162619,5.2
Massachusetts,2015,4,3595870,65.4,3417689,62.2,178181,5.0
Michigan,2015,4,4750757,60.3,4479763,56.9,270994,5.7
Minnesota,2015,4,3002331,70.2,2888543,67.6,113788,3.8
Mississippi,2015,4,1257058,55.2,1174188,51.6,82870,6.6
Missouri,2015,4,3058205,64.7,2890940,61.1,167265,5.5
Montana,2015,4,517282,63.6,495305,60.9,21977,4.2
Nebraska,2015,4,1009259,70.2,979055,68.1,30204,3.0
Nevada,2015,4,1394785,62.7,1295937,58.2,98848,7.1
New Hampshire,2015,4,747475,68.7,720243,66.2,27232,3.6
New Jersey,2015,4,4502099,64.2,4227666,60.3,274433,6.1
New Mexico,2015,4,939710,58.4,876589,54.5,63121,6.7
New York,2015,4,9548293,60.8,9021384,57.4,526909,5.5
New York city,2015,4,4101681,60.4,3859543,56.8,242138,5.9
North Carolina,2015,4,4753189,61.2,4477145,57.6,276044,5.8
North Dakota,2015,4,411096,71.0,399699,69.0,11397,2.8
Ohio,2015,4,5713945,62.7,5422656,59.5,291289,5.1
Oklahoma,2015,4,1831977,61.8,1753289,59.1,78688,4.3
Oregon,2015,4,1965819,61.4,1854638,57.9,111181,5.7
Pennsylvania,2015,4,6412274,62.8,6059046,59.3,353228,5.5
Rhode Island,2015,4,557557,65.2,522512,61.1,35045,6.3
South Carolina,2015,4,2266502,59.5,2125329,55.8,141173,6.2
South Dakota,2015,4,452965,70.0,438747,67.8,14218,3.1
Tennessee,2015,4,3066692,59.6,2885754,56.1,180938,5.9
Texas,2015,4,13052347,63.9,12471167,61.1,581180,4.5
Utah,2015,4,1445478,67.8,1394232,65.4,51246,3.5
Vermont,2015,4,347766,67.6,335199,65.1,12567,3.6
Virginia,2015,4,4239190,65.4,4042765,62.4,196425,4.6
Washington,2015,4,3539114,63.2,3346743,59.8,192371,5.4
West Virginia,2015,4,794032,53.6,740233,50.0,53799,6.8
Wisconsin,2015,4,3080496,67.8,2939372,64.7,141124,4.6
Wyoming,2015,4,302299,67.0,289899,64.3,12400,4.1
Alabama,2015,5,2164519,57.0,2031470,53.5,133049,6.1
Alaska,2015,5,362798,66.9,339977,62.7,22821,6.3
Arizona,2015,5,3179024,60.4,2983595,56.7,195429,6.1
Arkansas,2015,5,1339839,58.3,1269993,55.3,69846,5.2
California,2015,5,18830333,62.3,17620363,58.3,1209970,6.4
Los Angeles County,2015,5,4986872,62.4,4636252,58.0,350620,7.0
Colorado,2015,5,2819533,66.8,2709579,64.2,109954,3.9
Connecticut,2015,5,1896379,66.0,1788339,62.3,108040,5.7
Delaware,2015,5,461456,62.0,439061,58.9,22395,4.9
District of Columbia,2015,5,387466,69.7,360162,64.8,27304,7.0
Florida,2015,5,9618147,59.3,9074570,56.0,543577,5.7
Georgia,2015,5,4735398,61.1,4442925,57.4,292473,6.2
Hawaii,2015,5,669614,61.7,646142,59.5,23472,3.5
Idaho,2015,5,793675,63.9,762546,61.4,31129,3.9
Illinois,2015,5,6506301,64.7,6114433,60.8,391868,6.0
Indiana,2015,5,3254041,63.6,3096911,60.6,157130,4.8
Iowa,2015,5,1700817,70.0,1637661,67.4,63156,3.7
Kansas,2015,5,1493024,67.8,1428789,64.9,64235,4.3
Kentucky,2015,5,1976817,57.5,1873250,54.4,103567,5.2
Louisiana,2015,5,2158261,60.5,2020294,56.7,137967,6.4
Maine,2015,5,688694,63.1,657703,60.3,30991,4.5
Maryland,2015,5,3142923,66.9,2982840,63.5,160083,5.1
Massachusetts,2015,5,3594220,65.4,3418656,62.2,175564,4.9
Michigan,2015,5,4753081,60.3,4486713,56.9,266368,5.6
Minnesota,2015,5,3005863,70.3,2892071,67.6,113792,3.8
Mississippi,2015,5,1259289,55.3,1177336,51.7,81953,6.5
Missouri,2015,5,3058587,64.6,2895171,61.2,163416,5.3
Montana,2015,5,517493,63.6,495499,60.9,21994,4.3
Nebraska,2015,5,1009818,70.2,979369,68.0,30449,3.0
Nevada,2015,5,1396200,62.6,1298740,58.3,97460,7.0
New Hampshire,2015,5,746588,68.6,720124,66.2,26464,3.5
New Jersey,2015,5,4499740,64.2,4231181,60.4,268559,6.0
New Mexico,2015,5,939838,58.4,876592,54.5,63246,6.7
New York,2015,5,9549164,60.8,9032002,57.5,517162,5.4
New York city,2015,5,4097794,60.3,3862609,56.8,235185,5.7
North Carolina,2015,5,4760636,61.2,4483514,57.7,277122,5.8
North Dakota,2015,5,410351,70.8,398775,68.8,11576,2.8
Ohio,2015,5,5712467,62.6,5426068,59.5,286399,5.0
Oklahoma,2015,5,1833635,61.8,1753826,59.1,79809,4.4
Oregon,2015,5,1970139,61.5,1859558,58.0,110581,5.6
Pennsylvania,2015,5,6417950,62.8,6066953,59.4,350997,5.5
Rhode Island,2015,5,556870,65.1,522512,61.1,34358,6.2
South Carolina,2015,5,2268384,59.5,2129882,55.8,138502,6.1
South Dakota,2015,5,453080,70.0,438941,67.8,14139,3.1
Tennessee,2015,5,3070773,59.6,2892935,56.2,177838,5.8
Texas,2015,5,13062363,63.9,12483045,61.0,579318,4.4
Utah,2015,5,1449095,67.9,1397733,65.5,51362,3.5
Vermont,2015,5,347189,67.5,334785,65.0,12404,3.6
Virginia,2015,5,4237686,65.3,4045613,62.4,192073,4.5
Washington,2015,5,3544965,63.3,3353329,59.8,191636,5.4
West Virginia,2015,5,793992,53.6,739757,50.0,54235,6.8
Wisconsin,2015,5,3080195,67.8,2941178,64.8,139017,4.5
Wyoming,2015,5,302311,67.0,289650,64.2,12661,4.2
Alabama,2015,6,2157472,56.8,2024484,53.3,132988,6.2
Alaska,2015,6,362477,66.8,339787,62.7,22690,6.3
Arizona,2015,6,3183495,60.4,2988875,56.7,194620,6.1
Arkansas,2015,6,1340124,58.3,1272125,55.4,67999,5.1
California,2015,6,18825613,62.2,17640900,58.3,1184713,6.3
Los Angeles County,2015,6,4975759,62.2,4636963,58.0,338796,6.8
Colorado,2015,6,2821315,66.7,2714525,64.2,106790,3.8
Connecticut,2015,6,1892772,65.9,1786301,62.2,106471,5.6
Delaware,2015,6,462330,62.0,440105,59.0,22225,4.8
District of Columbia,2015,6,388031,69.7,361107,64.8,26924,6.9
Florida,2015,6,9627791,59.3,9091449,56.0,536342,5.6
Georgia,2015,6,4733228,61.0,4444943,57.3,288285,6.1
Hawaii,2015,6,669943,61.7,647039,59.6,22904,3.4
Idaho,2015,6,795165,63.9,763973,61.4,31192,3.9
Illinois,2015,6,6510435,64.8,6121275,60.9,389160,6.0
Indiana,2015,6,3258941,63.7,3105042,60.7,153899,4.7
Iowa,2015,6,1698838,69.9,1636400,67.3,62438,3.7
Kansas,2015,6,1492703,67.7,1429837,64.9,62866,4.2
Kentucky,2015,6,1975226,57.4,1872397,54.4,102829,5.2
Louisiana,2015,6,2152853,60.4,2017960,56.6,134893,6.3
Maine,2015,6,687442,63.0,657285,60.3,30157,4.4
Maryland,2015,6,3142915,66.9,2985301,63.6,157614,5.0
Massachusetts,2015,6,3591258,65.3,3418552,62.1,172706,4.8
Michigan,2015,6,4754815,60.3,4494018,57.0,260797,5.5
Minnesota,2015,6,3007688,70.3,2894004,67.6,113684,3.8
Mississippi,2015,6,1260313,55.3,1179455,51.8,80858,6.4
Missouri,2015,6,3057937,64.6,2899170,61.2,158767,5.2
Montana,2015,6,517470,63.6,495452,60.9,22018,4.3
Nebraska,2015,6,1010488,70.2,979862,68.0,30626,3.0
Nevada,2015,6,1397085,62.6,1301068,58.3,96017,6.9
New Hampshire,2015,6,745526,68.5,719859,66.1,25667,3.4
New Jersey,2015,6,4495690,64.1,4234299,60.4,261391,5.8
New Mexico,2015,6,939351,58.3,876434,54.4,62917,6.7
New York,2015,6,9543550,60.7,9038865,57.5,504685,5.3
New York city,2015,6,4091095,60.2,3863788,56.8,227307,5.6
North Carolina,2015,6,4765102,61.2,4489001,57.7,276101,5.8
North Dakota,2015,6,409780,70.5,398126,68.5,11654,2.8
Ohio,2015,6,5709322,62.6,5428877,59.5,280445,4.9
Oklahoma,2015,6,1833226,61.7,1753090,59.0,80136,4.4
Oregon,2015,6,1974615,61.5,1865067,58.1,109548,5.5
Pennsylvania,2015,6,6421791,62.9,6073881,59.5,347910,5.4
Rhode Island,2015,6,555818,65.0,522251,61.0,33567,6.0
South Carolina,2015,6,2268969,59.4,2133764,55.9,135205,6.0
South Dakota,2015,6,453071,69.9,439062,67.8,14009,3.1
Tennessee,2015,6,3073789,59.6,2899547,56.2,174242,5.7
Texas,2015,6,13072586,63.8,12493882,61.0,578704,4.4
Utah,2015,6,1452297,67.9,1400856,65.5,51441,3.5
Vermont,2015,6,346525,67.3,334255,64.9,12270,3.5
Virginia,2015,6,4234686,65.2,4047714,62.3,186972,4.4
Washington,2015,6,3550112,63.3,3359187,59.8,190925,5.4
West Virginia,2015,6,793269,53.6,739251,49.9,54018,6.8
Wisconsin,2015,6,3079718,67.8,2943053,64.8,136665,4.4
Wyoming,2015,6,302119,66.9,289316,64.1,12803,4.2
Alabama,2015,7,2149701,56.6,2017218,53.1,132483,6.2
Alaska,2015,7,362134,66.8,339558,62.6,22576,6.2
Arizona,2015,7,3187178,60.4,2993303,56.7,193875,6.1
Arkansas,2015,7,1339927,58.3,1273942,55.4,65985,4.9
California,2015,7,18816836,62.1,17658045,58.3,1158791,6.2
Los Angeles County,2015,7,4963813,62.1,4637564,58.0,326249,6.6
Colorado,2015,7,2823037,66.6,2719557,64.2,103480,3.7
Connecticut,2015,7,1889106,65.8,1784137,62.1,104969,5.6
Delaware,2015,7,463176,62.1,441109,59.1,22067,4.8
District of Columbia,2015,7,388585,69.7,362003,64.9,26582,6.8
Florida,2015,7,9637406,59.2,9108581,56.0,528825,5.5
Georgia,2015,7,4730359,60.9,4446220,57.3,284139,6.0
Hawaii,2015,7,670277,61.7,647849,59.6,22428,3.3
Idaho,2015,7,796345,63.9,765212,61.4,31133,3.9
Illinois,2015,7,6511967,64.8,6125787,60.9,386180,5.9
Indiana,2015,7,3264081,63.8,3112811,60.8,151270,4.6
Iowa,2015,7,1697034,69.8,1635142,67.2,61892,3.6
Kansas,2015,7,1492465,67.7,1431085,64.9,61380,4.1
Kentucky,2015,7,1974094,57.3,1871994,54.4,102100,5.2
Louisiana,2015,7,2146855,60.2,2014908,56.5,131947,6.1
Maine,2015,7,686253,62.9,656874,60.2,29379,4.3
Maryland,2015,7,3141732,66.9,2986335,63.5,155397,4.9
Massachusetts,2015,7,3587263,65.1,3417329,62.1,169934,4.7
Michigan,2015,7,4756256,60.3,4501568,57.1,254688,5.4
Minnesota,2015,7,3008042,70.2,2894625,67.6,113417,3.8
Mississippi,2015,7,1260827,55.3,1180794,51.8,80033,6.3
Missouri,2015,7,3056934,64.5,2902982,61.3,153952,5.0
Montana,2015,7,517499,63.5,495460,60.8,22039,4.3
Nebraska,2015,7,1011241,70.2,980537,68.0,30704,3.0
Nevada,2015,7,1397589,62.5,1302948,58.3,94641,6.8
New Hampshire,2015,7,744639,68.4,719711,66.1,24928,3.3
New Jersey,2015,7,4490941,64.0,4237324,60.4,253617,5.6
New Mexico,2015,7,938492,58.3,876122,54.4,62370,6.6
New York,2015,7,9534767,60.7,9043435,57.5,491332,5.2
New York city,2015,7,4083676,60.0,3863955,56.8,219721,5.4
North Carolina,2015,7,4767689,61.2,4494279,57.7,273410,5.7
North Dakota,2015,7,409442,70.4,397805,68.4,11637,2.8
Ohio,2015,7,5704862,62.5,5429949,59.5,274913,4.8
Oklahoma,2015,7,1831607,61.6,1751708,58.9,79899,4.4
Oregon,2015,7,1979176,61.6,1871082,58.2,108094,5.5
Pennsylvania,2015,7,6424397,62.9,6079630,59.5,344767,5.4
Rhode Island,2015,7,554698,64.8,521895,61.0,32803,5.9
South Carolina,2015,7,2268743,59.3,2136969,55.9,131774,5.8
South Dakota,2015,7,452987,69.9,439168,67.8,13819,3.1
Tennessee,2015,7,3075793,59.6,2905360,56.3,170433,5.5
Texas,2015,7,13083798,63.7,12503348,60.9,580450,4.4
Utah,2015,7,1455143,68.0,1403612,65.6,51531,3.5
Vermont,2015,7,345899,67.2,333746,64.8,12153,3.5
Virginia,2015,7,4231177,65.1,4049219,62.3,181958,4.3
Washington,2015,7,3554656,63.2,3363984,59.8,190672,5.4
West Virginia,2015,7,791959,53.5,738717,49.9,53242,6.7
Wisconsin,2015,7,3079639,67.7,2945129,64.8,134510,4.4
Wyoming,2015,7,301719,66.8,288919,64.0,12800,4.2
Alabama,2015,8,2142296,56.4,2010491,52.9,131805,6.2
Alaska,2015,8,361851,66.6,339307,62.5,22544,6.2
Arizona,2015,8,3190286,60.3,2997349,56.7,192937,6.0
Arkansas,2015,8,1339528,58.2,1275545,55.4,63983,4.8
California,2015,8,18810236,62.0,17674840,58.3,1135396,6.0
Los Angeles County,2015,8,4953341,61.9,4638825,58.0,314516,6.3
Colorado,2015,8,2825443,66.5,2724952,64.2,100491,3.6
Connecticut,2015,8,1886215,65.7,1782474,62.0,103741,5.5
Delaware,2015,8,464036,62.1,442091,59.2,21945,4.7
District of Columbia,2015,8,389198,69.7,362893,65.0,26305,6.8
Florida,2015,8,9648341,59.2,9126443,56.0,521898,5.4
Georgia,2015,8,4728148,60.8,4447634,57.2,280514,5.9
Hawaii,2015,8,670776,61.7,648736,59.7,22040,3.3
Idaho,2015,8,797404,63.9,766369,61.4,31035,3.9
Illinois,2015,8,6513391,64.8,6128765,61.0,384626,5.9
Indiana,2015,8,3269717,63.9,3120334,60.9,149383,4.6
Iowa,2015,8,1696005,69.7,1634411,67.2,61594,3.6
Kansas,2015,8,1492607,67.7,1432469,64.9,60138,4.0
Kentucky,2015,8,1974414,57.3,1872627,54.3,101787,5.2
Louisiana,2015,8,2141096,60.0,2011545,56.3,129551,6.1
Maine,2015,8,685224,62.8,656502,60.1,28722,4.2
Maryland,2015,8,3140095,66.8,2986765,63.5,153330,4.9
Massachusetts,2015,8,3583181,65.0,3415653,62.0,167528,4.7
Michigan,2015,8,4758144,60.3,4509543,57.2,248601,5.2
Minnesota,2015,8,3007887,70.2,2894759,67.5,113128,3.8
Mississippi,2015,8,1261680,55.3,1181932,51.8,79748,6.3
Missouri,2015,8,3056343,64.5,2906823,61.4,149520,4.9
Montana,2015,8,517775,63.5,495684,60.8,22091,4.3
Nebraska,2015,8,1012103,70.2,981413,68.1,30690,3.0
Nevada,2015,8,1398013,62.4,1304599,58.2,93414,6.7
New Hampshire,2015,8,744174,68.3,719896,66.0,24278,3.3
New Jersey,2015,8,4486690,64.0,4240738,60.5,245952,5.5
New Mexico,2015,8,937602,58.2,875731,54.3,61871,6.6
New York,2015,8,9527129,60.6,9047482,57.6,479647,5.0
New York city,2015,8,4077619,59.9,3863668,56.8,213951,5.2
North Carolina,2015,8,4769911,61.1,4500058,57.7,269853,5.7
North Dakota,2015,8,409372,70.4,397788,68.4,11584,2.8
Ohio,2015,8,5700670,62.4,5429438,59.5,271232,4.8
Oklahoma,2015,8,1829635,61.5,1750196,58.8,79439,4.3
Oregon,2015,8,1983912,61.6,1877482,58.3,106430,5.4
Pennsylvania,2015,8,6426714,62.9,6084814,59.5,341900,5.3
Rhode Island,2015,8,553720,64.7,521546,60.9,32174,5.8
South Carolina,2015,8,2268472,59.2,2139758,55.9,128714,5.7
South Dakota,2015,8,452923,69.8,439326,67.7,13597,3.0
Tennessee,2015,8,3077329,59.6,2910795,56.4,166534,5.4
Texas,2015,8,13096567,63.7,12512227,60.8,584340,4.5
Utah,2015,8,1457886,67.9,1406235,65.5,51651,3.5
Vermont,2015,8,345384,67.1,333349,64.7,12035,3.5
Virginia,2015,8,4227968,65.0,4050212,62.3,177756,4.2
Washington,2015,8,3559448,63.2,3368239,59.8,191209,5.4
West Virginia,2015,8,790409,53.4,738212,49.9,52197,6.6
Wisconsin,2015,8,3080585,67.7,2947761,64.8,132824,4.3
Wyoming,2015,8,301250,66.7,288478,63.9,12772,4.2
Alabama,2015,9,2136055,56.2,2004972,52.7,131083,6.1
Alaska,2015,9,361622,66.6,339036,62.4,22586,6.2
Arizona,2015,9,3193508,60.3,3002093,56.7,191415,6.0
Arkansas,2015,9,1339273,58.2,1277195,55.5,62078,4.6
California,2015,9,18810658,62.0,17695331,58.3,1115327,5.9
Los Angeles County,2015,9,4946956,61.8,4642593,58.0,304363,6.2
Colorado,2015,9,2829407,66.5,2731343,64.2,98064,3.5
Connecticut,2015,9,1884305,65.6,1781625,62.0,102680,5.4
Delaware,2015,9,464940,62.2,443116,59.2,21824,4.7
District of Columbia,2015,9,389790,69.7,363732,65.0,26058,6.7
Florida,2015,9,9661738,59.1,9146394,56.0,515344,5.3
Georgia,2015,9,4727779,60.7,4450420,57.2,277359,5.9
Hawaii,2015,9,671504,61.7,649824,59.7,21680,3.2
Idaho,2015,9,798413,63.8,767529,61.3,30884,3.9
Illinois,2015,9,6517227,64.8,6132095,61.0,385132,5.9
Indiana,2015,9,3276546,64.0,3128292,61.1,148254,4.5
Iowa,2015,9,1696155,69.7,1634605,67.2,61550,3.6
Kansas,2015,9,1493272,67.7,1433984,65.0,59288,4.0
Kentucky,2015,9,1976725,57.3,1874730,54.4,101995,5.2
Louisiana,2015,9,2136562,59.8,2008611,56.2,127951,6.0
Maine,2015,9,684534,62.7,656347,60.1,28187,4.1
Maryland,2015,9,3138851,66.7,2987744,63.5,151107,4.8
Massachusetts,2015,9,3580147,64.9,3414849,61.9,165298,4.6
Michigan,2015,9,4761803,60.4,4518849,57.3,242954,5.1
Minnesota,2015,9,3008335,70.1,2895504,67.5,112831,3.8
Mississippi,2015,9,1263353,55.4,1183427,51.9,79926,6.3
Missouri,2015,9,3056675,64.5,2911038,61.4,145637,4.8
Montana,2015,9,518275,63.5,496124,60.8,22151,4.3
Nebraska,2015,9,1013086,70.2,982465,68.1,30621,3.0
Nevada,2015,9,1398568,62.3,1306362,58.2,92206,6.6
New Hampshire,2015,9,744217,68.2,720547,66.0,23670,3.2
New Jersey,2015,9,4483815,63.9,4245263,60.5,238552,5.3
New Mexico,2015,9,936945,58.1,875502,54.3,61443,6.6
New York,2015,9,9523717,60.6,9053257,57.6,470460,4.9
New York city,2015,9,4074208,59.9,3863725,56.8,210483,5.2
North Carolina,2015,9,4772715,61.1,4506791,57.7,265924,5.6
North Dakota,2015,9,409549,70.4,397992,68.4,11557,2.8
Ohio,2015,9,5698995,62.4,5428901,59.4,270094,4.7
Oklahoma,2015,9,1828048,61.4,1749022,58.8,79026,4.3
Oregon,2015,9,1989069,61.6,1884395,58.4,104674,5.3
Pennsylvania,2015,9,6429981,62.9,6090516,59.6,339465,5.3
Rhode Island,2015,9,552928,64.6,521239,60.9,31689,5.7
South Carolina,2015,9,2268967,59.2,2142840,55.9,126127,5.6
South Dakota,2015,9,452976,69.8,439607,67.7,13369,3.0
Tennessee,2015,9,3079250,59.6,2916889,56.4,162361,5.3
Texas,2015,9,13111812,63.7,12523886,60.8,587926,4.5
Utah,2015,9,1460802,67.9,1409096,65.5,51706,3.5
Vermont,2015,9,345015,67.0,333114,64.7,11901,3.4
Virginia,2015,9,4225421,64.9,4050900,62.3,174521,4.1
Washington,2015,9,3565425,63.2,3373358,59.8,192067,5.4
West Virginia,2015,9,789048,53.3,737859,49.9,51189,6.5
Wisconsin,2015,9,3082966,67.8,2951433,64.9,131533,4.3
Wyoming,2015,9,300853,66.6,288034,63.8,12819,4.3
Alabama,2015,10,2135797,56.1,2005232,52.7,130565,6.1
Alaska,2015,10,361498,66.5,338801,62.3,22697,6.3
Arizona,2015,10,3198236,60.3,3008840,56.7,189396,5.9
Arkansas,2015,10,1339813,58.2,1279410,55.6,60403,4.5
California,2015,10,18824385,62.0,17724466,58.4,1099919,5.8
Los Angeles County,2015,10,4947103,61.8,4650785,58.1,296318,6.0
Colorado,2015,10,2835695,66.5,2739313,64.3,96382,3.4
Connecticut,2015,10,1883557,65.5,1781801,62.0,101756,5.4
Delaware,2015,10,465959,62.2,444262,59.3,21697,4.7
District of Columbia,2015,10,390400,69.7,364559,65.1,25841,6.6
Florida,2015,10,9679856,59.1,9170460,56.0,509396,5.3
Georgia,2015,10,4730976,60.7,4456067,57.2,274909,5.8
Hawaii,2015,10,672548,61.8,651209,59.8,21339,3.2
Idaho,2015,10,799645,63.8,768912,61.3,30733,3.8
Illinois,2015,10,6526537,64.9,6138315,61.1,388222,5.9
Indiana,2015,10,3286118,64.1,3137870,61.2,148248,4.5
Iowa,2015,10,1697907,69.7,1636189,67.2,61718,3.6
Kansas,2015,10,1494509,67.7,1435575,65.0,58934,3.9
Kentucky,2015,10,1981083,57.4,1878391,54.5,102692,5.2
Louisiana,2015,10,2134141,59.7,2006830,56.1,127311,6.0
Maine,2015,10,684485,62.7,656665,60.1,27820,4.1
Maryland,2015,10,3139081,66.7,2990357,63.6,148724,4.7
Massachusetts,2015,10,3579727,64.9,3416493,61.9,163234,4.6
Michigan,2015,10,4769314,60.4,4530470,57.4,238844,5.0
Minnesota,2015,10,3010487,70.1,2897657,67.5,112830,3.7
Mississippi,2015,10,1265802,55.5,1185416,52.0,80386,6.4
Missouri,2015,10,3058618,64.5,2916130,61.5,142488,4.7
Montana,2015,10,519031,63.5,496790,60.8,22241,4.3
Nebraska,2015,10,1014321,70.2,983776,68.1,30545,3.0
Nevada,2015,10,1399703,62.3,1308661,58.2,91042,6.5
New Hampshire,2015,10,744823,68.2,721725,66.1,23098,3.1
New Jersey,2015,10,4484030,63.9,4251866,60.6,232164,5.2
New Mexico,2015,10,936887,58.1,875740,54.3,61147,6.5
New York,2015,10,9527500,60.6,9062751,57.6,464749,4.9
New York city,2015,10,4074608,59.9,3865040,56.8,209568,5.1
North Carolina,2015,10,4778016,61.0,4515716,57.7,262300,5.5
North Dakota,2015,10,409944,70.5,398304,68.5,11640,2.8
Ohio,2015,10,5702644,62.4,5430886,59.4,271758,4.8
Oklahoma,2015,10,1827831,61.4,1748766,58.7,79065,4.3
Oregon,2015,10,1995491,61.7,1892430,58.5,103061,5.2
Pennsylvania,2015,10,6436573,63.0,6098624,59.7,337949,5.3
Rhode Island,2015,10,552438,64.5,521094,60.8,31344,5.7
South Carolina,2015,10,2271292,59.1,2147013,55.9,124279,5.5
South Dakota,2015,10,453249,69.7,440079,67.7,13170,2.9
Tennessee,2015,10,3083238,59.6,2925088,56.5,158150,5.1
Texas,2015,10,13133423,63.7,12543363,60.8,590060,4.5
Utah,2015,10,1464379,67.9,1412676,65.5,51703,3.5
Vermont,2015,10,344859,66.9,333101,64.7,11758,3.4
Virginia,2015,10,4224998,64.9,4052719,62.3,172279,4.1
Washington,2015,10,3573801,63.2,3380768,59.8,193033,5.4
West Virginia,2015,10,788329,53.3,737853,49.9,50476,6.4
Wisconsin,2015,10,3087350,67.8,2956772,65.0,130578,4.2
Wyoming,2015,10,300679,66.6,287649,63.7,13030,4.3
Alabama,2015,11,2127937,55.9,1997567,52.5,130370,6.1
Alaska,2015,11,361518,66.4,338641,62.2,22877,6.3
Arizona,2015,11,3204955,60.3,3017642,56.8,187313,5.8
Arkansas,2015,11,1341300,58.2,1282346,55.7,58954,4.4
California,2015,11,18852382,62.0,17762494,58.4,1089888,5.8
Los Angeles County,2015,11,4954062,61.8,4663718,58.2,290344,5.9
Colorado,2015,11,2844179,66.6,2748716,64.4,95463,3.4
Connecticut,2015,11,1883966,65.6,1782985,62.0,100981,5.4
Delaware,2015,11,467051,62.3,445489,59.4,21562,4.6
District of Columbia,2015,11,391107,69.8,365451,65.2,25656,6.6
Florida,2015,11,9702643,59.2,9198031,56.1,504612,5.2
Georgia,2015,11,4737800,60.7,4464354,57.2,273446,5.8
Hawaii,2015,11,673778,61.8,652737,59.9,21041,3.1
Idaho,2015,11,801327,63.8,770672,61.4,30655,3.8
Illinois,2015,11,6542574,65.1,6148366,61.2,394208,6.0
Indiana,2015,11,3298722,64.3,3149094,61.4,149628,4.5
Iowa,2015,11,1701237,69.8,1639252,67.3,61985,3.6
Kansas,2015,11,1496037,67.7,1437062,65.1,58975,3.9
Kentucky,2015,11,1986651,57.6,1883128,54.6,103523,5.2
Louisiana,2015,11,2133748,59.7,2006151,56.1,127597,6.0
Maine,2015,11,685200,62.7,657554,60.2,27646,4.0
Maryland,2015,11,3141039,66.7,2994693,63.6,146346,4.7
Massachusetts,2015,11,3582932,64.9,3421499,62.0,161433,4.5
Michigan,2015,11,4781113,60.5,4544206,57.5,236907,5.0
Minnesota,2015,11,3014550,70.2,2901181,67.5,113369,3.8
Mississippi,2015,11,1268447,55.6,1187642,52.1,80805,6.4
Missouri,2015,11,3062018,64.6,2921813,61.6,140205,4.6
Montana,2015,11,519981,63.6,497588,60.8,22393,4.3
Nebraska,2015,11,1015747,70.3,985231,68.2,30516,3.0
Nevada,2015,11,1401563,62.2,1311565,58.2,89998,6.4
New Hampshire,2015,11,746012,68.3,723418,66.2,22594,3.0
New Jersey,2015,11,4487793,63.9,4260009,60.7,227784,5.1
New Mexico,2015,11,937588,58.1,876509,54.3,61079,6.5
New York,2015,11,9537575,60.6,9074704,57.7,462871,4.9
New York city,2015,11,4078186,59.9,3867407,56.8,210779,5.2
North Carolina,2015,11,4787250,61.1,4527769,57.8,259481,5.4
North Dakota,2015,11,410486,70.6,398595,68.5,11891,2.9
Ohio,2015,11,5713128,62.5,5437112,59.5,276016,4.8
Oklahoma,2015,11,1829254,61.4,1749506,58.7,79748,4.4
Oregon,2015,11,2003622,61.9,1901807,58.7,101815,5.1
Pennsylvania,2015,11,6446815,63.1,6108866,59.7,337949,5.2
Rhode Island,2015,11,552327,64.5,521203,60.8,31124,5.6
South Carolina,2015,11,2275676,59.2,2152291,55.9,123385,5.4
South Dakota,2015,11,453718,69.7,440691,67.7,13027,2.9
Tennessee,2015,11,3090043,59.7,2935651,56.7,154392,5.0
Texas,2015,11,13162283,63.7,12571333,60.8,590950,4.5
Utah,2015,11,1468832,68.0,1417067,65.6,51765,3.5
Vermont,2015,11,344913,66.9,333306,64.7,11607,3.4
Virginia,2015,11,4227185,64.9,4056317,62.3,170868,4.0
Washington,2015,11,3585005,63.3,3390788,59.9,194217,5.4
West Virginia,2015,11,788344,53.3,738192,49.9,50152,6.4
Wisconsin,2015,11,3093448,67.9,2963483,65.1,129965,4.2
Wyoming,2015,11,300834,66.6,287332,63.6,13502,4.5
Alabama,2015,12,2133700,56.0,2003525,52.6,130175,6.1
Alaska,2015,12,361660,66.4,338572,62.2,23088,6.4
Arizona,2015,12,3212709,60.3,3027448,56.8,185261,5.8
Arkansas,2015,12,1343071,58.3,1285465,55.8,57606,4.3
California,2015,12,18886247,62.1,17804150,58.5,1082097,5.7
Los Angeles County,2015,12,4964532,61.9,4679301,58.4,285231,5.7
Colorado,2015,12,2853704,66.7,2758635,64.5,95069,3.3
Connecticut,2015,12,1884911,65.6,1784830,62.1,100081,5.3
Delaware,2015,12,468016,62.4,446642,59.6,21374,4.6
District of Columbia,2015,12,391856,69.8,366441,65.3,25415,6.5
Florida,2015,12,9726210,59.2,9226214,56.2,499996,5.1
Georgia,2015,12,4745734,60.7,4473442,57.2,272292,5.7
Hawaii,2015,12,674900,61.9,654135,60.0,20765,3.1
Idaho,2015,12,803322,63.8,772741,61.4,30581,3.8
Illinois,2015,12,6561973,65.3,6160489,61.3,401484,6.1
Indiana,2015,12,3312477,64.6,3160677,61.6,151800,4.6
Iowa,2015,12,1705328,70.0,1643195,67.4,62133,3.6
Kansas,2015,12,1497255,67.8,1438196,65.1,59059,3.9
Kentucky,2015,12,1992217,57.7,1888233,54.7,103984,5.2
Louisiana,2015,12,2134220,59.7,2005983,56.1,128237,6.0
Maine,2015,12,686446,62.8,658891,60.3,27555,4.0
Maryland,2015,12,3143703,66.8,2999779,63.7,143924,4.6
Massachusetts,2015,12,3588507,65.0,3428990,62.1,159517,4.4
Michigan,2015,12,4795181,60.7,4558668,57.7,236513,4.9
Minnesota,2015,12,3019343,70.2,2905253,67.6,114090,3.8
Mississippi,2015,12,1270497,55.7,1189803,52.1,80694,6.4
Missouri,2015,12,3065552,64.6,2927136,61.7,138416,4.5
Montana,2015,12,520883,63.6,498325,60.8,22558,4.3
Nebraska,2015,12,1017042,70.3,986563,68.2,30479,3.0
Nevada,2015,12,1403650,62.2,1314754,58.3,88896,6.3
New Hampshire,2015,12,747531,68.4,725396,66.4,22135,3.0
New Jersey,2015,12,4493120,64.0,4267692,60.8,225428,5.0
New Mexico,2015,12,938775,58.2,877628,54.4,61147,6.5
New York,2015,12,9548386,60.7,9085645,57.8,462741,4.8
New York city,2015,12,4082040,60.0,3869753,56.9,212287,5.2
North Carolina,2015,12,4798884,61.2,4541877,57.9,257007,5.4
North Dakota,2015,12,411033,70.7,398772,68.6,12261,3.0
Ohio,2015,12,5728436,62.7,5446975,59.6,281461,4.9
Oklahoma,2015,12,1831352,61.4,1750553,58.7,80799,4.4
Oregon,2015,12,2012522,62.0,1911765,58.9,100757,5.0
Pennsylvania,2015,12,6458131,63.2,6118943,59.8,339188,5.3
Rhode Island,2015,12,552428,64.5,521489,60.8,30939,5.6
South Carolina,2015,12,2280829,59.2,2157985,56.0,122844,5.4
South Dakota,2015,12,454211,69.8,441285,67.8,12926,2.8
Tennessee,2015,12,3098156,59.8,2947080,56.8,151076,4.9
Texas,2015,12,13194306,63.8,12603859,60.9,590447,4.5
Utah,2015,12,1473799,68.1,1421939,65.7,51860,3.5
Vermont,2015,12,345067,67.0,333646,64.8,11421,3.3
Virginia,2015,12,4230228,64.9,4060702,62.3,169526,4.0
Washington,2015,12,3597830,63.5,3402683,60.0,195147,5.4
West Virginia,2015,12,788821,53.4,738713,50.0,50108,6.4
Wisconsin,2015,12,3099913,68.1,2970598,65.2,129315,4.2
Wyoming,2015,12,301280,66.7,287030,63.6,14250,4.7
Alabama,2016,1,2138981,56.2,2009234,52.8,129747,6.1
Alaska,2016,1,361853,66.4,338581,62.1,23272,6.4
Arizona,2016,1,3220542,60.4,3037144,56.9,183398,5.7
Arkansas,2016,1,1344484,58.3,1288132,55.9,56352,4.2
California,2016,1,18917326,62.1,17843140,58.6,1074186,5.7
Los Angeles County,2016,1,4974853,62.0,4694698,58.5,280155,5.6
Colorado,2016,1,2862652,66.8,2767788,64.6,94864,3.3
Connecticut,2016,1,1885910,65.6,1787016,62.2,98894,5.2
Delaware,2016,1,468654,62.4,447512,59.6,21142,4.5
District of Columbia,2016,1,392658,69.9,367573,65.4,25085,6.4
Florida,2016,1,9746916,59.2,9252093,56.2,494823,5.1
Georgia,2016,1,4752310,60.7,4481522,57.2,270788,5.7
Hawaii,2016,1,675700,61.9,655187,60.0,20513,3.0
Idaho,2016,1,805322,63.9,774854,61.5,30468,3.8
Illinois,2016,1,6579309,65.5,6171894,61.4,407415,6.2
Indiana,2016,1,3324395,64.8,3170641,61.8,153754,4.6
Iowa,2016,1,1708738,70.1,1646660,67.6,62078,3.6
Kansas,2016,1,1497864,67.8,1438842,65.1,59022,3.9
Kentucky,2016,1,1996889,57.8,1893069,54.8,103820,5.2
Louisiana,2016,1,2134557,59.7,2005777,56.1,128780,6.0
Maine,2016,1,687907,62.9,660486,60.4,27421,4.0
Maryland,2016,1,3145817,66.8,3004440,63.8,141377,4.5
Massachusetts,2016,1,3594084,65.0,3436899,62.2,157185,4.4
Michigan,2016,1,4808822,60.9,4571961,57.9,236861,4.9
Minnesota,2016,1,3022956,70.3,2908419,67.6,114537,3.8
Mississippi,2016,1,1271520,55.7,1191631,52.2,79889,6.3
Missouri,2016,1,3068547,64.7,2931518,61.8,137029,4.5
Montana,2016,1,521545,63.6,498852,60.9,22693,4.4
Nebraska,2016,1,1018062,70.3,987626,68.2,30436,3.0
Nevada,2016,1,1405588,62.2,1317857,58.3,87731,6.2
New Hampshire,2016,1,749043,68.5,727313,66.5,21730,2.9
New Jersey,2016,1,4497590,64.1,4273085,60.9,224505,5.0
New Mexico,2016,1,940030,58.2,878770,54.4,61260,6.5
New York,2016,1,9554664,60.8,9092379,57.8,462285,4.8
New York city,2016,1,4083880,60.0,3871169,56.9,212711,5.2
North Carolina,2016,1,4810316,61.2,4555925,58.0,254391,5.3
North Dakota,2016,1,411466,70.8,398799,68.6,12667,3.1
Ohio,2016,1,5743731,62.8,5457717,59.7,286014,5.0
Oklahoma,2016,1,1832930,61.4,1751007,58.7,81923,4.5
Oregon,2016,1,2020991,62.2,1921114,59.1,99877,4.9
Pennsylvania,2016,1,6467536,63.2,6126634,59.9,340902,5.3
Rhode Island,2016,1,552571,64.5,521873,60.9,30698,5.6
South Carolina,2016,1,2285355,59.2,2163254,56.1,122101,5.3
South Dakota,2016,1,454613,69.8,441752,67.8,12861,2.8
Tennessee,2016,1,3105686,59.9,2957506,57.0,148180,4.8
Texas,2016,1,13224910,63.8,12635778,61.0,589132,4.5
Utah,2016,1,1478801,68.2,1426877,65.8,51924,3.5
Vermont,2016,1,345245,67.0,334036,64.8,11209,3.2
Virginia,2016,1,4232843,64.9,4065106,62.3,167737,4.0
Washington,2016,1,3610474,63.6,3415138,60.1,195336,5.4
West Virginia,2016,1,789352,53.4,739186,50.0,50166,6.4
Wisconsin,2016,1,3105263,68.2,2977051,65.3,128212,4.1
Wyoming,2016,1,301853,66.9,286696,63.5,15157,5.0
Alabama,2016,2,2143456,56.3,2014380,52.9,129076,6.0
Alaska,2016,2,362043,66.4,338619,62.1,23424,6.5
Arizona,2016,2,3227960,60.4,3046025,57.0,181935,5.6
Arkansas,2016,2,1345263,58.3,1289972,55.9,55291,4.1
California,2016,2,18941962,62.2,17875645,58.7,1066317,5.6
Los Angeles County,2016,2,4983669,62.1,4708465,58.7,275204,5.5
Colorado,2016,2,2870218,66.9,2775432,64.7,94786,3.3
Connecticut,2016,2,1886939,65.7,1789442,62.3,97497,5.2
Delaware,2016,2,468905,62.4,447972,59.6,20933,4.5
District of Columbia,2016,2,393390,70.0,368673,65.6,24717,6.3
Florida,2016,2,9763853,59.2,9274276,56.3,489577,5.0
Georgia,2016,2,4756401,60.7,4487435,57.2,268966,5.7
Hawaii,2016,2,676234,61.9,655874,60.1,20360,3.0
Idaho,2016,2,807148,63.9,776822,61.5,30326,3.8
Illinois,2016,2,6590470,65.6,6180514,61.5,409956,6.2
Indiana,2016,2,3332857,64.9,3178012,61.9,154845,4.6
Iowa,2016,2,1710383,70.2,1648419,67.6,61964,3.6
Kansas,2016,2,1497789,67.7,1438855,65.1,58934,3.9
Kentucky,2016,2,2000307,57.9,1897358,54.9,102949,5.1
Louisiana,2016,2,2134491,59.6,2005278,56.0,129213,6.1
Maine,2016,2,689398,63.1,662178,60.6,27220,3.9
Maryland,2016,2,3146807,66.8,3007840,63.9,138967,4.4
Massachusetts,2016,2,3598443,65.1,3443921,62.3,154522,4.3
Michigan,2016,2,4820513,61.0,4582714,58.0,237799,4.9
Minnesota,2016,2,3024171,70.3,2909497,67.6,114674,3.8
Mississippi,2016,2,1271510,55.7,1192863,52.3,78647,6.2
Missouri,2016,2,3070971,64.7,2934662,61.8,136309,4.4
Montana,2016,2,521898,63.6,499113,60.8,22785,4.4
Nebraska,2016,2,1018720,70.4,988278,68.2,30442,3.0
Nevada,2016,2,1407222,62.2,1320668,58.4,86554,6.2
New Hampshire,2016,2,750386,68.6,728939,66.6,21447,2.9
New Jersey,2016,2,4500079,64.1,4275593,60.9,224486,5.0
New Mexico,2016,2,941120,58.3,879654,54.5,61466,6.5
New York,2016,2,9553707,60.8,9092674,57.8,461033,4.8
New York city,2016,2,4082937,60.0,3871026,56.9,211911,5.2
North Carolina,2016,2,4819869,61.3,4568181,58.1,251688,5.2
North Dakota,2016,2,411741,70.8,398708,68.6,13033,3.2
Ohio,2016,2,5754850,62.9,5466498,59.8,288352,5.0
Oklahoma,2016,2,1833389,61.4,1750363,58.7,83026,4.5
Oregon,2016,2,2028181,62.3,1928738,59.3,99443,4.9
Pennsylvania,2016,2,6473118,63.3,6130276,59.9,342842,5.3
Rhode Island,2016,2,552733,64.5,522325,60.9,30408,5.5
South Carolina,2016,2,2288411,59.2,2167393,56.1,121018,5.3
South Dakota,2016,2,454907,69.8,442042,67.8,12865,2.8
Tennessee,2016,2,3111657,59.9,2965602,57.1,146055,4.7
Texas,2016,2,13252003,63.8,12662766,61.0,589237,4.4
Utah,2016,2,1483530,68.3,1431601,65.9,51929,3.5
Vermont,2016,2,345423,67.1,334400,64.9,11023,3.2
Virginia,2016,2,4234522,64.9,4068700,62.3,165822,3.9
Washington,2016,2,3621594,63.7,3426657,60.2,194937,5.4
West Virginia,2016,2,789436,53.5,739332,50.1,50104,6.3
Wisconsin,2016,2,3108750,68.2,2981909,65.4,126841,4.1
Wyoming,2016,2,302351,67.0,286294,63.4,16057,5.3
Alabama,2016,3,2146821,56.3,2018777,53.0,128044,6.0
Alaska,2016,3,362120,66.4,338578,62.1,23542,6.5
Arizona,2016,3,3234359,60.4,3053620,57.1,180739,5.6
Arkansas,2016,3,1345319,58.3,1290874,55.9,54445,4.0
California,2016,3,18959258,62.2,17901022,58.7,1058236,5.6
Los Angeles County,2016,3,4991086,62.2,4720610,58.8,270476,5.4
Colorado,2016,3,2876122,66.9,2781378,64.7,94744,3.3
Connecticut,2016,3,1888081,65.7,1792129,62.4,95952,5.1
Delaware,2016,3,468851,62.4,448073,59.6,20778,4.4
District of Columbia,2016,3,393876,70.0,369514,65.6,24362,6.2
Florida,2016,3,9777290,59.2,9292824,56.3,484466,5.0
Georgia,2016,3,4796311,61.1,4529480,57.7,266831,5.6
Hawaii,2016,3,676608,62.0,656314,60.1,20294,3.0
Idaho,2016,3,808719,63.9,778561,61.5,30158,3.7
Illinois,2016,3,6593404,65.6,6185600,61.6,407804,6.2
Indiana,2016,3,3337674,65.0,3183002,61.9,154672,4.6
Iowa,2016,3,1710050,70.1,1648133,67.6,61917,3.6
Kansas,2016,3,1496952,67.7,1438043,65.0,58909,3.9
Kentucky,2016,3,2002784,58.0,1901323,55.0,101461,5.1
Louisiana,2016,3,2133521,59.6,2004061,56.0,129460,6.1
Maine,2016,3,690787,63.2,663837,60.7,26950,3.9
Maryland,2016,3,3146772,66.8,3009911,63.9,136861,4.3
Massachusetts,2016,3,3601685,65.1,3450057,62.4,151628,4.2
Michigan,2016,3,4829629,61.1,4590535,58.1,239094,5.0
Minnesota,2016,3,3023055,70.2,2908446,67.5,114609,3.8
Mississippi,2016,3,1270710,55.7,1193455,52.3,77255,6.1
Missouri,2016,3,3072852,64.7,2936300,61.8,136552,4.4
Montana,2016,3,521936,63.6,499124,60.8,22812,4.4
Nebraska,2016,3,1018855,70.3,988365,68.2,30490,3.0
Nevada,2016,3,1408473,62.2,1323153,58.4,85320,6.1
New Hampshire,2016,3,751461,68.6,730123,66.7,21338,2.8
New Jersey,2016,3,4500037,64.1,4275290,60.9,224747,5.0
New Mexico,2016,3,941995,58.3,880148,54.5,61847,6.6
New York,2016,3,9545384,60.7,9086193,57.8,459191,4.8
New York city,2016,3,4079641,59.9,3869320,56.8,210321,5.2
North Carolina,2016,3,4826578,61.3,4577708,58.1,248870,5.2
North Dakota,2016,3,411888,70.9,398605,68.6,13283,3.2
Ohio,2016,3,5759537,63.0,5471393,59.8,288144,5.0
Oklahoma,2016,3,1832699,61.4,1748627,58.6,84072,4.6
Oregon,2016,3,2033640,62.4,1934161,59.3,99479,4.9
Pennsylvania,2016,3,6474416,63.3,6129729,59.9,344687,5.3
Rhode Island,2016,3,552908,64.5,522805,61.0,30103,5.4
South Carolina,2016,3,2289534,59.2,2170026,56.1,119508,5.2
South Dakota,2016,3,455081,69.7,442131,67.8,12950,2.8
Tennessee,2016,3,3116195,60.0,2971290,57.2,144905,4.7
Texas,2016,3,13275533,63.8,12683175,61.0,592358,4.5
Utah,2016,3,1487708,68.3,1435988,66.0,51720,3.5
Vermont,2016,3,345578,67.1,334690,65.0,10888,3.2
Virginia,2016,3,4235332,64.9,4070935,62.4,164397,3.9
Washington,2016,3,3630389,63.7,3436155,60.3,194234,5.4
West Virginia,2016,3,788767,53.4,739023,50.1,49744,6.3
Wisconsin,2016,3,3110352,68.2,2984977,65.5,125375,4.0
Wyoming,2016,3,302567,67.0,285818,63.3,16749,5.5
Alabama,2016,4,2149261,56.4,2022346,53.0,126915,5.9
Alaska,2016,4,362119,66.3,338457,62.0,23662,6.5
Arizona,2016,4,3239833,60.4,3059997,57.1,179836,5.6
Arkansas,2016,4,1344939,58.2,1291027,55.9,53912,4.0
California,2016,4,18973207,62.2,17921613,58.7,1051594,5.5
Los Angeles County,2016,4,4998754,62.2,4731988,58.9,266766,5.3
Colorado,2016,4,2880932,66.9,2786260,64.7,94672,3.3
Connecticut,2016,4,1889305,65.7,1794839,62.5,94466,5.0
Delaware,2016,4,468680,62.3,447969,59.5,20711,4.4
District of Columbia,2016,4,394058,69.9,369933,65.6,24125,6.1
Florida,2016,4,9790156,59.2,9309537,56.3,480619,4.9
Georgia,2016,4,4833906,61.5,4568888,58.1,265018,5.5
Hawaii,2016,4,676978,62.0,656743,60.1,20235,3.0
Idaho,2016,4,810104,63.9,780076,61.5,30028,3.7
Illinois,2016,4,6589117,65.6,6186891,61.6,402226,6.1
Indiana,2016,4,3339764,65.0,3186380,62.0,153384,4.6
Iowa,2016,4,1708496,70.0,1646486,67.5,62010,3.6
Kansas,2016,4,1495476,67.6,1436383,64.9,59093,4.0
Kentucky,2016,4,2005178,58.0,1905194,55.1,99984,5.0
Louisiana,2016,4,2131830,59.5,2002097,55.9,129733,6.1
Maine,2016,4,691999,63.3,665340,60.8,26659,3.9
Maryland,2016,4,3146561,66.8,3011264,63.9,135297,4.3
Massachusetts,2016,4,3604987,65.1,3456132,62.4,148855,4.1
Michigan,2016,4,4836910,61.2,4596471,58.1,240439,5.0
Minnesota,2016,4,3021085,70.1,2906473,67.4,114612,3.8
Mississippi,2016,4,1269674,55.6,1193563,52.3,76111,6.0
Missouri,2016,4,3074491,64.7,2936456,61.8,138035,4.5
Montana,2016,4,521820,63.5,499039,60.7,22781,4.4
Nebraska,2016,4,1018474,70.2,987872,68.1,30602,3.0
Nevada,2016,4,1409538,62.1,1325445,58.4,84093,6.0
New Hampshire,2016,4,752291,68.7,730870,66.7,21421,2.8
New Jersey,2016,4,4498429,64.0,4273344,60.8,225085,5.0
New Mexico,2016,4,942848,58.3,880344,54.5,62504,6.6
New York,2016,4,9533668,60.6,9075462,57.7,458206,4.8
New York city,2016,4,4076666,59.9,3867577,56.8,209089,5.1
North Carolina,2016,4,4830974,61.3,4584798,58.1,246176,5.1
North Dakota,2016,4,412015,70.9,398635,68.6,13380,3.2
Ohio,2016,4,5759108,62.9,5472521,59.8,286587,5.0
Oklahoma,2016,4,1831282,61.3,1746117,58.5,85165,4.7
Oregon,2016,4,2037655,62.4,1937802,59.3,99853,4.9
Pennsylvania,2016,4,6472917,63.3,6126458,59.9,346459,5.4
Rhode Island,2016,4,553110,64.5,523270,61.0,29840,5.4
South Carolina,2016,4,2289095,59.1,2171385,56.0,117710,5.1
South Dakota,2016,4,455173,69.7,442044,67.7,13129,2.9
Tennessee,2016,4,3120756,60.0,2975759,57.2,144997,4.6
Texas,2016,4,13297832,63.9,12698126,61.0,599706,4.5
Utah,2016,4,1491391,68.4,1440100,66.0,51291,3.4
Vermont,2016,4,345690,67.1,334876,65.0,10814,3.1
Virginia,2016,4,4236772,64.9,4072587,62.4,164185,3.9
Washington,2016,4,3637282,63.7,3443618,60.3,193664,5.3
West Virginia,2016,4,787459,53.4,738270,50.0,49189,6.2
Wisconsin,2016,4,3110891,68.2,2986761,65.5,124130,4.0
Wyoming,2016,4,302403,67.0,285301,63.2,17102,5.7
Alabama,2016,5,2151573,56.4,2025350,53.1,126223,5.9
Alaska,2016,5,362119,66.3,338314,61.9,23805,6.6
Arizona,2016,5,3245197,60.4,3065928,57.1,179269,5.5
Arkansas,2016,5,1344591,58.2,1290913,55.9,53678,4.0
California,2016,5,18989520,62.2,17941250,58.8,1048270,5.5
Los Angeles County,2016,5,5008078,62.3,4743151,59.0,264927,5.3
Colorado,2016,5,2885680,66.9,2791195,64.7,94485,3.3
Connecticut,2016,5,1890682,65.8,1797493,62.5,93189,4.9
Delaware,2016,5,468563,62.2,447804,59.5,20759,4.4
District of Columbia,2016,5,394222,69.9,370141,65.6,24081,6.1
Florida,2016,5,9806455,59.2,9327449,56.3,479006,4.9
Georgia,2016,5,4870975,61.9,4606634,58.5,264341,5.4
Hawaii,2016,5,677630,62.0,657476,60.2,20154,3.0
Idaho,2016,5,811416,63.9,781429,61.5,29987,3.7
Illinois,2016,5,6580544,65.5,6184932,61.6,395612,6.0
Indiana,2016,5,3340290,64.9,3189022,62.0,151268,4.5
Iowa,2016,5,1706702,69.9,1644496,67.4,62206,3.6
Kansas,2016,5,1493780,67.5,1434209,64.8,59571,4.0
Kentucky,2016,5,2008503,58.1,1909307,55.2,99196,4.9
Louisiana,2016,5,2129860,59.4,1999764,55.8,130096,6.1
Maine,2016,5,693068,63.4,666646,60.9,26422,3.8
Maryland,2016,5,3147271,66.8,3012872,63.9,134399,4.3
Massachusetts,2016,5,3609457,65.2,3462973,62.5,146484,4.1
Michigan,2016,5,4843434,61.2,4601766,58.2,241668,5.0
Minnesota,2016,5,3019912,70.0,2904922,67.4,114990,3.8
Mississippi,2016,5,1269210,55.6,1193670,52.3,75540,6.0
Missouri,2016,5,3076191,64.7,2935649,61.8,140542,4.6
Montana,2016,5,521715,63.4,498984,60.7,22731,4.4
Nebraska,2016,5,1017826,70.2,987002,68.0,30824,3.0
Nevada,2016,5,1410785,62.1,1327774,58.4,83011,5.9
New Hampshire,2016,5,752948,68.7,731354,66.7,21594,2.9
New Jersey,2016,5,4496747,64.0,4271365,60.8,225382,5.0
New Mexico,2016,5,943841,58.4,880426,54.5,63415,6.7
New York,2016,5,9523916,60.6,9064157,57.6,459759,4.8
New York city,2016,5,4076588,59.9,3867127,56.8,209461,5.1
North Carolina,2016,5,4834712,61.2,4590267,58.1,244445,5.1
North Dakota,2016,5,412193,70.9,398875,68.6,13318,3.2
Ohio,2016,5,5756166,62.9,5470836,59.8,285330,5.0
Oklahoma,2016,5,1829596,61.2,1743321,58.3,86275,4.7
Oregon,2016,5,2040822,62.4,1940533,59.3,100289,4.9
Pennsylvania,2016,5,6470707,63.3,6122515,59.9,348192,5.4
Rhode Island,2016,5,553362,64.5,523706,61.0,29656,5.4
South Carolina,2016,5,2287908,59.0,2172197,56.0,115711,5.1
South Dakota,2016,5,455241,69.6,441851,67.6,13390,2.9
Tennessee,2016,5,3126578,60.1,2980257,57.2,146321,4.7
Texas,2016,5,13321031,63.9,12710616,60.9,610415,4.6
Utah,2016,5,1494904,68.4,1444126,66.0,50778,3.4
Vermont,2016,5,345778,67.1,334986,65.0,10792,3.1
Virginia,2016,5,4240409,64.9,4074927,62.4,165482,3.9
Washington,2016,5,3643393,63.7,3449983,60.4,193410,5.3
West Virginia,2016,5,785938,53.3,737255,50.0,48683,6.2
Wisconsin,2016,5,3111252,68.2,2987959,65.5,123293,4.0
Wyoming,2016,5,301896,66.9,284797,63.1,17099,5.7
Alabama,2016,6,2154315,56.5,2028210,53.2,126105,5.9
Alaska,2016,6,362098,66.2,338159,61.9,23939,6.6
Arizona,2016,6,3250898,60.4,3072085,57.1,178813,5.5
Arkansas,2016,6,1344422,58.2,1290844,55.9,53578,4.0
California,2016,6,19008579,62.2,17961187,58.8,1047392,5.5
Los Angeles County,2016,6,5018197,62.4,4753351,59.1,264846,5.3
Colorado,2016,6,2891014,66.9,2797121,64.8,93893,3.2
Connecticut,2016,6,1892133,65.8,1800092,62.6,92041,4.9
Delaware,2016,6,468515,62.1,447619,59.4,20896,4.5
District of Columbia,2016,6,394519,69.8,370323,65.6,24196,6.1
Florida,2016,6,9826989,59.2,9347749,56.3,479240,4.9
Georgia,2016,6,4908561,62.3,4643573,58.9,264988,5.4
Hawaii,2016,6,678662,62.1,658647,60.2,20015,2.9
Idaho,2016,6,812750,63.9,782732,61.5,30018,3.7
Illinois,2016,6,6569841,65.4,6180798,61.5,389043,5.9
Indiana,2016,6,3339805,64.9,3191314,62.0,148491,4.4
Iowa,2016,6,1705132,69.8,1642812,67.3,62320,3.7
Kansas,2016,6,1492201,67.4,1431926,64.7,60275,4.0
Kentucky,2016,6,2012869,58.2,1913680,55.3,99189,4.9
Louisiana,2016,6,2127524,59.4,1997206,55.7,130318,6.1
Maine,2016,6,694036,63.4,667788,61.0,26248,3.8
Maryland,2016,6,3149300,66.8,3015276,64.0,134024,4.3
Massachusetts,2016,6,3614771,65.2,3470308,62.6,144463,4.0
Michigan,2016,6,4849566,61.3,4606797,58.2,242769,5.0
Minnesota,2016,6,3019989,70.0,2904199,67.3,115790,3.8
Mississippi,2016,6,1269750,55.6,1194254,52.3,75496,5.9
Missouri,2016,6,3077577,64.7,2934414,61.7,143163,4.7
Montana,2016,6,521652,63.4,499016,60.6,22636,4.3
Nebraska,2016,6,1017046,70.0,985933,67.9,31113,3.1
Nevada,2016,6,1412384,62.0,1330298,58.4,82086,5.8
New Hampshire,2016,6,753404,68.7,731703,66.7,21701,2.9
New Jersey,2016,6,4495078,64.0,4269959,60.8,225119,5.0
New Mexico,2016,6,944847,58.4,880481,54.4,64366,6.8
New York,2016,6,9518429,60.5,9054675,57.6,463754,4.9
New York city,2016,6,4079683,59.9,3868262,56.8,211421,5.2
North Carolina,2016,6,4838912,61.2,4594881,58.1,244031,5.0
North Dakota,2016,6,412394,71.0,399269,68.7,13125,3.2
Ohio,2016,6,5752564,62.8,5467270,59.7,285294,5.0
Oklahoma,2016,6,1828018,61.1,1740924,58.2,87094,4.8
Oregon,2016,6,2043662,62.4,1943278,59.3,100384,4.9
Pennsylvania,2016,6,6468539,63.2,6119045,59.8,349494,5.4
Rhode Island,2016,6,553581,64.5,524123,61.1,29458,5.3
South Carolina,2016,6,2286438,58.8,2172971,55.9,113467,5.0
South Dakota,2016,6,455294,69.6,441614,67.5,13680,3.0
Tennessee,2016,6,3133742,60.1,2985440,57.3,148302,4.7
Texas,2016,6,13344101,63.9,12722956,60.9,621145,4.7
Utah,2016,6,1498447,68.4,1448202,66.1,50245,3.4
Vermont,2016,6,345859,67.1,335071,65.0,10788,3.1
Virginia,2016,6,4246189,64.9,4078270,62.4,167919,4.0
Washington,2016,6,3649388,63.7,3456222,60.4,193166,5.3
West Virginia,2016,6,784596,53.2,736276,49.9,48320,6.2
Wisconsin,2016,6,3111805,68.2,2989047,65.5,122758,3.9
Wyoming,2016,6,301109,66.7,284349,63.0,16760,5.6
Alabama,2016,7,2157474,56.5,2031143,53.2,126331,5.9
Alaska,2016,7,362029,66.2,338000,61.8,24029,6.6
Arizona,2016,7,3256816,60.4,3078706,57.1,178110,5.5
Arkansas,2016,7,1344309,58.1,1290861,55.8,53448,4.0
California,2016,7,19028074,62.2,17981056,58.8,1047018,5.5
Los Angeles County,2016,7,5027962,62.5,4762212,59.2,265750,5.3
Colorado,2016,7,2896793,66.9,2804247,64.8,92546,3.2
Connecticut,2016,7,1893536,65.9,1802669,62.7,90867,4.8
Delaware,2016,7,468517,62.1,447440,59.3,21077,4.5
District of Columbia,2016,7,394943,69.8,370549,65.5,24394,6.2
Florida,2016,7,9850017,59.2,9369741,56.3,480276,4.9
Georgia,2016,7,4947062,62.7,4680456,59.3,266606,5.4
Hawaii,2016,7,679858,62.1,660086,60.3,19772,2.9
Idaho,2016,7,814013,63.8,784003,61.5,30010,3.7
Illinois,2016,7,6558534,65.3,6175653,61.5,382881,5.8
Indiana,2016,7,3338179,64.8,3192914,62.0,145265,4.4
Iowa,2016,7,1703877,69.7,1641745,67.2,62132,3.6
Kansas,2016,7,1490884,67.3,1429885,64.6,60999,4.1
Kentucky,2016,7,2017591,58.3,1917963,55.4,99628,4.9
Louisiana,2016,7,2124777,59.3,1994428,55.6,130349,6.1
Maine,2016,7,694904,63.5,668817,61.1,26087,3.8
Maryland,2016,7,3152707,66.9,3018813,64.0,133894,4.2
Massachusetts,2016,7,3620318,65.3,3477693,62.7,142625,3.9
Michigan,2016,7,4855399,61.3,4611733,58.2,243666,5.0
Minnesota,2016,7,3021008,69.9,2904097,67.2,116911,3.9
Mississippi,2016,7,1270922,55.6,1195416,52.3,75506,5.9
Missouri,2016,7,3078141,64.7,2933221,61.7,144920,4.7
Montana,2016,7,521634,63.3,499140,60.6,22494,4.3
Nebraska,2016,7,1016161,69.9,984777,67.8,31384,3.1
Nevada,2016,7,1414241,62.0,1333032,58.5,81209,5.7
New Hampshire,2016,7,753667,68.6,731989,66.7,21678,2.9
New Jersey,2016,7,4493345,63.9,4269348,60.7,223997,5.0
New Mexico,2016,7,945687,58.5,880580,54.4,65107,6.9
New York,2016,7,9516807,60.5,9048360,57.5,468447,4.9
New York city,2016,7,4084913,60.0,3871190,56.8,213723,5.2
North Carolina,2016,7,4844325,61.2,4599901,58.1,244424,5.0
North Dakota,2016,7,412494,71.0,399631,68.8,12863,3.1
Ohio,2016,7,5749748,62.8,5463246,59.7,286502,5.0
Oklahoma,2016,7,1826864,61.1,1739455,58.1,87409,4.8
Oregon,2016,7,2046599,62.3,1946984,59.3,99615,4.9
Pennsylvania,2016,7,6465434,63.2,6115856,59.8,349578,5.4
Rhode Island,2016,7,553639,64.5,524516,61.1,29123,5.3
South Carolina,2016,7,2285086,58.7,2174111,55.9,110975,4.9
South Dakota,2016,7,455323,69.5,441381,67.4,13942,3.1
Tennessee,2016,7,3141665,60.2,2991411,57.4,150254,4.8
Texas,2016,7,13365941,63.9,12736496,60.9,629445,4.7
Utah,2016,7,1502055,68.4,1452325,66.1,49730,3.3
Vermont,2016,7,345924,67.1,335154,65.0,10770,3.1
Virginia,2016,7,4253358,65.0,4082681,62.4,170677,4.0
Washington,2016,7,3655019,63.7,3462950,60.4,192069,5.3
West Virginia,2016,7,783598,53.2,735591,49.9,48007,6.1
Wisconsin,2016,7,3112393,68.2,2990301,65.5,122092,3.9
Wyoming,2016,7,300247,66.5,283973,62.9,16274,5.4
Alabama,2016,8,2160744,56.6,2034025,53.3,126719,5.9
Alaska,2016,8,361944,66.1,337853,61.7,24091,6.7
Arizona,2016,8,3262727,60.4,3085510,57.2,177217,5.4
Arkansas,2016,8,1344072,58.1,1290838,55.8,53234,4.0
California,2016,8,19046039,62.2,17999607,58.8,1046432,5.5
Los Angeles County,2016,8,5036328,62.6,4769469,59.3,266859,5.3
Colorado,2016,8,2902625,67.0,2812008,64.9,90617,3.1
Connecticut,2016,8,1894991,65.9,1805214,62.8,89777,4.7
Delaware,2016,8,468615,62.0,447331,59.2,21284,4.5
District of Columbia,2016,8,395512,69.9,370878,65.5,24634,6.2
Florida,2016,8,9873290,59.3,9391728,56.4,481562,4.9
Georgia,2016,8,4986532,63.1,4717653,59.7,268879,5.4
Hawaii,2016,8,680909,62.2,661451,60.4,19458,2.9
Idaho,2016,8,815143,63.8,785242,61.4,29901,3.7
Illinois,2016,8,6548208,65.2,6170083,61.4,378125,5.8
Indiana,2016,8,3335426,64.7,3193276,62.0,142150,4.3
Iowa,2016,8,1702459,69.7,1640827,67.1,61632,3.6
Kansas,2016,8,1489730,67.2,1428192,64.5,61538,4.1
Kentucky,2016,8,2022067,58.4,1921669,55.5,100398,5.0
Louisiana,2016,8,2121376,59.2,1991224,55.5,130152,6.1
Maine,2016,8,695716,63.5,669786,61.2,25930,3.7
Maryland,2016,8,3157347,66.9,3023343,64.1,134004,4.2
Massachusetts,2016,8,3625768,65.3,3484610,62.8,141158,3.9
Michigan,2016,8,4860940,61.4,4616444,58.3,244496,5.0
Minnesota,2016,8,3022594,69.9,2904394,67.2,118200,3.9
Mississippi,2016,8,1272319,55.7,1196860,52.4,75459,5.9
Missouri,2016,8,3077411,64.7,2932194,61.6,145217,4.7
Montana,2016,8,521668,63.2,499311,60.5,22357,4.3
Nebraska,2016,8,1015208,69.8,983589,67.7,31619,3.1
Nevada,2016,8,1416277,62.0,1335898,58.5,80379,5.7
New Hampshire,2016,8,753749,68.6,732167,66.6,21582,2.9
New Jersey,2016,8,4491870,63.9,4269454,60.7,222416,5.0
New Mexico,2016,8,946277,58.5,880730,54.4,65547,6.9
New York,2016,8,9517447,60.5,9045264,57.5,472183,5.0
New York city,2016,8,4091011,60.1,3875960,56.9,215051,5.3
North Carolina,2016,8,4851158,61.2,4605874,58.1,245284,5.1
North Dakota,2016,8,412382,71.0,399770,68.8,12612,3.1
Ohio,2016,8,5749164,62.7,5459942,59.6,289222,5.0
Oklahoma,2016,8,1826152,61.0,1738948,58.1,87204,4.8
Oregon,2016,8,2049413,62.3,1951419,59.3,97994,4.8
Pennsylvania,2016,8,6460382,63.1,6111927,59.7,348455,5.4
Rhode Island,2016,8,553585,64.5,524930,61.1,28655,5.2
South Carolina,2016,8,2284243,58.6,2175693,55.8,108550,4.8
South Dakota,2016,8,455306,69.4,441149,67.3,14157,3.1
Tennessee,2016,8,3148996,60.3,2997016,57.4,151980,4.8
Texas,2016,8,13386060,63.9,12750754,60.9,635306,4.7
Utah,2016,8,1505706,68.4,1456380,66.2,49326,3.3
Vermont,2016,8,345995,67.1,335259,65.0,10736,3.1
Virginia,2016,8,4261151,65.1,4088025,62.4,173126,4.1
Washington,2016,8,3660154,63.7,3470082,60.4,190072,5.2
West Virginia,2016,8,782962,53.1,735299,49.9,47663,6.1
Wisconsin,2016,8,3112627,68.1,2991530,65.5,121097,3.9
Wyoming,2016,8,299501,66.4,283660,62.9,15841,5.3
Alabama,2016,9,2163777,56.6,2036649,53.3,127128,5.9
Alaska,2016,9,361974,66.1,337799,61.7,24175,6.7
Arizona,2016,9,3268544,60.4,3092046,57.2,176498,5.4
Arkansas,2016,9,1343648,58.0,1290648,55.8,53000,3.9
California,2016,9,19061155,62.2,18015129,58.8,1046026,5.5
Los Angeles County,2016,9,5042286,62.7,4774511,59.3,267775,5.3
Colorado,2016,9,2908090,67.0,2819516,65.0,88574,3.0
Connecticut,2016,9,1896690,66.0,1807641,62.9,89049,4.7
Delaware,2016,9,468865,62.0,447328,59.2,21537,4.6
District of Columbia,2016,9,396280,69.9,371384,65.5,24896,6.3
Florida,2016,9,9894617,59.3,9411626,56.4,482991,4.9
Georgia,2016,9,5007844,63.3,4736489,59.9,271355,5.4
Hawaii,2016,9,681639,62.3,662483,60.5,19156,2.8
Idaho,2016,9,816266,63.7,786512,61.4,29754,3.6
Illinois,2016,9,6539107,65.1,6164292,61.3,374815,5.7
Indiana,2016,9,3331610,64.6,3191886,61.9,139724,4.2
Iowa,2016,9,1700400,69.5,1639444,67.1,60956,3.6
Kansas,2016,9,1488560,67.2,1426801,64.4,61759,4.1
Kentucky,2016,9,2026061,58.5,1924543,55.6,101518,5.0
Louisiana,2016,9,2117470,59.0,1987810,55.4,129660,6.1
Maine,2016,9,696481,63.6,670673,61.2,25808,3.7
Maryland,2016,9,3162687,67.0,3028270,64.2,134417,4.3
Massachusetts,2016,9,3630818,65.4,3490335,62.9,140483,3.9
Michigan,2016,9,4866256,61.4,4620323,58.3,245933,5.1
Minnesota,2016,9,3024432,69.9,2904939,67.1,119493,4.0
Mississippi,2016,9,1273642,55.7,1198270,52.4,75372,5.9
Missouri,2016,9,3075144,64.6,2931162,61.6,143982,4.7
Montana,2016,9,521755,63.2,499476,60.5,22279,4.3
Nebraska,2016,9,1014279,69.7,982416,67.5,31863,3.1
Nevada,2016,9,1418474,62.0,1338773,58.5,79701,5.6
New Hampshire,2016,9,753622,68.5,732076,66.6,21546,2.9
New Jersey,2016,9,4490549,63.8,4269602,60.7,220947,4.9
New Mexico,2016,9,946531,58.5,880785,54.4,65746,6.9
New York,2016,9,9518718,60.5,9044383,57.5,474335,5.0
New York city,2016,9,4096603,60.2,3881935,57.0,214668,5.2
North Carolina,2016,9,4859201,61.2,4612759,58.1,246442,5.1
North Dakota,2016,9,412070,70.9,399634,68.8,12436,3.0
Ohio,2016,9,5752040,62.8,5458133,59.5,293907,5.1
Oklahoma,2016,9,1825492,61.0,1738937,58.1,86555,4.7
Oregon,2016,9,2051528,62.3,1955705,59.4,95823,4.7
Pennsylvania,2016,9,6453159,63.0,6106573,59.7,346586,5.4
Rhode Island,2016,9,553591,64.5,525454,61.2,28137,5.1
South Carolina,2016,9,2284053,58.5,2177396,55.8,106657,4.7
South Dakota,2016,9,455229,69.4,440886,67.2,14343,3.2
Tennessee,2016,9,3154762,60.4,3001280,57.4,153482,4.9
Texas,2016,9,13403980,63.9,12763563,60.8,640417,4.8
Utah,2016,9,1509362,68.4,1460215,66.2,49147,3.3
Vermont,2016,9,346058,67.1,335351,65.0,10707,3.1
Virginia,2016,9,4269034,65.1,4094058,62.5,174976,4.1
Washington,2016,9,3665002,63.7,3477143,60.4,187859,5.1
West Virginia,2016,9,782586,53.1,735395,49.9,47191,6.0
Wisconsin,2016,9,3112289,68.1,2992319,65.5,119970,3.9
Wyoming,2016,9,298941,66.3,283384,62.9,15557,5.2
Alabama,2016,10,2166110,56.7,2039127,53.3,126983,5.9
Alaska,2016,10,362112,66.2,337870,61.7,24242,6.7
Arizona,2016,10,3274187,60.4,3098339,57.2,175848,5.4
Arkansas,2016,10,1342910,58.0,1290250,55.7,52660,3.9
California,2016,10,19071727,62.2,18028383,58.8,1043344,5.5
Los Angeles County,2016,10,5045973,62.7,4778320,59.4,267653,5.3
Colorado,2016,10,2912869,67.0,2826596,65.0,86273,3.0
Connecticut,2016,10,1898583,66.0,1810005,62.9,88578,4.7
Delaware,2016,10,469237,62.0,447444,59.1,21793,4.6
District of Columbia,2016,10,397144,70.0,372053,65.6,25091,6.3
Florida,2016,10,9912032,59.3,9428996,56.4,483036,4.9
Georgia,2016,10,5065858,64.0,4793054,60.5,272804,5.4
Hawaii,2016,10,681999,62.3,663144,60.6,18855,2.8
Idaho,2016,10,817413,63.7,787865,61.4,29548,3.6
Illinois,2016,10,6529612,65.0,6158816,61.3,370796,5.7
Indiana,2016,10,3326557,64.5,3188983,61.8,137574,4.1
Iowa,2016,10,1697326,69.4,1637247,66.9,60079,3.5
Kansas,2016,10,1487280,67.1,1425871,64.3,61409,4.1
Kentucky,2016,10,2029535,58.6,1926913,55.6,102622,5.1
Louisiana,2016,10,2113467,58.9,1984845,55.3,128622,6.1
Maine,2016,10,697115,63.6,671499,61.3,25616,3.7
Maryland,2016,10,3167854,67.1,3033190,64.2,134664,4.3
Massachusetts,2016,10,3635097,65.4,3494693,62.9,140404,3.9
Michigan,2016,10,4870453,61.4,4623219,58.3,247234,5.1
Minnesota,2016,10,3026209,69.9,2906061,67.1,120148,4.0
Mississippi,2016,10,1274607,55.7,1199606,52.4,75001,5.9
Missouri,2016,10,3071352,64.5,2930190,61.5,141162,4.6
Montana,2016,10,521828,63.1,499594,60.4,22234,4.3
Nebraska,2016,10,1013352,69.6,981360,67.4,31992,3.2
Nevada,2016,10,1420709,62.0,1341689,58.5,79020,5.6
New Hampshire,2016,10,753280,68.4,731676,66.5,21604,2.9
New Jersey,2016,10,4488150,63.8,4269123,60.7,219027,4.9
New Mexico,2016,10,946423,58.4,880745,54.4,65678,6.9
New York,2016,10,9518573,60.5,9045425,57.5,473148,5.0
New York city,2016,10,4100450,60.2,3888678,57.1,211772,5.2
North Carolina,2016,10,4867434,61.2,4620450,58.1,246984,5.1
North Dakota,2016,10,411605,70.8,399286,68.7,12319,3.0
Ohio,2016,10,5757428,62.8,5457993,59.5,299435,5.2
Oklahoma,2016,10,1824350,60.9,1738956,58.1,85394,4.7
Oregon,2016,10,2052451,62.2,1959271,59.4,93180,4.5
Pennsylvania,2016,10,6444103,62.9,6100196,59.6,343907,5.3
Rhode Island,2016,10,553696,64.5,526126,61.3,27570,5.0
South Carolina,2016,10,2284227,58.5,2179118,55.8,105109,4.6
South Dakota,2016,10,455083,69.3,440599,67.1,14484,3.2
Tennessee,2016,10,3158441,60.4,3004295,57.4,154146,4.9
Texas,2016,10,13419163,63.8,12774408,60.8,644755,4.8
Utah,2016,10,1512986,68.5,1463848,66.2,49138,3.2
Vermont,2016,10,346102,67.1,335396,65.0,10706,3.1
Virginia,2016,10,4276217,65.2,4100496,62.5,175721,4.1
Washington,2016,10,3669217,63.6,3483903,60.4,185314,5.1
West Virginia,2016,10,782275,53.1,735838,50.0,46437,5.9
Wisconsin,2016,10,3111091,68.0,2992589,65.4,118502,3.8
Wyoming,2016,10,298556,66.3,283145,62.8,15411,5.2
Alabama,2016,11,2167734,56.7,2042073,53.4,125661,5.8
Alaska,2016,11,362298,66.2,338067,61.7,24231,6.7
Arizona,2016,11,3280006,60.4,3105116,57.2,174890,5.3
Arkansas,2016,11,1342237,57.9,1290085,55.7,52152,3.9
California,2016,11,19079948,62.2,18044658,58.8,1035290,5.4
Los Angeles County,2016,11,5049129,62.7,4783360,59.4,265769,5.3
Colorado,2016,11,2917546,67.0,2834159,65.1,83387,2.9
Connecticut,2016,11,1900809,66.1,1812673,63.0,88136,4.6
Delaware,2016,11,469756,62.0,447782,59.1,21974,4.7
District of Columbia,2016,11,397931,70.1,372781,65.6,25150,6.3
Florida,2016,11,9926694,59.3,9446908,56.4,479786,4.8
Georgia,2016,11,5066497,63.9,4794312,60.5,272185,5.4
Hawaii,2016,11,682195,62.3,663687,60.6,18508,2.7
Idaho,2016,11,818658,63.7,789438,61.4,29220,3.6
Illinois,2016,11,6518407,64.9,6154569,61.3,363838,5.6
Indiana,2016,11,3321175,64.4,3186375,61.7,134800,4.1
Iowa,2016,11,1693569,69.2,1634566,66.8,59003,3.5
Kansas,2016,11,1486064,67.0,1425661,64.3,60403,4.1
Kentucky,2016,11,2033028,58.6,1929665,55.7,103363,5.1
Louisiana,2016,11,2110081,58.8,1983120,55.3,126961,6.0
Maine,2016,11,697657,63.6,672408,61.3,25249,3.6
Maryland,2016,11,3172830,67.2,3038452,64.3,134378,4.2
Massachusetts,2016,11,3639080,65.4,3498632,62.9,140448,3.9
Michigan,2016,11,4873086,61.4,4626288,58.3,246798,5.1
Minnesota,2016,11,3028316,69.9,2908696,67.1,119620,4.0
Mississippi,2016,11,1275297,55.7,1201112,52.5,74185,5.8
Missouri,2016,11,3066907,64.4,2929960,61.5,136947,4.5
Montana,2016,11,521938,63.0,499776,60.4,22162,4.2
Nebraska,2016,11,1012567,69.5,980719,67.3,31848,3.1
Nevada,2016,11,1423131,61.9,1344990,58.5,78141,5.5
New Hampshire,2016,11,752930,68.4,731232,66.4,21698,2.9
New Jersey,2016,11,4484804,63.7,4268999,60.6,215805,4.8
New Mexico,2016,11,946214,58.4,880917,54.4,65297,6.9
New York,2016,11,9517508,60.5,9050218,57.5,467290,4.9
New York city,2016,11,4102813,60.3,3896596,57.2,206217,5.0
North Carolina,2016,11,4875090,61.3,4629236,58.2,245854,5.0
North Dakota,2016,11,411185,70.8,398987,68.7,12198,3.0
Ohio,2016,11,5763754,62.8,5460359,59.5,303395,5.3
Oklahoma,2016,11,1822914,60.9,1739205,58.1,83709,4.6
Oregon,2016,11,2052819,62.2,1962568,59.4,90251,4.4
Pennsylvania,2016,11,6435694,62.8,6095476,59.5,340218,5.3
Rhode Island,2016,11,553934,64.5,526963,61.3,26971,4.9
South Carolina,2016,11,2284792,58.4,2181286,55.8,103506,4.5
South Dakota,2016,11,454969,69.2,440426,67.0,14543,3.2
Tennessee,2016,11,3160471,60.4,3007297,57.4,153174,4.8
Texas,2016,11,13434311,63.8,12787312,60.8,646999,4.8
Utah,2016,11,1516777,68.5,1467644,66.3,49133,3.2
Vermont,2016,11,346202,67.1,335457,65.0,10745,3.1
Virginia,2016,11,4283055,65.2,4107886,62.6,175169,4.1
Washington,2016,11,3673004,63.6,3490923,60.4,182081,5.0
West Virginia,2016,11,782016,53.2,736667,50.1,45349,5.8
Wisconsin,2016,11,3109627,68.0,2993340,65.4,116287,3.7
Wyoming,2016,11,298248,66.2,282998,62.8,15250,5.1
Alabama,2016,12,2168771,56.7,2045834,53.5,122937,5.7
Alaska,2016,12,362459,66.2,338328,61.8,24131,6.7
Arizona,2016,12,3286375,60.5,3112781,57.3,173594,5.3
Arkansas,2016,12,1342177,57.9,1290651,55.7,51526,3.8
California,2016,12,19090083,62.2,18068401,58.9,1021682,5.4
Los Angeles County,2016,12,5053634,62.8,4791350,59.5,262284,5.2
Colorado,2016,12,2922961,67.0,2842900,65.2,80061,2.7
Connecticut,2016,12,1903587,66.2,1815897,63.1,87690,4.6
Delaware,2016,12,470473,62.0,448430,59.1,22043,4.7
District of Columbia,2016,12,398689,70.1,373585,65.7,25104,6.3
Florida,2016,12,9941833,59.3,9468761,56.5,473072,4.8
Georgia,2016,12,5068628,63.8,4799051,60.4,269577,5.3
Hawaii,2016,12,682432,62.3,664308,60.7,18124,2.7
Idaho,2016,12,820142,63.6,791352,61.4,28790,3.5
Illinois,2016,12,6506520,64.8,6152559,61.2,353961,5.4
Indiana,2016,12,3317083,64.3,3185941,61.7,131142,4.0
Iowa,2016,12,1689919,69.0,1632092,66.7,57827,3.4
Kansas,2016,12,1485099,67.0,1426125,64.3,58974,4.0
Kentucky,2016,12,2036870,58.7,1933310,55.7,103560,5.1
Louisiana,2016,12,2107951,58.8,1982995,55.3,124956,5.9
Maine,2016,12,698186,63.6,673402,61.4,24784,3.5
Maryland,2016,12,3177879,67.2,3044323,64.4,133556,4.2
Massachusetts,2016,12,3643795,65.5,3503296,63.0,140499,3.9
Michigan,2016,12,4874253,61.4,4630737,58.3,243516,5.0
Minnesota,2016,12,3031048,69.9,2913051,67.2,117997,3.9
Mississippi,2016,12,1275809,55.7,1202794,52.6,73015,5.7
Missouri,2016,12,3063183,64.3,2930971,61.5,132212,4.3
Montana,2016,12,522219,63.0,500168,60.3,22051,4.2
Nebraska,2016,12,1012214,69.4,980735,67.3,31479,3.1
Nevada,2016,12,1426046,62.0,1348939,58.6,77107,5.4
New Hampshire,2016,12,752816,68.3,731026,66.3,21790,2.9
New Jersey,2016,12,4482046,63.6,4270453,60.6,211593,4.7
New Mexico,2016,12,946205,58.4,881536,54.4,64669,6.8
New York,2016,12,9518132,60.5,9059508,57.6,458624,4.8
New York city,2016,12,4105250,60.3,3905682,57.4,199568,4.9
North Carolina,2016,12,4882053,61.3,4639157,58.2,242896,5.0
North Dakota,2016,12,411029,70.7,398992,68.7,12037,2.9
Ohio,2016,12,5770112,62.9,5465690,59.6,304422,5.3
Oklahoma,2016,12,1821747,60.8,1740013,58.1,81734,4.5
Oregon,2016,12,2053931,62.1,1966524,59.5,87407,4.3
Pennsylvania,2016,12,6430351,62.8,6094481,59.5,335870,5.2
Rhode Island,2016,12,554336,64.5,527979,61.5,26357,4.8
South Carolina,2016,12,2285947,58.3,2184139,55.8,101808,4.5
South Dakota,2016,12,455019,69.1,440501,66.9,14518,3.2
Tennessee,2016,12,3161953,60.3,3011886,57.5,150067,4.7
Texas,2016,12,13452830,63.8,12805992,60.8,646838,4.8
Utah,2016,12,1520948,68.5,1471879,66.3,49069,3.2
Vermont,2016,12,346418,67.1,335584,65.0,10834,3.1
Virginia,2016,12,4290653,65.3,4116919,62.7,173734,4.0
Washington,2016,12,3677076,63.6,3498667,60.5,178409,4.9
West Virginia,2016,12,781718,53.2,737762,50.2,43956,5.6
Wisconsin,2016,12,3108972,67.9,2995667,65.4,113305,3.6
Wyoming,2016,12,297901,66.2,282982,62.9,14919,5.0
Alabama,2017,1,2199177,56.7,2079074,53.6,120103,5.5
Alaska,2017,1,361868,66.2,337962,61.8,23906,6.6
Arizona,2017,1,3207827,60.5,3040381,57.3,167446,5.2
Arkansas,2017,1,1340807,58.1,1290170,55.9,50637,3.8
California,2017,1,19107737,62.2,18104833,58.9,1002904,5.2
Los Angeles County,2017,1,5077453,62.9,4819399,59.7,258054,5.1
Colorado,2017,1,2911905,67.0,2836089,65.3,75816,2.6
Connecticut,2017,1,1924150,66.4,1836282,63.4,87868,4.6
Delaware,2017,1,470994,61.9,448971,59.0,22023,4.7
District of Columbia,2017,1,390087,70.1,365688,65.8,24399,6.3
Florida,2017,1,9895826,59.3,9432161,56.5,463665,4.7
Georgia,2017,1,5073481,63.8,4808548,60.5,264933,5.2
Hawaii,2017,1,697290,62.3,679241,60.7,18049,2.6
Idaho,2017,1,826911,63.6,798308,61.4,28603,3.5
Illinois,2017,1,6565989,64.7,6219411,61.3,346578,5.3
Indiana,2017,1,3320460,64.1,3193478,61.7,126982,3.8
Iowa,2017,1,1696536,69.0,1640207,66.7,56329,3.3
Kansas,2017,1,1488616,66.9,1431211,64.3,57405,3.9
Kentucky,2017,1,2044263,58.7,1940528,55.7,103735,5.1
Louisiana,2017,1,2108478,58.8,1985716,55.4,122762,5.8
Maine,2017,1,702489,63.7,678066,61.4,24423,3.5
Maryland,2017,1,3221638,67.3,3089758,64.6,131880,4.1
Massachusetts,2017,1,3689575,65.5,3547595,63.0,141980,3.8
Michigan,2017,1,4896758,61.3,4659428,58.4,237330,4.8
Minnesota,2017,1,3052870,70.0,2935369,67.3,117501,3.8
Mississippi,2017,1,1274598,55.8,1203082,52.7,71516,5.6
Missouri,2017,1,3057505,64.1,2929500,61.5,128005,4.2
Montana,2017,1,525223,63.1,503357,60.5,21866,4.2
Nebraska,2017,1,1018333,69.3,986953,67.2,31380,3.1
Nevada,2017,1,1422626,62.2,1345895,58.8,76731,5.4
New Hampshire,2017,1,755955,68.2,734131,66.2,21824,2.9
New Jersey,2017,1,4608916,63.6,4396117,60.7,212799,4.6
New Mexico,2017,1,948436,58.4,884417,54.4,64019,6.7
New York,2017,1,9786877,60.6,9326683,57.7,460194,4.7
New York city,2017,1,4277572,60.4,4076849,57.6,200723,4.7
North Carolina,2017,1,4829626,61.2,4594840,58.3,234786,4.9
North Dakota,2017,1,415857,70.8,403954,68.8,11903,2.9
Ohio,2017,1,5795256,62.9,5490665,59.6,304591,5.3
Oklahoma,2017,1,1816237,60.9,1736893,58.2,79344,4.4
Oregon,2017,1,2051997,62.1,1967522,59.5,84475,4.1
Pennsylvania,2017,1,6490079,62.7,6153834,59.5,336245,5.2
Rhode Island,2017,1,566288,64.3,540023,61.3,26265,4.6
South Carolina,2017,1,2253968,58.2,2155359,55.6,98609,4.4
South Dakota,2017,1,453704,69.2,439537,67.0,14167,3.1
Tennessee,2017,1,3171747,60.3,3026155,57.6,145592,4.6
Texas,2017,1,13383543,63.8,12743129,60.7,640414,4.8
Utah,2017,1,1533260,68.6,1484178,66.4,49082,3.2
Vermont,2017,1,354265,67.3,343122,65.2,11143,3.1
Virginia,2017,1,4318562,65.4,4144568,62.8,173994,4.0
Washington,2017,1,3683980,63.5,3508124,60.5,175856,4.8
West Virginia,2017,1,782265,53.2,739919,50.3,42346,5.4
Wisconsin,2017,1,3127591,67.9,3017513,65.5,110078,3.5
Wyoming,2017,1,295389,66.1,281107,62.9,14282,4.8
Alabama,2017,2,2199698,56.7,2084290,53.7,115408,5.2
Alaska,2017,2,361924,66.2,338214,61.9,23710,6.6
Arizona,2017,2,3214755,60.5,3049108,57.4,165647,5.2
Arkansas,2017,2,1342683,58.2,1292667,56.0,50016,3.7
California,2017,2,19127260,62.2,18143666,59.0,983594,5.1
Los Angeles County,2017,2,5086663,63.0,4833193,59.9,253470,5.0
Colorado,2017,2,2920347,67.1,2847403,65.5,72944,2.5
Connecticut,2017,2,1927400,66.5,1840062,63.5,87338,4.5
Delaware,2017,2,472026,62.0,450089,59.2,21937,4.6
District of Columbia,2017,2,390854,70.2,366529,65.9,24325,6.2
Florida,2017,2,9918105,59.3,9463848,56.6,454257,4.6
Georgia,2017,2,5079507,63.8,4819383,60.6,260124,5.1
Hawaii,2017,2,698076,62.3,680263,60.8,17813,2.6
Idaho,2017,2,829087,63.7,801101,61.5,27986,3.4
Illinois,2017,2,6559916,64.7,6223864,61.4,336052,5.1
Indiana,2017,2,3321490,64.1,3199571,61.8,121919,3.7
Iowa,2017,2,1695743,68.9,1640706,66.7,55037,3.2
Kansas,2017,2,1488309,66.9,1432394,64.3,55915,3.8
Kentucky,2017,2,2048540,58.8,1945461,55.8,103079,5.0
Louisiana,2017,2,2108908,58.8,1988965,55.5,119943,5.7
Maine,2017,2,703204,63.7,679065,61.5,24139,3.4
Maryland,2017,2,3226867,67.4,3097289,64.7,129578,4.0
Massachusetts,2017,2,3697820,65.6,3555672,63.1,142148,3.8
Michigan,2017,2,4896252,61.3,4668276,58.5,227976,4.7
Minnesota,2017,2,3058235,70.1,2943856,67.5,114379,3.7
Mississippi,2017,2,1274798,55.8,1204659,52.7,70139,5.5
Missouri,2017,2,3056298,64.1,2932205,61.5,124093,4.1
Montana,2017,2,526050,63.2,504359,60.6,21691,4.1
Nebraska,2017,2,1018915,69.3,988190,67.2,30725,3.0
Nevada,2017,2,1427127,62.3,1351001,59.0,76126,5.3
New Hampshire,2017,2,756515,68.2,734822,66.3,21693,2.9
New Jersey,2017,2,4611297,63.6,4402506,60.7,208791,4.5
New Mexico,2017,2,949289,58.4,886194,54.5,63095,6.6
New York,2017,2,9800351,60.7,9346626,57.8,453725,4.6
New York city,2017,2,4285301,60.5,4088992,57.7,196309,4.6
North Carolina,2017,2,4834668,61.3,4606000,58.4,228668,4.7
North Dakota,2017,2,416427,70.9,404812,68.9,11615,2.8
Ohio,2017,2,5803585,62.9,5501760,59.7,301825,5.2
Oklahoma,2017,2,1816717,60.9,1739314,58.3,77403,4.3
Oregon,2017,2,2056892,62.1,1974410,59.7,82482,4.0
Pennsylvania,2017,2,6493374,62.8,6160622,59.6,332752,5.1
Rhode Island,2017,2,566807,64.4,541089,61.5,25718,4.5
South Carolina,2017,2,2255750,58.2,2158908,55.7,96842,4.3
South Dakota,2017,2,454039,69.2,440022,67.1,14017,3.1
Tennessee,2017,2,3175086,60.3,3035834,57.7,139252,4.4
Texas,2017,2,13407092,63.8,12773175,60.8,633917,4.7
Utah,2017,2,1538289,68.7,1489301,66.5,48988,3.2
Vermont,2017,2,354646,67.3,343512,65.2,11134,3.1
Virginia,2017,2,4329575,65.6,4157544,63.0,172031,4.0
Washington,2017,2,3692432,63.5,3519115,60.6,173317,4.7
West Virginia,2017,2,781856,53.2,740956,50.4,40900,5.2
Wisconsin,2017,2,3130948,68.0,3024224,65.6,106724,3.4
Wyoming,2017,2,294904,66.0,281308,63.0,13596,4.6
Alabama,2017,3,2200069,56.7,2089481,53.8,110588,5.0
Alaska,2017,3,361919,66.2,338359,61.9,23560,6.5
Arizona,2017,3,3222018,60.6,3058180,57.5,163838,5.1
Arkansas,2017,3,1345009,58.2,1295409,56.1,49600,3.7
California,2017,3,19149284,62.3,18183179,59.1,966105,5.0
Los Angeles County,2017,3,5096340,63.1,4846471,60.0,249869,4.9
Colorado,2017,3,2930285,67.3,2859106,65.6,71179,2.4
Connecticut,2017,3,1929652,66.6,1842864,63.6,86788,4.5
Delaware,2017,3,472954,62.1,451138,59.2,21816,4.6
District of Columbia,2017,3,391575,70.3,367300,66.0,24275,6.2
Florida,2017,3,9942750,59.4,9497565,56.7,445185,4.5
Georgia,2017,3,5086362,63.9,4830976,60.7,255386,5.0
Hawaii,2017,3,698739,62.4,681195,60.8,17544,2.5
Idaho,2017,3,831417,63.7,804009,61.6,27408,3.3
Illinois,2017,3,6556181,64.7,6227973,61.4,328208,5.0
Indiana,2017,3,3324093,64.2,3206656,61.9,117437,3.5
Iowa,2017,3,1696350,68.9,1642428,66.7,53922,3.2
Kansas,2017,3,1488542,66.9,1433704,64.4,54838,3.7
Kentucky,2017,3,2052277,58.9,1949728,55.9,102549,5.0
Louisiana,2017,3,2109114,58.8,1992398,55.6,116716,5.5
Maine,2017,3,703885,63.7,679879,61.6,24006,3.4
Maryland,2017,3,3231923,67.5,3104255,64.8,127668,4.0
Massachusetts,2017,3,3706031,65.7,3563651,63.2,142380,3.8
Michigan,2017,3,4895969,61.3,4677098,58.6,218871,4.5
Minnesota,2017,3,3063521,70.1,2952217,67.6,111304,3.6
Mississippi,2017,3,1275006,55.8,1205901,52.8,69105,5.4
Missouri,2017,3,3055779,64.1,2935285,61.5,120494,3.9
Montana,2017,3,527001,63.2,505437,60.6,21564,4.1
Nebraska,2017,3,1019921,69.4,989735,67.3,30186,3.0
Nevada,2017,3,1431411,62.4,1356268,59.1,75143,5.2
New Hampshire,2017,3,757171,68.2,735746,66.3,21425,2.8
New Jersey,2017,3,4615010,63.6,4408891,60.8,206119,4.5
New Mexico,2017,3,950051,58.5,888083,54.6,61968,6.5
New York,2017,3,9817572,60.7,9366666,58.0,450906,4.6
New York city,2017,3,4293803,60.6,4099667,57.9,194136,4.5
North Carolina,2017,3,4840015,61.3,4616768,58.4,223247,4.6
North Dakota,2017,3,416974,71.0,405729,69.1,11245,2.7
Ohio,2017,3,5811518,63.0,5512940,59.8,298578,5.1
Oklahoma,2017,3,1818055,60.9,1742293,58.4,75762,4.2
Oregon,2017,3,2063722,62.3,1982317,59.8,81405,3.9
Pennsylvania,2017,3,6496779,62.8,6167358,59.6,329421,5.1
Rhode Island,2017,3,567226,64.4,541886,61.5,25340,4.5
South Carolina,2017,3,2257873,58.2,2162564,55.7,95309,4.2
South Dakota,2017,3,454502,69.2,440611,67.1,13891,3.1
Tennessee,2017,3,3179214,60.4,3047101,57.9,132113,4.2
Texas,2017,3,13429146,63.8,12805899,60.9,623247,4.6
Utah,2017,3,1543308,68.8,1494287,66.6,49021,3.2
Vermont,2017,3,354970,67.4,343933,65.3,11037,3.1
Virginia,2017,3,4339507,65.7,4170194,63.1,169313,3.9
Washington,2017,3,3701462,63.6,3530103,60.7,171359,4.6
West Virginia,2017,3,781658,53.2,741764,50.5,39894,5.1
Wisconsin,2017,3,3135502,68.0,3031417,65.8,104085,3.3
Wyoming,2017,3,294438,66.0,281517,63.1,12921,4.4
Alabama,2017,4,2200718,56.7,2094737,53.9,105981,4.8
Alaska,2017,4,361816,66.2,338325,61.9,23491,6.5
Arizona,2017,4,3229183,60.7,3067067,57.6,162116,5.0
Arkansas,2017,4,1347419,58.3,1297981,56.2,49438,3.7
California,2017,4,19172412,62.3,18220082,59.2,952330,5.0
Los Angeles County,2017,4,5105552,63.2,4857870,60.2,247682,4.9
Colorado,2017,4,2941271,67.4,2870457,65.8,70814,2.4
Connecticut,2017,4,1930564,66.6,1844343,63.6,86221,4.5
Delaware,2017,4,473834,62.2,452145,59.3,21689,4.6
District of Columbia,2017,4,392397,70.4,368146,66.1,24251,6.2
Florida,2017,4,9965664,59.5,9528286,56.9,437378,4.4
Georgia,2017,4,5094342,63.9,4843239,60.7,251103,4.9
Hawaii,2017,4,699003,62.4,681836,60.9,17167,2.5
Idaho,2017,4,833850,63.8,806935,61.7,26915,3.2
Illinois,2017,4,6555108,64.6,6231214,61.4,323894,4.9
Indiana,2017,4,3327805,64.2,3213301,62.0,114504,3.4
Iowa,2017,4,1697896,68.9,1644766,66.8,53130,3.1
Kansas,2017,4,1489349,66.9,1435017,64.5,54332,3.6
Kentucky,2017,4,2055149,58.9,1953059,56.0,102090,5.0
Louisiana,2017,4,2109123,58.8,1995730,55.7,113393,5.4
Maine,2017,4,704512,63.8,680519,61.6,23993,3.4
Maryland,2017,4,3237141,67.5,3110578,64.9,126563,3.9
Massachusetts,2017,4,3713689,65.8,3571035,63.3,142654,3.8
Michigan,2017,4,4897585,61.3,4684609,58.6,212976,4.3
Minnesota,2017,4,3068233,70.2,2959327,67.7,108906,3.5
Mississippi,2017,4,1275266,55.8,1206831,52.8,68435,5.4
Missouri,2017,4,3055812,64.1,2938558,61.6,117254,3.8
Montana,2017,4,527966,63.3,506451,60.7,21515,4.1
Nebraska,2017,4,1021255,69.4,991350,67.4,29905,2.9
Nevada,2017,4,1435347,62.4,1361526,59.2,73821,5.1
New Hampshire,2017,4,757810,68.2,736689,66.3,21121,2.8
New Jersey,2017,4,4619442,63.6,4414239,60.8,205203,4.4
New Mexico,2017,4,950523,58.5,889828,54.7,60695,6.4
New York,2017,4,9835869,60.9,9384093,58.1,451776,4.6
New York city,2017,4,4301819,60.7,4107720,58.0,194099,4.5
North Carolina,2017,4,4847192,61.3,4627549,58.5,219643,4.5
North Dakota,2017,4,417282,71.0,406414,69.2,10868,2.6
Ohio,2017,4,5818553,63.1,5523019,59.9,295534,5.1
Oklahoma,2017,4,1820464,61.0,1745904,58.5,74560,4.1
Oregon,2017,4,2071449,62.4,1990080,60.0,81369,3.9
Pennsylvania,2017,4,6498146,62.8,6171838,59.6,326308,5.0
Rhode Island,2017,4,567546,64.4,542434,61.6,25112,4.4
South Carolina,2017,4,2260249,58.2,2166033,55.7,94216,4.2
South Dakota,2017,4,455014,69.2,441183,67.1,13831,3.0
Tennessee,2017,4,3184140,60.4,3059223,58.0,124917,3.9
Texas,2017,4,13448306,63.8,12838380,60.9,609926,4.5
Utah,2017,4,1548135,68.9,1498943,66.7,49192,3.2
Vermont,2017,4,355243,67.4,344374,65.3,10869,3.1
Virginia,2017,4,4347838,65.7,4181768,63.2,166070,3.8
Washington,2017,4,3710929,63.7,3540606,60.7,170323,4.6
West Virginia,2017,4,781942,53.2,742508,50.5,39434,5.0
Wisconsin,2017,4,3140437,68.1,3037886,65.9,102551,3.3
Wyoming,2017,4,294093,65.9,281693,63.2,12400,4.2
Alabama,2017,5,2201642,56.7,2100033,54.0,101609,4.6
Alaska,2017,5,361601,66.2,338131,61.9,23470,6.5
Arizona,2017,5,3235526,60.7,3075187,57.7,160339,5.0
Arkansas,2017,5,1349569,58.4,1300097,56.3,49472,3.7
California,2017,5,19193658,62.4,18252450,59.3,941208,4.9
Los Angeles County,2017,5,5113420,63.3,4867025,60.3,246395,4.8
Colorado,2017,5,2952554,67.6,2880674,66.0,71880,2.4
Connecticut,2017,5,1930068,66.6,1844470,63.6,85598,4.4
Delaware,2017,5,474720,62.2,453188,59.4,21532,4.5
District of Columbia,2017,5,393227,70.5,369006,66.2,24221,6.2
Florida,2017,5,9982016,59.5,9551303,56.9,430713,4.3
Georgia,2017,5,5103277,63.9,4856196,60.8,247081,4.8
Hawaii,2017,5,698628,62.4,682060,60.9,16568,2.4
Idaho,2017,5,836335,63.8,809789,61.8,26546,3.2
Illinois,2017,5,6556293,64.7,6233870,61.5,322423,4.9
Indiana,2017,5,3331884,64.3,3218341,62.1,113543,3.4
Iowa,2017,5,1699561,69.0,1646955,66.9,52606,3.1
Kansas,2017,5,1490429,66.9,1436226,64.5,54203,3.6
Kentucky,2017,5,2056962,59.0,1955520,56.1,101442,4.9
Louisiana,2017,5,2108626,58.8,1998677,55.7,109949,5.2
Maine,2017,5,705023,63.8,681002,61.6,24021,3.4
Maryland,2017,5,3242668,67.6,3116341,65.0,126327,3.9
Massachusetts,2017,5,3720395,65.9,3577599,63.3,142796,3.8
Michigan,2017,5,4902149,61.3,4690213,58.7,211936,4.3
Minnesota,2017,5,3072030,70.2,2964839,67.8,107191,3.5
Mississippi,2017,5,1275453,55.8,1207603,52.9,67850,5.3
Missouri,2017,5,3056058,64.0,2941772,61.6,114286,3.7
Montana,2017,5,528803,63.3,507282,60.7,21521,4.1
Nebraska,2017,5,1022712,69.5,992866,67.4,29846,2.9
Nevada,2017,5,1438906,62.5,1366662,59.4,72244,5.0
New Hampshire,2017,5,758365,68.2,737463,66.4,20902,2.8
New Jersey,2017,5,4623330,63.7,4417571,60.8,205759,4.5
New Mexico,2017,5,950564,58.5,891259,54.8,59305,6.2
New York,2017,5,9852683,60.9,9398001,58.1,454682,4.6
New York city,2017,5,4308587,60.8,4113325,58.0,195262,4.5
North Carolina,2017,5,4856677,61.3,4638960,58.6,217717,4.5
North Dakota,2017,5,417252,71.0,406697,69.2,10555,2.5
Ohio,2017,5,5824602,63.1,5531724,59.9,292878,5.0
Oklahoma,2017,5,1823836,61.1,1750065,58.6,73771,4.0
Oregon,2017,5,2078660,62.6,1996510,60.1,82150,4.0
Pennsylvania,2017,5,6496113,62.8,6173003,59.6,323110,5.0
Rhode Island,2017,5,567818,64.4,542809,61.6,25009,4.4
South Carolina,2017,5,2262759,58.1,2169130,55.7,93629,4.1
South Dakota,2017,5,455572,69.3,441739,67.2,13833,3.0
Tennessee,2017,5,3189735,60.5,3071352,58.2,118383,3.7
Texas,2017,5,13464024,63.8,12868903,61.0,595121,4.4
Utah,2017,5,1552513,68.9,1503169,66.7,49344,3.2
Vermont,2017,5,355445,67.4,344781,65.4,10664,3.0
Virginia,2017,5,4354662,65.8,4192147,63.3,162515,3.7
Washington,2017,5,3720366,63.7,3550246,60.8,170120,4.6
West Virginia,2017,5,782759,53.3,743381,50.6,39378,5.0
Wisconsin,2017,5,3145031,68.2,3042977,66.0,102054,3.2
Wyoming,2017,5,293917,65.9,281799,63.2,12118,4.1
Alabama,2017,6,2202497,56.7,2104727,54.1,97770,4.4
Alaska,2017,6,361303,66.1,337822,61.8,23481,6.5
Arizona,2017,6,3240691,60.7,3081904,57.8,158787,4.9
Arkansas,2017,6,1351134,58.4,1301422,56.3,49712,3.7
California,2017,6,19209913,62.4,18277837,59.4,932076,4.9
Los Angeles County,2017,6,5119263,63.4,4873614,60.3,245649,4.8
Colorado,2017,6,2963235,67.8,2888997,66.1,74238,2.5
Connecticut,2017,6,1928233,66.5,1843190,63.6,85043,4.4
Delaware,2017,6,475584,62.3,454216,59.5,21368,4.5
District of Columbia,2017,6,393872,70.6,369704,66.3,24168,6.1
Florida,2017,6,9990313,59.4,9564671,56.9,425642,4.3
Georgia,2017,6,5112111,64.0,4868580,60.9,243531,4.8
Hawaii,2017,6,697513,62.3,681765,60.8,15748,2.3
Idaho,2017,6,838842,63.9,812467,61.9,26375,3.1
Illinois,2017,6,6558948,64.7,6235783,61.5,323165,4.9
Indiana,2017,6,3335421,64.3,3221008,62.1,114413,3.4
Iowa,2017,6,1700553,69.0,1648287,66.9,52266,3.1
Kansas,2017,6,1491269,67.0,1437066,64.5,54203,3.6
Kentucky,2017,6,2057642,59.0,1957047,56.1,100595,4.9
Louisiana,2017,6,2107721,58.8,2000996,55.8,106725,5.1
Maine,2017,6,705310,63.8,681228,61.6,24082,3.4
Maryland,2017,6,3248037,67.7,3121014,65.1,127023,3.9
Massachusetts,2017,6,3725928,65.9,3583056,63.4,142872,3.8
Michigan,2017,6,4908978,61.4,4693648,58.7,215330,4.4
Minnesota,2017,6,3074738,70.2,2968624,67.8,106114,3.5
Mississippi,2017,6,1275119,55.8,1207857,52.9,67262,5.3
Missouri,2017,6,3056124,64.0,2944244,61.7,111880,3.7
Montana,2017,6,529395,63.3,507800,60.7,21595,4.1
Nebraska,2017,6,1024040,69.5,994089,67.5,29951,2.9
Nevada,2017,6,1442180,62.6,1371436,59.5,70744,4.9
New Hampshire,2017,6,758744,68.2,737883,66.3,20861,2.7
New Jersey,2017,6,4625598,63.6,4418021,60.8,207577,4.5
New Mexico,2017,6,950091,58.4,892199,54.9,57892,6.1
New York,2017,6,9865598,61.0,9407322,58.2,458276,4.6
New York city,2017,6,4313385,60.8,4116887,58.1,196498,4.6
North Carolina,2017,6,4867493,61.4,4650257,58.7,217236,4.5
North Dakota,2017,6,416868,71.0,406504,69.2,10364,2.5
Ohio,2017,6,5829922,63.1,5538880,60.0,291042,5.0
Oklahoma,2017,6,1827363,61.2,1754030,58.7,73333,4.0
Oregon,2017,6,2083955,62.6,2000509,60.1,83446,4.0
Pennsylvania,2017,6,6491089,62.7,6170674,59.6,320415,4.9
Rhode Island,2017,6,568094,64.4,543011,61.6,25083,4.4
South Carolina,2017,6,2265091,58.1,2171395,55.7,93696,4.1
South Dakota,2017,6,456058,69.3,442179,67.2,13879,3.0
Tennessee,2017,6,3195545,60.5,3082091,58.4,113454,3.6
Texas,2017,6,13476361,63.8,12894947,61.1,581414,4.3
Utah,2017,6,1556173,68.9,1506746,66.7,49427,3.2
Vermont,2017,6,355561,67.4,345064,65.4,10497,3.0
Virginia,2017,6,4359665,65.8,4200505,63.4,159160,3.7
Washington,2017,6,3729167,63.8,3558488,60.9,170679,4.6
West Virginia,2017,6,783929,53.4,744274,50.7,39655,5.1
Wisconsin,2017,6,3148514,68.2,3046157,66.0,102357,3.3
Wyoming,2017,6,293892,66.0,281770,63.2,12122,4.1
Alabama,2017,7,2203232,56.6,2108489,54.2,94743,4.3
Alaska,2017,7,360916,66.1,337403,61.7,23513,6.5
Arizona,2017,7,3245145,60.7,3087275,57.8,157870,4.9
Arkansas,2017,7,1351933,58.5,1301824,56.3,50109,3.7
California,2017,7,19220058,62.4,18295974,59.4,924084,4.8
Los Angeles County,2017,7,5122874,63.4,4877752,60.4,245122,4.8
Colorado,2017,7,2973006,67.9,2895586,66.1,77420,2.6
Connecticut,2017,7,1925520,66.4,1840878,63.5,84642,4.4
Delaware,2017,7,476348,62.3,455117,59.6,21231,4.5
District of Columbia,2017,7,394348,70.6,370273,66.3,24075,6.1
Florida,2017,7,9992489,59.4,9570284,56.9,422205,4.2
Georgia,2017,7,5119769,64.0,4879233,61.0,240536,4.7
Hawaii,2017,7,695816,62.1,681002,60.8,14814,2.1
Idaho,2017,7,841394,63.9,814980,61.9,26414,3.1
Illinois,2017,7,6562474,64.7,6237591,61.5,324883,5.0
Indiana,2017,7,3338155,64.3,3221914,62.1,116241,3.5
Iowa,2017,7,1700544,69.0,1648568,66.9,51976,3.1
Kansas,2017,7,1491424,67.0,1437289,64.5,54135,3.6
Kentucky,2017,7,2057506,58.9,1958016,56.1,99490,4.8
Louisiana,2017,7,2106949,58.8,2002832,55.9,104117,4.9
Maine,2017,7,705343,63.8,681199,61.6,24144,3.4
Maryland,2017,7,3252578,67.8,3124032,65.1,128546,4.0
Massachusetts,2017,7,3730379,65.9,3587404,63.4,142975,3.8
Michigan,2017,7,4916658,61.4,4694847,58.7,221811,4.5
Minnesota,2017,7,3076593,70.2,2970957,67.8,105636,3.4
Mississippi,2017,7,1274114,55.8,1207439,52.8,66675,5.2
Missouri,2017,7,3055731,64.0,2945386,61.7,110345,3.6
Montana,2017,7,529710,63.3,507986,60.7,21724,4.1
Nebraska,2017,7,1025081,69.5,994852,67.5,30229,2.9
Nevada,2017,7,1445520,62.6,1375795,59.6,69725,4.8
New Hampshire,2017,7,758881,68.2,737898,66.3,20983,2.8
New Jersey,2017,7,4625490,63.6,4415446,60.7,210044,4.5
New Mexico,2017,7,949257,58.3,892654,54.9,56603,6.0
New York,2017,7,9872094,61.0,9410601,58.2,461493,4.7
New York city,2017,7,4314900,60.8,4117855,58.1,197045,4.6
North Carolina,2017,7,4878081,61.5,4660009,58.7,218072,4.5
North Dakota,2017,7,416228,70.8,405903,69.1,10325,2.5
Ohio,2017,7,5834261,63.2,5544228,60.0,290033,5.0
Oklahoma,2017,7,1830241,61.3,1757151,58.8,73090,4.0
Oregon,2017,7,2086668,62.6,2001713,60.1,84955,4.1
Pennsylvania,2017,7,6484963,62.6,6166001,59.5,318962,4.9
Rhode Island,2017,7,568432,64.4,543089,61.6,25343,4.5
South Carolina,2017,7,2266673,58.1,2172303,55.7,94370,4.2
South Dakota,2017,7,456269,69.2,442319,67.1,13950,3.1
Tennessee,2017,7,3201412,60.6,3090836,58.5,110576,3.5
Texas,2017,7,13486545,63.8,12915730,61.1,570815,4.2
Utah,2017,7,1559136,68.9,1509675,66.7,49461,3.2
Vermont,2017,7,355638,67.4,345221,65.4,10417,2.9
Virginia,2017,7,4362829,65.8,4206323,63.5,156506,3.6
Washington,2017,7,3737064,63.8,3565091,60.9,171973,4.6
West Virginia,2017,7,785269,53.5,745020,50.8,40249,5.1
Wisconsin,2017,7,3150342,68.2,3047331,66.0,103011,3.3
Wyoming,2017,7,293905,66.0,281599,63.2,12306,4.2
Alabama,2017,8,2203843,56.6,2111469,54.2,92374,4.2
Alaska,2017,8,360404,66.0,336888,61.6,23516,6.5
Arizona,2017,8,3248948,60.7,3091379,57.8,157569,4.8
Arkansas,2017,8,1351813,58.4,1301295,56.2,50518,3.7
California,2017,8,19221629,62.3,18307232,59.4,914397,4.8
Los Angeles County,2017,8,5123793,63.4,4879572,60.4,244221,4.8
Colorado,2017,8,2981249,68.0,2900866,66.1,80383,2.7
Connecticut,2017,8,1922196,66.2,1837969,63.3,84227,4.4
Delaware,2017,8,476879,62.3,455788,59.6,21091,4.4
District of Columbia,2017,8,394563,70.6,370657,66.3,23906,6.1
Florida,2017,8,9991052,59.3,9571788,56.8,419264,4.2
Georgia,2017,8,5124787,64.0,4887201,61.0,237586,4.6
Hawaii,2017,8,693848,61.9,679954,60.6,13894,2.0
Idaho,2017,8,843855,64.0,817266,62.0,26589,3.2
Illinois,2017,8,6564703,64.7,6239573,61.5,325130,5.0
Indiana,2017,8,3339376,64.3,3221848,62.0,117528,3.5
Iowa,2017,8,1699477,68.9,1648009,66.8,51468,3.0
Kansas,2017,8,1490537,66.9,1436741,64.5,53796,3.6
Kentucky,2017,8,2056456,58.9,1958734,56.1,97722,4.8
Louisiana,2017,8,2106561,58.7,2004515,55.9,102046,4.8
Maine,2017,8,704992,63.7,680930,61.5,24062,3.4
Maryland,2017,8,3255258,67.8,3124951,65.1,130307,4.0
Massachusetts,2017,8,3733717,66.0,3590897,63.4,142820,3.8
Michigan,2017,8,4922722,61.5,4693937,58.6,228785,4.6
Minnesota,2017,8,3077320,70.2,2972123,67.8,105197,3.4
Mississippi,2017,8,1272449,55.7,1206728,52.8,65721,5.2
Missouri,2017,8,3054426,63.9,2944891,61.6,109535,3.6
Montana,2017,8,529722,63.2,507933,60.6,21789,4.1
Nebraska,2017,8,1025609,69.5,995094,67.5,30515,3.0
Nevada,2017,8,1449012,62.6,1379704,59.6,69308,4.8
New Hampshire,2017,8,758800,68.1,737635,66.2,21165,2.8
New Jersey,2017,8,4622153,63.5,4410238,60.6,211915,4.6
New Mexico,2017,8,948194,58.3,892747,54.8,55447,5.8
New York,2017,8,9870248,61.0,9407451,58.1,462797,4.7
New York city,2017,8,4312352,60.8,4115981,58.0,196371,4.6
North Carolina,2017,8,4886091,61.5,4667119,58.7,218972,4.5
North Dakota,2017,8,415469,70.7,405078,68.9,10391,2.5
Ohio,2017,8,5834899,63.1,5546538,60.0,288361,4.9
Oklahoma,2017,8,1832044,61.3,1759249,58.9,72795,4.0
Oregon,2017,8,2087018,62.6,2000873,60.0,86145,4.1
Pennsylvania,2017,8,6478865,62.5,6160498,59.5,318367,4.9
Rhode Island,2017,8,568723,64.4,543076,61.5,25647,4.5
South Carolina,2017,8,2266940,58.1,2171730,55.6,95210,4.2
South Dakota,2017,8,456284,69.2,442300,67.1,13984,3.1
Tennessee,2017,8,3206644,60.6,3097281,58.5,109363,3.4
Texas,2017,8,13495091,63.7,12931972,61.1,563119,4.2
Utah,2017,8,1561331,68.9,1511971,66.7,49360,3.2
Vermont,2017,8,355664,67.3,345249,65.4,10415,2.9
Virginia,2017,8,4364018,65.8,4209550,63.5,154468,3.5
Washington,2017,8,3743266,63.8,3569864,60.9,173402,4.6
West Virginia,2017,8,786433,53.6,745515,50.9,40918,5.2
Wisconsin,2017,8,3149928,68.2,3046854,65.9,103074,3.3
Wyoming,2017,8,293795,66.0,281298,63.2,12497,4.3
Alabama,2017,9,2204575,56.6,2114006,54.3,90569,4.1
Alaska,2017,9,359766,65.8,336298,61.5,23468,6.5
Arizona,2017,9,3252264,60.7,3094480,57.7,157784,4.9
Arkansas,2017,9,1350879,58.4,1300061,56.2,50818,3.8
California,2017,9,19215041,62.3,18312935,59.4,902106,4.7
Los Angeles County,2017,9,5122100,63.4,4879189,60.4,242911,4.7
Colorado,2017,9,2987772,68.0,2905274,66.1,82498,2.8
Connecticut,2017,9,1918762,66.1,1835036,63.2,83726,4.4
Delaware,2017,9,477134,62.3,456213,59.6,20921,4.4
District of Columbia,2017,9,394548,70.6,370865,66.3,23683,6.0
Florida,2017,9,9989384,59.2,9573364,56.7,416020,4.2
Georgia,2017,9,5126751,63.9,4892228,61.0,234523,4.6
Hawaii,2017,9,691983,61.7,678813,60.5,13170,1.9
Idaho,2017,9,845994,64.0,819239,62.0,26755,3.2
Illinois,2017,9,6564712,64.7,6241648,61.5,323064,4.9
Indiana,2017,9,3338942,64.2,3221577,62.0,117365,3.5
Iowa,2017,9,1697774,68.8,1647100,66.7,50674,3.0
Kansas,2017,9,1488669,66.8,1435493,64.4,53176,3.6
Kentucky,2017,9,2054594,58.8,1959273,56.1,95321,4.6
Louisiana,2017,9,2106373,58.7,2005913,55.9,100460,4.8
Maine,2017,9,704221,63.6,680467,61.4,23754,3.4
Maryland,2017,9,3255786,67.8,3123986,65.0,131800,4.0
Massachusetts,2017,9,3736497,66.0,3594194,63.4,142303,3.8
Michigan,2017,9,4925268,61.5,4691656,58.6,233612,4.7
Minnesota,2017,9,3077085,70.1,2972553,67.7,104532,3.4
Mississippi,2017,9,1270213,55.6,1205682,52.8,64531,5.1
Missouri,2017,9,3052116,63.9,2942970,61.6,109146,3.6
Montana,2017,9,529534,63.1,507771,60.5,21763,4.1
Nebraska,2017,9,1025624,69.5,994949,67.4,30675,3.0
Nevada,2017,9,1452637,62.7,1383214,59.7,69423,4.8
New Hampshire,2017,9,758648,68.1,737338,66.2,21310,2.8
New Jersey,2017,9,4616269,63.4,4403727,60.5,212542,4.6
New Mexico,2017,9,947109,58.2,892724,54.8,54385,5.7
New York,2017,9,9860903,60.9,9399265,58.1,461638,4.7
New York city,2017,9,4306645,60.7,4112266,58.0,194379,4.5
North Carolina,2017,9,4890096,61.5,4671175,58.7,218921,4.5
North Dakota,2017,9,414730,70.5,404220,68.7,10510,2.5
Ohio,2017,9,5829698,63.1,5545045,60.0,284653,4.9
Oklahoma,2017,9,1832860,61.3,1760592,58.9,72268,3.9
Oregon,2017,9,2086104,62.5,1999344,59.9,86760,4.2
Pennsylvania,2017,9,6473619,62.5,6155362,59.4,318257,4.9
Rhode Island,2017,9,568878,64.4,542976,61.5,25902,4.6
South Carolina,2017,9,2265919,58.0,2170172,55.5,95747,4.2
South Dakota,2017,9,455863,69.1,441913,67.0,13950,3.1
Tennessee,2017,9,3210372,60.6,3101083,58.5,109289,3.4
Texas,2017,9,13503616,63.7,12945812,61.1,557804,4.1
Utah,2017,9,1562843,68.8,1513729,66.6,49114,3.1
Vermont,2017,9,355642,67.3,345179,65.3,10463,2.9
Virginia,2017,9,4363693,65.7,4210984,63.4,152709,3.5
Washington,2017,9,3747314,63.8,3572996,60.8,174318,4.7
West Virginia,2017,9,787155,53.7,745669,50.9,41486,5.3
Wisconsin,2017,9,3147440,68.1,3045565,65.9,101875,3.2
Wyoming,2017,9,293545,65.9,280899,63.1,12646,4.3
Alabama,2017,10,2205842,56.6,2116522,54.3,89320,4.0
Alaska,2017,10,359052,65.7,335702,61.4,23350,6.5
Arizona,2017,10,3255727,60.6,3097498,57.7,158229,4.9
Arkansas,2017,10,1349529,58.3,1298573,56.1,50956,3.8
California,2017,10,19204052,62.2,18316581,59.3,887471,4.6
Los Angeles County,2017,10,5118482,63.3,4877180,60.3,241302,4.7
Colorado,2017,10,2993236,68.0,2909396,66.1,83840,2.8
Connecticut,2017,10,1915879,66.0,1832749,63.1,83130,4.3
Delaware,2017,10,477200,62.2,456491,59.5,20709,4.3
District of Columbia,2017,10,394486,70.5,371013,66.3,23473,6.0
Florida,2017,10,9991165,59.1,9578823,56.7,412342,4.1
Georgia,2017,10,5126320,63.9,4894923,61.0,231397,4.5
Hawaii,2017,10,690640,61.5,677815,60.4,12825,1.9
Idaho,2017,10,847754,64.0,821014,62.0,26740,3.2
Illinois,2017,10,6563820,64.7,6244566,61.6,319254,4.9
Indiana,2017,10,3338238,64.2,3222593,62.0,115645,3.5
Iowa,2017,10,1696152,68.7,1646476,66.7,49676,2.9
Kansas,2017,10,1486252,66.7,1433830,64.3,52422,3.5
Kentucky,2017,10,2052327,58.7,1959688,56.1,92639,4.5
Louisiana,2017,10,2106403,58.7,2006969,56.0,99434,4.7
Maine,2017,10,703145,63.4,679929,61.3,23216,3.3
Maryland,2017,10,3254560,67.7,3121982,64.9,132578,4.1
Massachusetts,2017,10,3739791,66.0,3598295,63.5,141496,3.8
Michigan,2017,10,4924445,61.5,4689603,58.5,234842,4.8
Minnesota,2017,10,3076436,70.0,2972950,67.7,103486,3.4
Mississippi,2017,10,1268736,55.5,1205286,52.8,63450,5.0
Missouri,2017,10,3049100,63.8,2940292,61.5,108808,3.6
Montana,2017,10,529329,63.0,507693,60.5,21636,4.1
Nebraska,2017,10,1025402,69.4,994689,67.3,30713,3.0
Nevada,2017,10,1456539,62.7,1386589,59.7,69950,4.8
New Hampshire,2017,10,758621,68.0,737283,66.1,21338,2.8
New Jersey,2017,10,4609435,63.3,4397686,60.4,211749,4.6
New Mexico,2017,10,946178,58.1,892867,54.8,53311,5.6
New York,2017,10,9846668,60.8,9388484,58.0,458184,4.7
New York city,2017,10,4299268,60.6,4107804,57.9,191464,4.5
North Carolina,2017,10,4889994,61.4,4672542,58.7,217452,4.4
North Dakota,2017,10,414181,70.4,403543,68.6,10638,2.6
Ohio,2017,10,5819720,62.9,5540955,59.9,278765,4.8
Oklahoma,2017,10,1833120,61.3,1761711,58.9,71409,3.9
Oregon,2017,10,2084732,62.4,1997970,59.8,86762,4.2
Pennsylvania,2017,10,6469541,62.4,6151692,59.3,317849,4.9
Rhode Island,2017,10,568910,64.4,542867,61.4,26043,4.6
South Carolina,2017,10,2264088,57.9,2168436,55.4,95652,4.2
South Dakota,2017,10,455660,69.0,441816,66.9,13844,3.0
Tennessee,2017,10,3212576,60.6,3102731,58.5,109845,3.4
Texas,2017,10,13513945,63.7,12959897,61.0,554048,4.1
Utah,2017,10,1563968,68.7,1515235,66.6,48733,3.1
Vermont,2017,10,355610,67.3,345095,65.3,10515,3.0
Virginia,2017,10,4362892,65.7,4211968,63.4,150924,3.5
Washington,2017,10,3749967,63.8,3575464,60.8,174503,4.7
West Virginia,2017,10,787430,53.7,745509,50.9,41921,5.3
Wisconsin,2017,10,3143901,68.0,3044438,65.8,99463,3.2
Wyoming,2017,10,293166,65.8,280475,63.0,12691,4.3
Alabama,2017,11,2207993,56.6,2119284,54.4,88709,4.0
Alaska,2017,11,358314,65.6,335142,61.3,23172,6.5
Arizona,2017,11,3260024,60.6,3101312,57.7,158712,4.9
Arkansas,2017,11,1348158,58.2,1297139,56.0,51019,3.8
California,2017,11,19193135,62.2,18320848,59.3,872287,4.5
Los Angeles County,2017,11,5114537,63.3,4874731,60.3,239806,4.7
Colorado,2017,11,2998232,68.1,2913494,66.1,84738,2.8
Connecticut,2017,11,1913860,65.9,1831392,63.0,82468,4.3
Delaware,2017,11,477198,62.2,456726,59.5,20472,4.3
District of Columbia,2017,11,394554,70.5,371205,66.3,23349,5.9
Florida,2017,11,9997632,59.1,9589039,56.7,408593,4.1
Georgia,2017,11,5124282,63.8,4895940,60.9,228342,4.5
Hawaii,2017,11,690058,61.5,677106,60.3,12952,1.9
Idaho,2017,11,849162,64.0,822645,62.0,26517,3.1
Illinois,2017,11,6562511,64.7,6248693,61.6,313818,4.8
Indiana,2017,11,3338651,64.2,3225487,62.0,113164,3.4
Iowa,2017,11,1695053,68.6,1646441,66.7,48612,2.9
Kansas,2017,11,1483917,66.5,1432248,64.2,51669,3.5
Kentucky,2017,11,2050175,58.6,1960040,56.1,90135,4.4
Louisiana,2017,11,2107102,58.8,2008039,56.0,99063,4.7
Maine,2017,11,701954,63.3,679429,61.3,22525,3.2
Maryland,2017,11,3252112,67.6,3119773,64.9,132339,4.1
Massachusetts,2017,11,3744389,66.0,3603792,63.5,140597,3.8
Michigan,2017,11,4921884,61.4,4689031,58.5,232853,4.7
Minnesota,2017,11,3075555,70.0,2973295,67.6,102260,3.3
Mississippi,2017,11,1267423,55.5,1204790,52.7,62633,4.9
Missouri,2017,11,3046091,63.7,2937776,61.4,108315,3.6
Montana,2017,11,529187,63.0,507763,60.4,21424,4.0
Nebraska,2017,11,1025248,69.4,994579,67.3,30669,3.0
Nevada,2017,11,1460795,62.8,1390016,59.7,70779,4.8
New Hampshire,2017,11,758833,68.0,737561,66.1,21272,2.8
New Jersey,2017,11,4602632,63.2,4392811,60.3,209821,4.6
New Mexico,2017,11,945481,58.0,893299,54.8,52182,5.5
New York,2017,11,9830847,60.7,9377414,57.9,453433,4.6
New York city,2017,11,4291736,60.5,4103231,57.8,188505,4.4
North Carolina,2017,11,4887261,61.3,4672554,58.6,214707,4.4
North Dakota,2017,11,413872,70.3,403097,68.5,10775,2.6
Ohio,2017,11,5807581,62.8,5535041,59.8,272540,4.7
Oklahoma,2017,11,1833177,61.3,1762825,58.9,70352,3.8
Oregon,2017,11,2083101,62.3,1996852,59.7,86249,4.1
Pennsylvania,2017,11,6466394,62.3,6149558,59.3,316836,4.9
Rhode Island,2017,11,568872,64.3,542833,61.4,26039,4.6
South Carolina,2017,11,2261774,57.7,2167270,55.3,94504,4.2
South Dakota,2017,11,455426,68.9,441706,66.9,13720,3.0
Tennessee,2017,11,3214155,60.6,3103452,58.5,110703,3.4
Texas,2017,11,13527004,63.6,12974970,61.0,552034,4.1
Utah,2017,11,1564982,68.6,1516673,66.5,48309,3.1
Vermont,2017,11,355605,67.2,345035,65.2,10570,3.0
Virginia,2017,11,4362552,65.7,4213541,63.4,149011,3.4
Washington,2017,11,3752292,63.7,3578113,60.7,174179,4.6
West Virginia,2017,11,787406,53.8,745139,50.9,42267,5.4
Wisconsin,2017,11,3140231,67.8,3043660,65.8,96571,3.1
Wyoming,2017,11,292717,65.7,280093,62.9,12624,4.3
Alabama,2017,12,2211270,56.7,2122773,54.4,88497,4.0
Alaska,2017,12,357632,65.5,334722,61.3,22910,6.4
Arizona,2017,12,3265952,60.7,3107262,57.7,158690,4.9
Arkansas,2017,12,1347206,58.1,1296258,55.9,50948,3.8
California,2017,12,19189000,62.1,18331881,59.3,857119,4.5
Los Angeles County,2017,12,5112209,63.2,4873883,60.3,238326,4.7
Colorado,2017,12,3003856,68.1,2918625,66.2,85231,2.8
Connecticut,2017,12,1913150,65.8,1831551,63.0,81599,4.3
Delaware,2017,12,477330,62.1,457153,59.5,20177,4.2
District of Columbia,2017,12,394839,70.5,371560,66.3,23279,5.9
Florida,2017,12,10009156,59.1,9604892,56.7,404264,4.0
Georgia,2017,12,5121949,63.7,4896980,60.9,224969,4.4
Hawaii,2017,12,690394,61.5,676938,60.3,13456,1.9
Idaho,2017,12,850457,64.0,824364,62.0,26093,3.1
Illinois,2017,12,6561498,64.7,6255004,61.7,306494,4.7
Indiana,2017,12,3341850,64.2,3231082,62.1,110768,3.3
Iowa,2017,12,1695075,68.6,1647607,66.7,47468,2.8
Kansas,2017,12,1482474,66.5,1431598,64.2,50876,3.4
Kentucky,2017,12,2048835,58.6,1960723,56.1,88112,4.3
Louisiana,2017,12,2108887,58.8,2009776,56.0,99111,4.7
Maine,2017,12,701023,63.2,679269,61.2,21754,3.1
Maryland,2017,12,3249421,67.5,3118863,64.8,130558,4.0
Massachusetts,2017,12,3751631,66.1,3612149,63.7,139482,3.7
Michigan,2017,12,4920031,61.4,4691756,58.5,228275,4.6
Minnesota,2017,12,3075176,69.9,2974306,67.6,100870,3.3
Mississippi,2017,12,1266891,55.5,1204763,52.8,62128,4.9
Missouri,2017,12,3044088,63.6,2936798,61.4,107290,3.5
Montana,2017,12,529223,62.9,508109,60.4,21114,4.0
Nebraska,2017,12,1025474,69.3,995014,67.3,30460,3.0
Nevada,2017,12,1465560,62.9,1393994,59.8,71566,4.9
New Hampshire,2017,12,759460,68.0,738354,66.1,21106,2.8
New Jersey,2017,12,4596953,63.0,4390479,60.2,206474,4.5
New Mexico,2017,12,945193,58.0,894267,54.8,50926,5.4
New York,2017,12,9817592,60.6,9370967,57.8,446625,4.5
New York city,2017,12,4285758,60.4,4100310,57.8,185448,4.3
North Carolina,2017,12,4885076,61.2,4674384,58.6,210692,4.3
North Dakota,2017,12,413778,70.3,402903,68.4,10875,2.6
Ohio,2017,12,5797032,62.6,5529682,59.8,267350,4.6
Oklahoma,2017,12,1833562,61.3,1764458,59.0,69104,3.8
Oregon,2017,12,2081495,62.2,1996148,59.6,85347,4.1
Pennsylvania,2017,12,6465239,62.3,6150734,59.3,314505,4.9
Rhode Island,2017,12,568957,64.3,543131,61.4,25826,4.5
South Carolina,2017,12,2259641,57.6,2167809,55.3,91832,4.1
South Dakota,2017,12,455425,68.9,441844,66.8,13581,3.0
Tennessee,2017,12,3216562,60.5,3105014,58.4,111548,3.5
Texas,2017,12,13545086,63.7,12994087,61.1,550999,4.1
Utah,2017,12,1566384,68.6,1518553,66.5,47831,3.1
Vermont,2017,12,355711,67.2,345122,65.2,10589,3.0
Virginia,2017,12,4364128,65.6,4217312,63.4,146816,3.4
Washington,2017,12,3755898,63.7,3582546,60.7,173352,4.6
West Virginia,2017,12,787528,53.8,745022,50.9,42506,5.4
Wisconsin,2017,12,3137416,67.8,3043620,65.7,93796,3.0
Wyoming,2017,12,292334,65.6,279877,62.8,12457,4.3
Alabama,2018,1,2215203,56.8,2127128,54.5,88075,4.0
Alaska,2018,1,357218,65.4,334382,61.2,22836,6.4
Arizona,2018,1,3273165,60.7,3113945,57.8,159220,4.9
Arkansas,2018,1,1341321,57.9,1290307,55.7,51014,3.8
California,2018,1,19196954,62.1,18352744,59.4,844210,4.4
Los Angeles County,2018,1,5113725,63.3,4875532,60.3,238193,4.7
Colorado,2018,1,3016639,68.3,2929572,66.3,87067,2.9
Connecticut,2018,1,1908264,65.7,1828277,62.9,79987,4.2
Delaware,2018,1,478056,62.2,458437,59.6,19619,4.1
District of Columbia,2018,1,395016,70.5,371856,66.4,23160,5.9
Florida,2018,1,10035695,59.2,9640036,56.8,395659,3.9
Georgia,2018,1,5126480,63.7,4906159,60.9,220321,4.3
Hawaii,2018,1,692289,61.6,678079,60.4,14210,2.1
Idaho,2018,1,852010,64.0,826410,62.1,25600,3.0
Illinois,2018,1,6554812,64.6,6255518,61.7,299294,4.6
Indiana,2018,1,3355494,64.4,3245200,62.3,110294,3.3
Iowa,2018,1,1694988,68.6,1647790,66.7,47198,2.8
Kansas,2018,1,1487571,66.7,1435898,64.4,51673,3.5
Kentucky,2018,1,2047780,58.6,1960863,56.1,86917,4.2
Louisiana,2018,1,2108584,58.8,2009808,56.0,98776,4.7
Maine,2018,1,698862,63.0,677440,61.0,21422,3.1
Maryland,2018,1,3256989,67.7,3124028,64.9,132961,4.1
Massachusetts,2018,1,3769464,66.4,3629779,63.9,139685,3.7
Michigan,2018,1,4926680,61.4,4703938,58.7,222742,4.5
Minnesota,2018,1,3068776,69.7,2973054,67.5,95722,3.1
Mississippi,2018,1,1266933,55.5,1205088,52.8,61845,4.9
Missouri,2018,1,3046775,63.7,2938508,61.4,108267,3.6
Montana,2018,1,530913,63.1,509909,60.6,21004,4.0
Nebraska,2018,1,1028444,69.5,998353,67.5,30091,2.9
Nevada,2018,1,1469779,62.9,1400476,60.0,69303,4.7
New Hampshire,2018,1,762668,68.3,741741,66.4,20927,2.7
New Jersey,2018,1,4589597,62.9,4385453,60.1,204144,4.4
New Mexico,2018,1,940285,57.6,891233,54.6,49052,5.2
New York,2018,1,9802719,60.5,9361939,57.8,440780,4.5
New York city,2018,1,4272594,60.2,4088835,57.6,183759,4.3
North Carolina,2018,1,4883710,61.1,4677874,58.6,205836,4.2
North Dakota,2018,1,413194,70.2,402303,68.3,10891,2.6
Ohio,2018,1,5797630,62.6,5532766,59.8,264864,4.6
Oklahoma,2018,1,1833765,61.3,1765707,59.0,68058,3.7
Oregon,2018,1,2080689,62.1,1995726,59.6,84963,4.1
Pennsylvania,2018,1,6474413,62.4,6163215,59.4,311198,4.8
Rhode Island,2018,1,570471,64.4,545021,61.6,25450,4.5
South Carolina,2018,1,2261291,57.6,2173906,55.4,87385,3.9
South Dakota,2018,1,457365,69.2,443805,67.1,13560,3.0
Tennessee,2018,1,3220657,60.6,3107251,58.4,113406,3.5
Texas,2018,1,13599540,63.8,13048165,61.2,551375,4.1
Utah,2018,1,1569799,68.6,1522153,66.5,47646,3.0
Vermont,2018,1,354979,67.1,345110,65.2,9869,2.8
Virginia,2018,1,4349259,65.4,4202231,63.2,147028,3.4
Washington,2018,1,3765106,63.8,3591980,60.8,173126,4.6
West Virginia,2018,1,788504,53.9,746031,51.0,42473,5.4
Wisconsin,2018,1,3130645,67.6,3038413,65.6,92232,2.9
Wyoming,2018,1,292323,65.6,280000,62.9,12323,4.2
Alabama,2018,2,2221179,56.9,2132739,54.6,88440,4.0
Alaska,2018,2,356853,65.4,334378,61.2,22475,6.3
Arizona,2018,2,3282873,60.8,3124522,57.9,158351,4.8
Arkansas,2018,2,1341576,57.9,1290847,55.7,50729,3.8
California,2018,2,19219336,62.2,18384599,59.5,834737,4.3
Los Angeles County,2018,2,5117717,63.3,4879879,60.4,237838,4.6
Colorado,2018,2,3025887,68.4,2938179,66.4,87708,2.9
Connecticut,2018,2,1910699,65.7,1831795,63.0,78904,4.1
Delaware,2018,2,478958,62.2,459718,59.7,19240,4.0
District of Columbia,2018,2,395888,70.6,372775,66.5,23113,5.8
Florida,2018,2,10056393,59.2,9665775,56.9,390618,3.9
Georgia,2018,2,5128657,63.6,4912063,61.0,216594,4.2
Hawaii,2018,2,693538,61.7,678860,60.4,14678,2.1
Idaho,2018,2,853921,64.0,828831,62.1,25090,2.9
Illinois,2018,2,6555717,64.7,6263513,61.8,292204,4.5
Indiana,2018,2,3367131,64.6,3256495,62.5,110636,3.3
Iowa,2018,2,1698795,68.8,1652673,66.9,46122,2.7
Kansas,2018,2,1489190,66.7,1437973,64.4,51217,3.4
Kentucky,2018,2,2049893,58.6,1963395,56.1,86498,4.2
Louisiana,2018,2,2112529,58.9,2012358,56.1,100171,4.7
Maine,2018,2,699365,63.0,678283,61.1,21082,3.0
Maryland,2018,2,3259422,67.7,3128359,65.0,131063,4.0
Massachusetts,2018,2,3783908,66.6,3645163,64.2,138745,3.7
Michigan,2018,2,4931679,61.5,4714905,58.8,216774,4.4
Minnesota,2018,2,3070279,69.7,2976090,67.6,94189,3.1
Mississippi,2018,2,1268039,55.6,1206065,52.9,61974,4.9
Missouri,2018,2,3048573,63.7,2942099,61.5,106474,3.5
Montana,2018,2,531682,63.1,511006,60.7,20676,3.9
Nebraska,2018,2,1030167,69.6,1000270,67.6,29897,2.9
Nevada,2018,2,1474824,63.1,1406385,60.1,68439,4.6
New Hampshire,2018,2,764718,68.4,743898,66.6,20820,2.7
New Jersey,2018,2,4591388,62.9,4391311,60.2,200077,4.4
New Mexico,2018,2,941054,57.7,893378,54.8,47676,5.1
New York,2018,2,9803973,60.5,9372373,57.8,431600,4.4
New York city,2018,2,4271328,60.2,4089884,57.6,181444,4.2
North Carolina,2018,2,4889226,61.2,4687688,58.6,201538,4.1
North Dakota,2018,2,413337,70.2,402540,68.3,10797,2.6
Ohio,2018,2,5800253,62.7,5536066,59.8,264187,4.6
Oklahoma,2018,2,1835365,61.3,1768867,59.1,66498,3.6
Oregon,2018,2,2080223,62.0,1996370,59.5,83853,4.0
Pennsylvania,2018,2,6480717,62.5,6174626,59.5,306091,4.7
Rhode Island,2018,2,571351,64.5,546431,61.7,24920,4.4
South Carolina,2018,2,2262598,57.6,2179771,55.5,82827,3.7
South Dakota,2018,2,457880,69.2,444447,67.2,13433,2.9
Tennessee,2018,2,3228202,60.7,3114203,58.5,113999,3.5
Texas,2018,2,13633431,63.9,13081962,61.3,551469,4.0
Utah,2018,2,1572966,68.6,1525703,66.5,47263,3.0
Vermont,2018,2,355297,67.1,345619,65.3,9678,2.7
Virginia,2018,2,4355545,65.5,4211373,63.3,144172,3.3
Washington,2018,2,3773943,63.8,3602069,60.9,171874,4.6
West Virginia,2018,2,789870,54.0,747400,51.1,42470,5.4
Wisconsin,2018,2,3131602,67.6,3039863,65.6,91739,2.9
Wyoming,2018,2,292352,65.6,280213,62.9,12139,4.2
Alabama,2018,3,2228062,57.1,2139159,54.8,88903,4.0
Alaska,2018,3,356657,65.3,334582,61.3,22075,6.2
Arizona,2018,3,3293381,60.9,3136405,58.0,156976,4.8
Arkansas,2018,3,1342246,57.9,1292063,55.7,50183,3.7
California,2018,3,19250782,62.3,18424514,59.6,826268,4.3
Los Angeles County,2018,3,5123580,63.4,4886312,60.5,237268,4.6
Colorado,2018,3,3036364,68.5,2947535,66.5,88829,2.9
Connecticut,2018,3,1914468,65.8,1836742,63.2,77726,4.1
Delaware,2018,3,480082,62.3,461238,59.9,18844,3.9
District of Columbia,2018,3,396886,70.8,373837,66.7,23049,5.8
Florida,2018,3,10078282,59.3,9692793,57.0,385489,3.8
Georgia,2018,3,5133066,63.6,4920102,61.0,212964,4.1
Hawaii,2018,3,694874,61.9,679731,60.5,15143,2.2
Idaho,2018,3,856159,64.1,831543,62.2,24616,2.9
Illinois,2018,3,6557860,64.7,6271420,61.9,286440,4.4
Indiana,2018,3,3381187,64.9,3269097,62.7,112090,3.3
Iowa,2018,3,1703856,68.9,1658815,67.1,45041,2.6
Kansas,2018,3,1491516,66.8,1440755,64.6,50761,3.4
Kentucky,2018,3,2053343,58.7,1966889,56.2,86454,4.2
Louisiana,2018,3,2116504,59.0,2014483,56.2,102021,4.8
Maine,2018,3,700465,63.1,679393,61.2,21072,3.0
Maryland,2018,3,3263605,67.8,3134621,65.1,128984,4.0
Massachusetts,2018,3,3799466,66.9,3661664,64.4,137802,3.6
Michigan,2018,3,4938501,61.6,4727685,58.9,210816,4.3
Minnesota,2018,3,3072565,69.7,2979960,67.6,92605,3.0
Mississippi,2018,3,1269912,55.7,1207828,53.0,62084,4.9
Missouri,2018,3,3050889,63.8,2946937,61.6,103952,3.4
Montana,2018,3,532749,63.2,512377,60.8,20372,3.8
Nebraska,2018,3,1032316,69.7,1002615,67.7,29701,2.9
Nevada,2018,3,1480296,63.2,1412917,60.3,67379,4.6
New Hampshire,2018,3,767185,68.6,746413,66.8,20772,2.7
New Jersey,2018,3,4597167,63.0,4400669,60.3,196498,4.3
New Mexico,2018,3,942290,57.7,895868,54.9,46422,4.9
New York,2018,3,9812713,60.6,9391095,58.0,421618,4.3
New York city,2018,3,4271935,60.2,4092876,57.6,179059,4.2
North Carolina,2018,3,4898015,61.2,4700339,58.7,197676,4.0
North Dakota,2018,3,413418,70.2,402846,68.4,10572,2.6
Ohio,2018,3,5808545,62.7,5543916,59.9,264629,4.6
Oklahoma,2018,3,1836734,61.4,1772089,59.2,64645,3.5
Oregon,2018,3,2079994,62.0,1997382,59.5,82612,4.0
Pennsylvania,2018,3,6489525,62.5,6189807,59.6,299718,4.6
Rhode Island,2018,3,572418,64.6,548147,61.9,24271,4.2
South Carolina,2018,3,2265872,57.6,2187356,55.6,78516,3.5
South Dakota,2018,3,458689,69.3,445415,67.3,13274,2.9
Tennessee,2018,3,3237830,60.8,3123754,58.7,114076,3.5
Texas,2018,3,13669328,64.0,13119215,61.5,550113,4.0
Utah,2018,3,1576719,68.6,1529817,66.6,46902,3.0
Vermont,2018,3,355659,67.2,346233,65.4,9426,2.7
Virginia,2018,3,4361958,65.5,4222034,63.4,139924,3.2
Washington,2018,3,3784605,64.0,3614503,61.1,170102,4.5
West Virginia,2018,3,791737,54.2,749438,51.3,42299,5.3
Wisconsin,2018,3,3133530,67.6,3041219,65.6,92311,2.9
Wyoming,2018,3,292549,65.7,280586,63.0,11963,4.1
Alabama,2018,4,2234186,57.2,2144935,54.9,89251,4.0
Alaska,2018,4,356476,65.3,334807,61.3,21669,6.1
Arizona,2018,4,3303276,61.0,3147822,58.2,155454,4.7
Arkansas,2018,4,1342648,57.9,1293298,55.8,49350,3.7
California,2018,4,19278835,62.3,18461288,59.7,817547,4.2
Los Angeles County,2018,4,5127667,63.4,4891425,60.5,236242,4.6
Colorado,2018,4,3046082,68.7,2955661,66.6,90421,3.0
Connecticut,2018,4,1918644,66.0,1842175,63.3,76469,4.0
Delaware,2018,4,480907,62.4,462460,60.0,18447,3.8
District of Columbia,2018,4,397377,70.8,374476,66.7,22901,5.8
Florida,2018,4,10097841,59.4,9718126,57.1,379715,3.8
Georgia,2018,4,5136015,63.6,4926847,61.0,209168,4.1
Hawaii,2018,4,695769,61.9,680222,60.5,15547,2.2
Idaho,2018,4,858335,64.1,834116,62.3,24219,2.8
Illinois,2018,4,6558761,64.7,6276908,61.9,281853,4.3
Indiana,2018,4,3394029,65.1,3280254,62.9,113775,3.4
Iowa,2018,4,1708600,69.1,1664626,67.3,43974,2.6
Kansas,2018,4,1493526,66.9,1443318,64.7,50208,3.4
Kentucky,2018,4,2056434,58.8,1969875,56.3,86559,4.2
Louisiana,2018,4,2118479,59.1,2014911,56.2,103568,4.9
Maine,2018,4,701613,63.2,680261,61.2,21352,3.0
Maryland,2018,4,3267454,67.8,3140413,65.2,127041,3.9
Massachusetts,2018,4,3813006,67.1,3676332,64.7,136674,3.6
Michigan,2018,4,4943343,61.6,4738451,59.1,204892,4.1
Minnesota,2018,4,3074116,69.7,2983197,67.7,90919,3.0
Mississippi,2018,4,1270899,55.7,1208847,53.0,62052,4.9
Missouri,2018,4,3051864,63.8,2951076,61.7,100788,3.3
Montana,2018,4,533807,63.3,513700,60.9,20107,3.8
Nebraska,2018,4,1034270,69.8,1004769,67.8,29501,2.9
Nevada,2018,4,1485403,63.3,1419234,60.5,66169,4.5
New Hampshire,2018,4,769506,68.8,748808,66.9,20698,2.7
New Jersey,2018,4,4603634,63.0,4410368,60.4,193266,4.2
New Mexico,2018,4,943456,57.8,898068,55.0,45388,4.8
New York,2018,4,9823257,60.6,9412158,58.1,411099,4.2
New York city,2018,4,4271853,60.1,4095568,57.7,176285,4.1
North Carolina,2018,4,4906470,61.3,4711885,58.8,194585,4.0
North Dakota,2018,4,413191,70.1,402954,68.4,10237,2.5
Ohio,2018,4,5817694,62.8,5553048,60.0,264646,4.5
Oklahoma,2018,4,1836649,61.3,1774190,59.3,62459,3.4
Oregon,2018,4,2079262,61.9,1998035,59.5,81227,3.9
Pennsylvania,2018,4,6497801,62.6,6205079,59.8,292722,4.5
Rhode Island,2018,4,573339,64.7,549710,62.0,23629,4.1
South Carolina,2018,4,2270009,57.7,2194735,55.8,75274,3.3
South Dakota,2018,4,459246,69.4,446182,67.4,13064,2.8
Tennessee,2018,4,3246778,60.9,3133120,58.8,113658,3.5
Texas,2018,4,13698765,64.1,13152629,61.5,546136,4.0
Utah,2018,4,1580206,68.7,1533639,66.6,46567,2.9
Vermont,2018,4,355914,67.2,346783,65.5,9131,2.6
Virginia,2018,4,4364905,65.5,4230473,63.5,134432,3.1
Washington,2018,4,3794684,64.0,3627090,61.2,167594,4.4
West Virginia,2018,4,793427,54.3,751531,51.5,41896,5.3
Wisconsin,2018,4,3134372,67.6,3041152,65.6,93220,3.0
Wyoming,2018,4,292737,65.7,280917,63.1,11820,4.0
Alabama,2018,5,2238566,57.3,2149130,55.0,89436,4.0
Alaska,2018,5,356226,65.3,334894,61.4,21332,6.0
Arizona,2018,5,3312067,61.1,3157523,58.3,154544,4.7
Arkansas,2018,5,1342443,57.9,1293980,55.8,48463,3.6
California,2018,5,19295169,62.4,18485203,59.7,809966,4.2
Los Angeles County,2018,5,5127576,63.4,4892359,60.5,235217,4.6
Colorado,2018,5,3053525,68.7,2961309,66.7,92216,3.0
Connecticut,2018,5,1922217,66.1,1846935,63.5,75282,3.9
Delaware,2018,5,481147,62.4,463069,60.0,18078,3.8
District of Columbia,2018,5,397110,70.7,374472,66.7,22638,5.7
Florida,2018,5,10113381,59.4,9739894,57.2,373487,3.7
Georgia,2018,5,5135036,63.5,4929596,61.0,205440,4.0
Hawaii,2018,5,695842,61.9,679901,60.5,15941,2.3
Idaho,2018,5,860211,64.1,836240,62.3,23971,2.8
Illinois,2018,5,6557649,64.7,6278603,62.0,279046,4.3
Indiana,2018,5,3402840,65.2,3287610,63.0,115230,3.4
Iowa,2018,5,1711978,69.2,1668837,67.5,43141,2.5
Kansas,2018,5,1494620,66.9,1444886,64.7,49734,3.3
Kentucky,2018,5,2057893,58.8,1971050,56.3,86843,4.2
Louisiana,2018,5,2117549,59.1,2013112,56.2,104437,4.9
Maine,2018,5,702378,63.2,680528,61.2,21850,3.1
Maryland,2018,5,3269331,67.8,3143853,65.2,125478,3.8
Massachusetts,2018,5,3822727,67.2,3687349,64.8,135378,3.5
Michigan,2018,5,4944678,61.6,4744662,59.1,200016,4.0
Minnesota,2018,5,3074263,69.7,2984655,67.6,89608,2.9
Mississippi,2018,5,1270811,55.7,1208925,53.0,61886,4.9
Missouri,2018,5,3050840,63.7,2953143,61.7,97697,3.2
Montana,2018,5,534614,63.3,514707,61.0,19907,3.7
Nebraska,2018,5,1035688,69.9,1006243,67.9,29445,2.8
Nevada,2018,5,1489709,63.4,1424714,60.6,64995,4.4
New Hampshire,2018,5,771118,68.9,750585,67.0,20533,2.7
New Jersey,2018,5,4608051,63.1,4417829,60.5,190222,4.1
New Mexico,2018,5,944196,57.8,899482,55.1,44714,4.7
New York,2018,5,9829787,60.6,9428753,58.2,401034,4.1
New York city,2018,5,4268705,60.1,4095441,57.6,173264,4.1
North Carolina,2018,5,4911991,61.3,4719136,58.9,192855,3.9
North Dakota,2018,5,412583,70.0,402699,68.3,9884,2.4
Ohio,2018,5,5823748,62.9,5560130,60.0,263618,4.5
Oklahoma,2018,5,1834793,61.3,1774569,59.3,60224,3.3
Oregon,2018,5,2077839,61.8,1997707,59.4,80132,3.9
Pennsylvania,2018,5,6503837,62.6,6217321,59.9,286516,4.4
Rhode Island,2018,5,573839,64.7,550761,62.1,23078,4.0
South Carolina,2018,5,2274103,57.7,2200403,55.8,73700,3.2
South Dakota,2018,5,459537,69.4,446680,67.4,12857,2.8
Tennessee,2018,5,3253270,61.0,3140122,58.9,113148,3.5
Texas,2018,5,13717335,64.1,13176416,61.6,540919,3.9
Utah,2018,5,1582877,68.6,1536566,66.6,46311,2.9
Vermont,2018,5,355989,67.2,347144,65.5,8845,2.5
Virginia,2018,5,4362496,65.5,4233868,63.5,128628,2.9
Washington,2018,5,3802817,64.1,3637867,61.3,164950,4.3
West Virginia,2018,5,794520,54.4,753131,51.6,41389,5.2
Wisconsin,2018,5,3132751,67.5,3038761,65.5,93990,3.0
Wyoming,2018,5,292808,65.7,281065,63.1,11743,4.0
Alabama,2018,6,2241402,57.3,2152116,55.0,89286,4.0
Alaska,2018,6,355900,65.2,334808,61.4,21092,5.9
Arizona,2018,6,3320195,61.2,3165561,58.3,154634,4.7
Arkansas,2018,6,1341964,57.8,1294216,55.8,47748,3.6
California,2018,6,19300178,62.3,18495575,59.7,804603,4.2
Los Angeles County,2018,6,5123652,63.4,4889001,60.5,234651,4.6
Colorado,2018,6,3058408,68.7,2964578,66.6,93830,3.1
Connecticut,2018,6,1924895,66.2,1850699,63.6,74196,3.9
Delaware,2018,6,480875,62.3,463154,60.0,17721,3.7
District of Columbia,2018,6,396235,70.6,373972,66.6,22263,5.6
Florida,2018,6,10124402,59.4,9757459,57.2,366943,3.6
Georgia,2018,6,5130580,63.4,4928630,60.9,201950,3.9
Hawaii,2018,6,695111,61.8,678752,60.4,16359,2.4
Idaho,2018,6,861773,64.1,837884,62.3,23889,2.8
Illinois,2018,6,6555485,64.7,6277389,61.9,278096,4.2
Indiana,2018,6,3406827,65.2,3290515,63.0,116312,3.4
Iowa,2018,6,1713875,69.3,1671232,67.6,42643,2.5
Kansas,2018,6,1494721,66.9,1445332,64.7,49389,3.3
Kentucky,2018,6,2057555,58.8,1970474,56.3,87081,4.2
Louisiana,2018,6,2114318,59.0,2009891,56.1,104427,4.9
Maine,2018,6,702617,63.2,680222,61.2,22395,3.2
Maryland,2018,6,3269322,67.8,3145249,65.2,124073,3.8
Massachusetts,2018,6,3828443,67.3,3694639,64.9,133804,3.5
Michigan,2018,6,4943760,61.6,4746335,59.1,197425,4.0
Minnesota,2018,6,3073370,69.6,2984479,67.6,88891,2.9
Mississippi,2018,6,1269490,55.7,1207935,53.0,61555,4.8
Missouri,2018,6,3048331,63.6,2953221,61.7,95110,3.1
Montana,2018,6,535137,63.3,515374,61.0,19763,3.7
Nebraska,2018,6,1036580,69.9,1007005,67.9,29575,2.9
Nevada,2018,6,1493323,63.4,1429301,60.7,64022,4.3
New Hampshire,2018,6,771898,68.9,751625,67.1,20273,2.6
New Jersey,2018,6,4609385,63.1,4422709,60.5,186676,4.0
New Mexico,2018,6,944533,57.8,900068,55.1,44465,4.7
New York,2018,6,9830937,60.6,9438572,58.2,392365,4.0
New York city,2018,6,4262878,60.0,4092322,57.6,170556,4.0
North Carolina,2018,6,4914457,61.2,4722123,58.8,192334,3.9
North Dakota,2018,6,411764,69.8,402179,68.2,9585,2.3
Ohio,2018,6,5825046,62.9,5563685,60.1,261361,4.5
Oklahoma,2018,6,1831931,61.2,1773680,59.2,58251,3.2
Oregon,2018,6,2076459,61.7,1996678,59.3,79781,3.8
Pennsylvania,2018,6,6507763,62.7,6225972,59.9,281791,4.3
Rhode Island,2018,6,573894,64.7,551233,62.1,22661,3.9
South Carolina,2018,6,2278126,57.7,2204417,55.9,73709,3.2
South Dakota,2018,6,459592,69.3,446914,67.4,12678,2.8
Tennessee,2018,6,3257856,61.0,3145062,58.9,112794,3.5
Texas,2018,6,13726250,64.1,13191095,61.6,535155,3.9
Utah,2018,6,1584753,68.6,1538626,66.6,46127,2.9
Vermont,2018,6,355873,67.1,347274,65.5,8599,2.4
Virginia,2018,6,4356635,65.4,4232960,63.5,123675,2.8
Washington,2018,6,3809408,64.1,3646420,61.4,162988,4.3
West Virginia,2018,6,794973,54.5,754150,51.7,40823,5.1
Wisconsin,2018,6,3128690,67.4,3034386,65.4,94304,3.0
Wyoming,2018,6,292775,65.7,281040,63.1,11735,4.0
Alabama,2018,7,2243084,57.3,2154387,55.1,88697,4.0
Alaska,2018,7,355486,65.2,334563,61.3,20923,5.9
Arizona,2018,7,3328193,61.2,3172389,58.4,155804,4.7
Arkansas,2018,7,1341657,57.8,1294291,55.8,47366,3.5
California,2018,7,19297703,62.3,18495896,59.7,801807,4.2
Los Angeles County,2018,7,5117860,63.3,4883098,60.4,234762,4.6
Colorado,2018,7,3061224,68.7,2966133,66.6,95091,3.1
Connecticut,2018,7,1926837,66.2,1853634,63.7,73203,3.8
Delaware,2018,7,480321,62.1,462949,59.9,17372,3.6
District of Columbia,2018,7,395082,70.3,373263,66.4,21819,5.5
Florida,2018,7,10131559,59.4,9770969,57.2,360590,3.6
Georgia,2018,7,5124359,63.3,4925388,60.8,198971,3.9
Hawaii,2018,7,693774,61.7,677002,60.2,16772,2.4
Idaho,2018,7,863111,64.1,839164,62.3,23947,2.8
Illinois,2018,7,6552816,64.7,6274164,61.9,278652,4.3
Indiana,2018,7,3406076,65.2,3289109,62.9,116967,3.4
Iowa,2018,7,1714584,69.3,1672132,67.6,42452,2.5
Kansas,2018,7,1494114,66.9,1444952,64.7,49162,3.3
Kentucky,2018,7,2055583,58.7,1968482,56.2,87101,4.2
Louisiana,2018,7,2109715,58.9,2006232,56.0,103483,4.9
Maine,2018,7,702319,63.1,679458,61.1,22861,3.3
Maryland,2018,7,3268322,67.8,3145774,65.2,122548,3.7
Massachusetts,2018,7,3830674,67.3,3698801,64.9,131873,3.4
Michigan,2018,7,4942200,61.5,4745013,59.1,197187,4.0
Minnesota,2018,7,3072049,69.5,2983367,67.5,88682,2.9
Mississippi,2018,7,1267252,55.6,1205989,52.9,61263,4.8
Missouri,2018,7,3045277,63.6,2951984,61.6,93293,3.1
Montana,2018,7,535470,63.3,515831,61.0,19639,3.7
Nebraska,2018,7,1037124,69.9,1007347,67.9,29777,2.9
Nevada,2018,7,1496536,63.4,1433169,60.7,63367,4.2
New Hampshire,2018,7,772042,68.9,752083,67.1,19959,2.6
New Jersey,2018,7,4607904,63.0,4425537,60.5,182367,4.0
New Mexico,2018,7,944642,57.8,899990,55.1,44652,4.7
New York,2018,7,9828624,60.6,9442483,58.2,386141,3.9
New York city,2018,7,4256544,59.9,4087579,57.5,168965,4.0
North Carolina,2018,7,4914439,61.2,4721774,58.8,192665,3.9
North Dakota,2018,7,410961,69.7,401599,68.1,9362,2.3
Ohio,2018,7,5822570,62.8,5563748,60.0,258822,4.4
Oklahoma,2018,7,1828858,61.0,1772156,59.1,56702,3.1
Oregon,2018,7,2075491,61.6,1995059,59.2,80432,3.9
Pennsylvania,2018,7,6510210,62.7,6231756,60.0,278454,4.3
Rhode Island,2018,7,573574,64.6,551163,62.1,22411,3.9
South Carolina,2018,7,2282203,57.8,2207615,55.9,74588,3.3
South Dakota,2018,7,459355,69.3,446846,67.4,12509,2.7
Tennessee,2018,7,3260968,61.0,3148377,58.9,112591,3.5
Texas,2018,7,13728718,64.0,13199505,61.5,529213,3.9
Utah,2018,7,1586054,68.5,1540090,66.5,45964,2.9
Vermont,2018,7,355582,67.1,347161,65.5,8421,2.4
Virginia,2018,7,4350276,65.2,4229820,63.4,120456,2.8
Washington,2018,7,3815453,64.1,3653121,61.4,162332,4.3
West Virginia,2018,7,794879,54.5,754671,51.8,40208,5.1
Wisconsin,2018,7,3123155,67.3,3029065,65.2,94090,3.0
Wyoming,2018,7,292681,65.7,280894,63.1,11787,4.0
Alabama,2018,8,2244588,57.3,2156606,55.1,87982,3.9
Alaska,2018,8,355014,65.1,334161,61.2,20853,5.9
Arizona,2018,8,3337305,61.3,3178981,58.4,158324,4.7
Arkansas,2018,8,1342124,57.8,1294614,55.7,47510,3.5
California,2018,8,19297388,62.3,18493301,59.7,804087,4.2
Los Angeles County,2018,8,5113684,63.3,4877706,60.3,235978,4.6
Colorado,2018,8,3063296,68.7,2967218,66.5,96078,3.1
Connecticut,2018,8,1928488,66.2,1855994,63.8,72494,3.8
Delaware,2018,8,479868,62.0,462767,59.8,17101,3.6
District of Columbia,2018,8,394108,70.1,372592,66.3,21516,5.5
Florida,2018,8,10137840,59.3,9781708,57.2,356132,3.5
Georgia,2018,8,5119321,63.1,4921956,60.7,197365,3.9
Hawaii,2018,8,692148,61.5,674923,60.0,17225,2.5
Idaho,2018,8,864565,64.0,840375,62.2,24190,2.8
Illinois,2018,8,6551810,64.7,6270691,61.9,281119,4.3
Indiana,2018,8,3402860,65.1,3285287,62.8,117573,3.5
Iowa,2018,8,1715034,69.3,1672377,67.5,42657,2.5
Kansas,2018,8,1493557,66.8,1444346,64.6,49211,3.3
Kentucky,2018,8,2052969,58.6,1965952,56.1,87017,4.2
Louisiana,2018,8,2105348,58.7,2003075,55.9,102273,4.9
Maine,2018,8,701765,63.0,678519,61.0,23246,3.3
Maryland,2018,8,3268314,67.7,3147108,65.2,121206,3.7
Massachusetts,2018,8,3831400,67.2,3701355,64.9,130045,3.4
Michigan,2018,8,4942546,61.5,4743536,59.0,199010,4.0
Minnesota,2018,8,3071919,69.5,2982419,67.4,89500,2.9
Mississippi,2018,8,1265674,55.5,1204143,52.8,61531,4.9
Missouri,2018,8,3043252,63.5,2950566,61.6,92686,3.0
Montana,2018,8,535880,63.3,516289,61.0,19591,3.7
Nebraska,2018,8,1037794,69.9,1007672,67.8,30122,2.9
Nevada,2018,8,1500003,63.5,1436752,60.8,63251,4.2
New Hampshire,2018,8,772000,68.8,752295,67.1,19705,2.6
New Jersey,2018,8,4605741,62.9,4427631,60.5,178110,3.9
New Mexico,2018,8,944966,57.8,899630,55.0,45336,4.8
New York,2018,8,9827008,60.6,9443161,58.2,383847,3.9
New York city,2018,8,4252479,59.8,4083074,57.4,169405,4.0
North Carolina,2018,8,4914460,61.1,4720444,58.7,194016,3.9
North Dakota,2018,8,410454,69.5,401191,68.0,9263,2.3
Ohio,2018,8,5820956,62.8,5563148,60.0,257808,4.4
Oklahoma,2018,8,1826456,60.9,1770551,59.0,55905,3.1
Oregon,2018,8,2075912,61.6,1993756,59.1,82156,4.0
Pennsylvania,2018,8,6513434,62.7,6236612,60.0,276822,4.3
Rhode Island,2018,8,573129,64.5,550774,62.0,22355,3.9
South Carolina,2018,8,2286695,57.8,2211124,55.9,75571,3.3
South Dakota,2018,8,459265,69.2,446865,67.3,12400,2.7
Tennessee,2018,8,3264022,61.0,3151256,58.9,112766,3.5
Texas,2018,8,13731309,63.9,13205883,61.5,525426,3.8
Utah,2018,8,1587374,68.4,1541493,66.5,45881,2.9
Vermont,2018,8,355259,67.0,346919,65.4,8340,2.3
Virginia,2018,8,4346897,65.1,4227022,63.3,119875,2.8
Washington,2018,8,3822447,64.2,3659168,61.4,163279,4.3
West Virginia,2018,8,794631,54.5,754857,51.8,39774,5.0
Wisconsin,2018,8,3117962,67.1,3024217,65.1,93745,3.0
Wyoming,2018,8,292613,65.7,280727,63.0,11886,4.1
Alabama,2018,9,2246778,57.4,2159434,55.1,87344,3.9
Alaska,2018,9,354523,65.0,333616,61.1,20907,5.9
Arizona,2018,9,3347937,61.4,3186038,58.4,161899,4.8
Arkansas,2018,9,1343667,57.8,1295453,55.8,48214,3.6
California,2018,9,19305148,62.3,18493118,59.7,812030,4.2
Los Angeles County,2018,9,5112937,63.3,4874976,60.3,237961,4.7
Colorado,2018,9,3065884,68.6,2969146,66.5,96738,3.2
Connecticut,2018,9,1930047,66.3,1857909,63.8,72138,3.7
Delaware,2018,9,479785,61.9,462829,59.7,16956,3.5
District of Columbia,2018,9,393580,70.0,372033,66.2,21547,5.5
Florida,2018,9,10145179,59.3,9790750,57.2,354429,3.5
Georgia,2018,9,5117166,63.0,4919812,60.6,197354,3.9
Hawaii,2018,9,690477,61.4,672759,59.8,17718,2.6
Idaho,2018,9,866383,64.0,841744,62.2,24639,2.8
Illinois,2018,9,6554020,64.7,6268596,61.9,285424,4.4
Indiana,2018,9,3399927,65.0,3281441,62.7,118486,3.5
Iowa,2018,9,1715931,69.3,1672825,67.5,43106,2.5
Kansas,2018,9,1493558,66.8,1444014,64.6,49544,3.3
Kentucky,2018,9,2050784,58.5,1963906,56.0,86878,4.2
Louisiana,2018,9,2102610,58.6,2001098,55.8,101512,4.8
Maine,2018,9,701177,62.9,677698,60.8,23479,3.3
Maryland,2018,9,3270769,67.7,3150326,65.2,120443,3.7
Massachusetts,2018,9,3832282,67.2,3703622,64.9,128660,3.4
Michigan,2018,9,4945880,61.5,4743870,59.0,202010,4.1
Minnesota,2018,9,3073838,69.4,2982207,67.4,91631,3.0
Mississippi,2018,9,1264717,55.5,1202177,52.7,62540,4.9
Missouri,2018,9,3043345,63.5,2949967,61.5,93378,3.1
Montana,2018,9,536497,63.3,516885,61.0,19612,3.7
Nebraska,2018,9,1038831,69.9,1008194,67.8,30637,2.9
Nevada,2018,9,1504138,63.5,1440442,60.8,63696,4.2
New Hampshire,2018,9,772145,68.8,752549,67.0,19596,2.5
New Jersey,2018,9,4604978,62.9,4430370,60.5,174608,3.8
New Mexico,2018,9,945845,57.8,899404,55.0,46441,4.9
New York,2018,9,9827558,60.6,9441924,58.2,385634,3.9
New York city,2018,9,4251429,59.8,4079051,57.4,172378,4.1
North Carolina,2018,9,4917251,61.1,4721175,58.6,196076,4.0
North Dakota,2018,9,410417,69.5,401116,67.9,9301,2.3
Ohio,2018,9,5823324,62.8,5564293,60.0,259031,4.4
Oklahoma,2018,9,1825292,60.8,1769237,59.0,56055,3.1
Oregon,2018,9,2078329,61.6,1993722,59.1,84607,4.1
Pennsylvania,2018,9,6519107,62.7,6242195,60.0,276912,4.2
Rhode Island,2018,9,572774,64.4,550365,61.9,22409,3.9
South Carolina,2018,9,2291502,57.9,2215518,55.9,75984,3.3
South Dakota,2018,9,459131,69.1,446738,67.2,12393,2.7
Tennessee,2018,9,3268586,61.0,3155309,58.9,113277,3.5
Texas,2018,9,13738816,63.9,13213624,61.4,525192,3.8
Utah,2018,9,1589157,68.4,1543290,66.4,45867,2.9
Vermont,2018,9,355027,66.9,346692,65.3,8335,2.3
Virginia,2018,9,4348736,65.1,4226588,63.3,122148,2.8
Washington,2018,9,3831730,64.3,3665693,61.5,166037,4.3
West Virginia,2018,9,794523,54.5,754813,51.8,39710,5.0
Wisconsin,2018,9,3114185,67.0,3020627,65.0,93558,3.0
Wyoming,2018,9,292589,65.6,280639,62.9,11950,4.1
Alabama,2018,10,2250193,57.4,2163423,55.2,86770,3.9
Alaska,2018,10,354115,64.9,333060,61.0,21055,5.9
Arizona,2018,10,3359392,61.5,3193729,58.4,165663,4.9
Arkansas,2018,10,1346113,57.9,1296935,55.8,49178,3.7
California,2018,10,19321310,62.3,18497788,59.7,823522,4.3
Los Angeles County,2018,10,5115007,63.3,4875035,60.3,239972,4.7
Colorado,2018,10,3069511,68.6,2972769,66.4,96742,3.2
Connecticut,2018,10,1931443,66.3,1859440,63.8,72003,3.7
Delaware,2018,10,480215,61.9,463284,59.7,16931,3.5
District of Columbia,2018,10,393686,70.0,371760,66.1,21926,5.6
Florida,2018,10,10153991,59.3,9799002,57.2,354989,3.5
Georgia,2018,10,5118183,63.0,4919880,60.5,198303,3.9
Hawaii,2018,10,688974,61.3,670774,59.6,18200,2.6
Idaho,2018,10,868585,64.0,843367,62.2,25218,2.9
Illinois,2018,10,6558904,64.7,6268153,61.8,290751,4.4
Indiana,2018,10,3398941,64.9,3279216,62.6,119725,3.5
Iowa,2018,10,1717712,69.3,1674025,67.5,43687,2.5
Kansas,2018,10,1494286,66.8,1444241,64.6,50045,3.3
Kentucky,2018,10,2049774,58.5,1963087,56.0,86687,4.2
Louisiana,2018,10,2101886,58.6,2000659,55.8,101227,4.8
Maine,2018,10,700622,62.8,677166,60.7,23456,3.3
Maryland,2018,10,3276162,67.8,3155904,65.3,120258,3.7
Massachusetts,2018,10,3833978,67.2,3706338,65.0,127640,3.3
Michigan,2018,10,4951784,61.6,4746517,59.0,205267,4.1
Minnesota,2018,10,3077585,69.5,2982924,67.3,94661,3.1
Mississippi,2018,10,1264996,55.5,1200942,52.7,64054,5.1
Missouri,2018,10,3045983,63.5,2950848,61.5,95135,3.1
Montana,2018,10,537243,63.3,517595,61.0,19648,3.7
Nebraska,2018,10,1040257,69.9,1009041,67.8,31216,3.0
Nevada,2018,10,1508923,63.6,1444468,60.9,64455,4.3
New Hampshire,2018,10,772675,68.8,753034,67.0,19641,2.5
New Jersey,2018,10,4607016,62.9,4435151,60.5,171865,3.7
New Mexico,2018,10,947258,57.8,899635,54.9,47623,5.0
New York,2018,10,9830666,60.6,9441120,58.2,389546,4.0
New York city,2018,10,4253352,59.8,4076414,57.3,176938,4.2
North Carolina,2018,10,4924093,61.1,4726112,58.6,197981,4.0
North Dakota,2018,10,410864,69.5,401438,67.9,9426,2.3
Ohio,2018,10,5829268,62.8,5567912,60.0,261356,4.5
Oklahoma,2018,10,1825633,60.8,1768657,58.9,56976,3.1
Oregon,2018,10,2082356,61.6,1995305,59.1,87051,4.2
Pennsylvania,2018,10,6527971,62.8,6249408,60.1,278563,4.3
Rhode Island,2018,10,572579,64.4,550154,61.9,22425,3.9
South Carolina,2018,10,2296611,57.9,2220965,56.0,75646,3.3
South Dakota,2018,10,459487,69.1,446998,67.2,12489,2.7
Tennessee,2018,10,3275310,61.1,3161426,59.0,113884,3.5
Texas,2018,10,13752653,63.8,13225591,61.4,527062,3.8
Utah,2018,10,1591528,68.3,1545723,66.4,45805,2.9
Vermont,2018,10,354920,66.8,346570,65.3,8350,2.4
Virginia,2018,10,4356111,65.2,4229700,63.3,126411,2.9
Washington,2018,10,3843936,64.4,3673580,61.5,170356,4.4
West Virginia,2018,10,794584,54.5,754650,51.8,39934,5.0
Wisconsin,2018,10,3112223,66.9,3018636,64.9,93587,3.0
Wyoming,2018,10,292593,65.6,280690,62.9,11903,4.1
Alabama,2018,11,2254719,57.5,2168540,55.3,86179,3.8
Alaska,2018,11,353807,64.9,332606,61.0,21201,6.0
Arizona,2018,11,3370604,61.6,3201936,58.5,168668,5.0
Arkansas,2018,11,1348986,58.0,1299048,55.9,49938,3.7
California,2018,11,19341208,62.4,18506174,59.7,835034,4.3
Los Angeles County,2018,11,5117277,63.3,4875991,60.4,241286,4.7
Colorado,2018,11,3074154,68.6,2978195,66.5,95959,3.1
Connecticut,2018,11,1932621,66.4,1860763,63.9,71858,3.7
Delaware,2018,11,481121,61.9,464129,59.8,16992,3.5
District of Columbia,2018,11,394441,70.1,371922,66.1,22519,5.7
Florida,2018,11,10163230,59.3,9806795,57.2,356435,3.5
Georgia,2018,11,5121554,62.9,4922351,60.5,199203,3.9
Hawaii,2018,11,687724,61.1,669105,59.5,18619,2.7
Idaho,2018,11,871079,64.1,845311,62.2,25768,3.0
Illinois,2018,11,6566078,64.8,6269545,61.9,296533,4.5
Indiana,2018,11,3400809,64.9,3279824,62.6,120985,3.6
Iowa,2018,11,1720630,69.4,1676341,67.6,44289,2.6
Kansas,2018,11,1495502,66.9,1444967,64.6,50535,3.4
Kentucky,2018,11,2050090,58.4,1963589,56.0,86501,4.2
Louisiana,2018,11,2102681,58.6,2001710,55.8,100971,4.8
Maine,2018,11,700002,62.8,676865,60.7,23137,3.3
Maryland,2018,11,3284008,67.9,3163607,65.5,120401,3.7
Massachusetts,2018,11,3836258,67.2,3709482,65.0,126776,3.3
Michigan,2018,11,4959109,61.7,4750865,59.1,208244,4.2
Minnesota,2018,11,3082383,69.5,2984559,67.3,97824,3.2
Mississippi,2018,11,1266372,55.5,1200515,52.6,65857,5.2
Missouri,2018,11,3050429,63.6,2953050,61.5,97379,3.2
Montana,2018,11,538005,63.4,518342,61.0,19663,3.7
Nebraska,2018,11,1041929,70.0,1010192,67.9,31737,3.0
Nevada,2018,11,1514086,63.7,1448898,60.9,65188,4.3
New Hampshire,2018,11,773554,68.8,753777,67.0,19777,2.6
New Jersey,2018,11,4612105,62.9,4442666,60.6,169439,3.7
New Mexico,2018,11,948960,57.9,900429,54.9,48531,5.1
New York,2018,11,9835681,60.6,9442909,58.2,392772,4.0
New York city,2018,11,4257637,59.9,4076525,57.3,181112,4.3
North Carolina,2018,11,4934296,61.1,4735340,58.7,198956,4.0
North Dakota,2018,11,411710,69.6,402127,68.0,9583,2.3
Ohio,2018,11,5836699,62.9,5573963,60.1,262736,4.5
Oklahoma,2018,11,1827361,60.8,1769219,58.9,58142,3.2
Oregon,2018,11,2087199,61.7,1998410,59.1,88789,4.3
Pennsylvania,2018,11,6539111,62.9,6257800,60.2,281311,4.3
Rhode Island,2018,11,572471,64.3,550168,61.8,22303,3.9
South Carolina,2018,11,2302219,58.0,2227242,56.1,74977,3.3
South Dakota,2018,11,460137,69.1,447488,67.2,12649,2.7
Tennessee,2018,11,3284094,61.2,3169758,59.1,114336,3.5
Texas,2018,11,13770218,63.8,13242160,61.4,528058,3.8
Utah,2018,11,1594424,68.3,1548839,66.4,45585,2.9
Vermont,2018,11,354931,66.8,346578,65.2,8353,2.4
Virginia,2018,11,4367520,65.3,4236410,63.3,131110,3.0
Washington,2018,11,3858540,64.5,3683176,61.6,175364,4.5
West Virginia,2018,11,794677,54.5,754484,51.8,40193,5.1
Wisconsin,2018,11,3111972,66.9,3018167,64.8,93805,3.0
Wyoming,2018,11,292591,65.6,280876,62.9,11715,4.0
Alabama,2018,12,2259852,57.6,2174521,55.4,85331,3.8
Alaska,2018,12,353511,64.8,332298,60.9,21213,6.0
Arizona,2018,12,3380640,61.7,3210355,58.6,170285,5.0
Arkansas,2018,12,1351662,58.1,1301513,56.0,50149,3.7
California,2018,12,19358470,62.4,18516907,59.7,841563,4.3
Los Angeles County,2018,12,5118275,63.4,4877194,60.4,241081,4.7
Colorado,2018,12,3079184,68.7,2984873,66.6,94311,3.1
Connecticut,2018,12,1933431,66.4,1861939,63.9,71492,3.7
Delaware,2018,12,482271,62.0,465185,59.8,17086,3.5
District of Columbia,2018,12,395656,70.3,372530,66.2,23126,5.8
Florida,2018,12,10172116,59.3,9814959,57.2,357157,3.5
Georgia,2018,12,5125971,62.9,4926826,60.5,199145,3.9
Hawaii,2018,12,686699,61.1,667796,59.4,18903,2.8
Idaho,2018,12,873623,64.1,847511,62.2,26112,3.0
Illinois,2018,12,6573958,64.9,6272795,61.9,301163,4.6
Indiana,2018,12,3403942,64.9,3282619,62.6,121323,3.6
Iowa,2018,12,1724481,69.5,1679734,67.7,44747,2.6
Kansas,2018,12,1496766,66.9,1445964,64.6,50802,3.4
Kentucky,2018,12,2051604,58.5,1965310,56.0,86294,4.2
Louisiana,2018,12,2104198,58.7,2003945,55.9,100253,4.8
Maine,2018,12,699179,62.7,676634,60.6,22545,3.2
Maryland,2018,12,3292917,68.1,3172633,65.6,120284,3.7
Massachusetts,2018,12,3838490,67.2,3712645,65.0,125845,3.3
Michigan,2018,12,4965846,61.8,4755801,59.1,210045,4.2
Minnesota,2018,12,3086977,69.6,2986773,67.3,100204,3.2
Mississippi,2018,12,1268505,55.6,1201136,52.7,67369,5.3
Missouri,2018,12,3055299,63.6,2955921,61.6,99378,3.3
Montana,2018,12,538708,63.4,519087,61.1,19621,3.6
Nebraska,2018,12,1043597,70.1,1011504,67.9,32093,3.1
Nevada,2018,12,1519209,63.8,1453593,61.0,65616,4.3
New Hampshire,2018,12,774650,68.9,754731,67.1,19919,2.6
New Jersey,2018,12,4619188,63.0,4452345,60.7,166843,3.6
New Mexico,2018,12,950640,58.0,901652,55.0,48988,5.2
New York,2018,12,9840825,60.6,9447272,58.2,393553,4.0
New York city,2018,12,4262800,60.0,4079204,57.4,183596,4.3
North Carolina,2018,12,4946004,61.2,4747457,58.8,198547,4.0
North Dakota,2018,12,412765,69.8,403051,68.2,9714,2.4
Ohio,2018,12,5843036,62.9,5581875,60.1,261161,4.5
Oklahoma,2018,12,1829903,60.9,1770921,58.9,58982,3.2
Oregon,2018,12,2091702,61.8,2002514,59.2,89188,4.3
Pennsylvania,2018,12,6550466,63.0,6266062,60.2,284404,4.3
Rhode Island,2018,12,572295,64.3,550309,61.8,21986,3.8
South Carolina,2018,12,2308376,58.1,2233861,56.2,74515,3.2
South Dakota,2018,12,460895,69.2,448081,67.3,12814,2.8
Tennessee,2018,12,3294640,61.4,3180069,59.2,114571,3.5
Texas,2018,12,13787114,63.8,13262040,61.4,525074,3.8
Utah,2018,12,1597603,68.4,1552442,66.4,45161,2.8
Vermont,2018,12,354968,66.8,346672,65.2,8296,2.3
Virginia,2018,12,4380653,65.4,4245652,63.4,135001,3.1
Washington,2018,12,3873868,64.7,3694275,61.7,179593,4.6
West Virginia,2018,12,794501,54.6,754301,51.8,40200,5.1
Wisconsin,2018,12,3112405,66.8,3018328,64.8,94077,3.0
Wyoming,2018,12,292526,65.5,281141,63.0,11385,3.9
Alabama,2019,1,2264526,57.7,2180712,55.6,83814,3.7
Alaska,2019,1,353156,64.8,332127,60.9,21029,6.0
Arizona,2019,1,3389140,61.7,3218743,58.6,170397,5.0
Arkansas,2019,1,1353523,58.2,1303850,56.0,49673,3.7
California,2019,1,19367080,62.4,18527572,59.7,839508,4.3
Los Angeles County,2019,1,5117724,63.4,4878706,60.4,239018,4.7
Colorado,2019,1,3083800,68.7,2991927,66.6,91873,3.0
Connecticut,2019,1,1933659,66.4,1862834,64.0,70825,3.7
Delaware,2019,1,483268,62.1,466118,59.9,17150,3.5
District of Columbia,2019,1,396983,70.6,373456,66.4,23527,5.9
Florida,2019,1,10180557,59.3,9824781,57.2,355776,3.5
Georgia,2019,1,5129857,62.9,4932298,60.5,197559,3.9
Hawaii,2019,1,685793,61.0,666823,59.3,18970,2.8
Idaho,2019,1,875941,64.2,849791,62.2,26150,3.0
Illinois,2019,1,6579087,64.9,6277328,62.0,301759,4.6
Indiana,2019,1,3405784,64.9,3285673,62.7,120111,3.5
Iowa,2019,1,1728416,69.6,1683462,67.8,44954,2.6
Kansas,2019,1,1497704,66.9,1447029,64.7,50675,3.4
Kentucky,2019,1,2053708,58.5,1967732,56.1,85976,4.2
Louisiana,2019,1,2105545,58.7,2006814,56.0,98731,4.7
Maine,2019,1,698128,62.5,676358,60.6,21770,3.1
Maryland,2019,1,3301314,68.3,3181980,65.8,119334,3.6
Massachusetts,2019,1,3840181,67.2,3715554,65.0,124627,3.2
Michigan,2019,1,4970052,61.8,4760117,59.2,209935,4.2
Minnesota,2019,1,3090464,69.6,2989126,67.4,101338,3.3
Mississippi,2019,1,1270306,55.7,1202088,52.7,68218,5.4
Missouri,2019,1,3059221,63.7,2958791,61.6,100430,3.3
Montana,2019,1,539209,63.4,519708,61.1,19501,3.6
Nebraska,2019,1,1045037,70.2,1012769,68.0,32268,3.1
Nevada,2019,1,1523916,63.9,1458328,61.1,65588,4.3
New Hampshire,2019,1,775729,68.9,755732,67.1,19997,2.6
New Jersey,2019,1,4626305,63.1,4462932,60.8,163373,3.5
New Mexico,2019,1,951940,58.0,902997,55.0,48943,5.1
New York,2019,1,9843200,60.6,9452089,58.2,391111,4.0
New York city,2019,1,4267363,60.0,4083608,57.4,183755,4.3
North Carolina,2019,1,4956844,61.3,4759961,58.9,196883,4.0
North Dakota,2019,1,413717,69.9,403945,68.3,9772,2.4
Ohio,2019,1,5846166,63.0,5590529,60.2,255637,4.4
Oklahoma,2019,1,1832322,61.0,1773208,59.0,59114,3.2
Oregon,2019,1,2094615,61.9,2006597,59.3,88018,4.2
Pennsylvania,2019,1,6559461,63.1,6272735,60.3,286726,4.4
Rhode Island,2019,1,571954,64.3,550457,61.8,21497,3.8
South Carolina,2019,1,2314365,58.2,2240068,56.3,74297,3.2
South Dakota,2019,1,461536,69.2,448580,67.3,12956,2.8
Tennessee,2019,1,3305850,61.5,3191290,59.4,114560,3.5
Texas,2019,1,13800436,63.8,13283685,61.4,516751,3.7
Utah,2019,1,1600770,68.4,1556237,66.5,44533,2.8
Vermont,2019,1,354921,66.8,346789,65.3,8132,2.3
Virginia,2019,1,4392649,65.6,4255805,63.5,136844,3.1
Washington,2019,1,3887757,64.9,3706011,61.9,181746,4.7
West Virginia,2019,1,793880,54.5,754035,51.8,39845,5.0
Wisconsin,2019,1,3112456,66.8,3018026,64.8,94430,3.0
Wyoming,2019,1,292363,65.5,281421,63.0,10942,3.7
Alabama,2019,2,2267778,57.8,2186484,55.7,81294,3.6
Alaska,2019,2,352844,64.7,332187,60.9,20657,5.9
Arizona,2019,2,3396327,61.8,3227254,58.7,169073,5.0
Arkansas,2019,2,1354286,58.2,1305675,56.1,48611,3.6
California,2019,2,19365489,62.4,18537538,59.7,827951,4.3
Los Angeles County,2019,2,5115967,63.4,4880924,60.4,235043,4.6
Colorado,2019,2,3087585,68.7,2998967,66.7,88618,2.9
Connecticut,2019,2,1933293,66.4,1863505,64.0,69788,3.6
Delaware,2019,2,483911,62.1,466780,59.9,17131,3.5
District of Columbia,2019,2,398121,70.8,374550,66.6,23571,5.9
Florida,2019,2,10189993,59.3,9838493,57.2,351500,3.4
Georgia,2019,2,5132415,62.9,4938240,60.5,194175,3.8
Hawaii,2019,2,684986,60.9,666191,59.2,18795,2.7
Idaho,2019,2,878001,64.2,852119,62.3,25882,2.9
Illinois,2019,2,6579243,65.0,6282635,62.0,296608,4.5
Indiana,2019,2,3404829,64.9,3287472,62.7,117357,3.4
Iowa,2019,2,1731954,69.8,1687073,68.0,44881,2.6
Kansas,2019,2,1498291,67.0,1448170,64.7,50121,3.3
Kentucky,2019,2,2055955,58.6,1970391,56.1,85564,4.2
Louisiana,2019,2,2105746,58.7,2009402,56.1,96344,4.6
Maine,2019,2,696932,62.4,676063,60.5,20869,3.0
Maryland,2019,2,3308425,68.4,3191085,66.0,117340,3.5
Massachusetts,2019,2,3841338,67.2,3718510,65.1,122828,3.2
Michigan,2019,2,4971557,61.8,4763577,59.2,207980,4.2
Minnesota,2019,2,3092881,69.7,2991761,67.4,101120,3.3
Mississippi,2019,2,1271765,55.8,1203342,52.8,68423,5.4
Missouri,2019,2,3061474,63.7,2961491,61.7,99983,3.3
Montana,2019,2,539489,63.4,520216,61.1,19273,3.6
Nebraska,2019,2,1046179,70.2,1013929,68.0,32250,3.1
Nevada,2019,2,1528094,63.9,1463068,61.2,65026,4.3
New Hampshire,2019,2,776581,68.9,756649,67.2,19932,2.6
New Jersey,2019,2,4632556,63.1,4474203,61.0,158353,3.4
New Mexico,2019,2,952777,58.1,904293,55.1,48484,5.1
New York,2019,2,9840991,60.6,9456144,58.3,384847,3.9
New York city,2019,2,4269825,60.0,4088844,57.5,180981,4.2
North Carolina,2019,2,4965154,61.4,4771068,59.0,194086,3.9
North Dakota,2019,2,414314,70.0,404612,68.4,9702,2.3
Ohio,2019,2,5847142,63.0,5600217,60.3,246925,4.2
Oklahoma,2019,2,1834100,61.0,1775662,59.0,58438,3.2
Oregon,2019,2,2095538,61.8,2009960,59.3,85578,4.1
Pennsylvania,2019,2,6563753,63.1,6277081,60.3,286672,4.4
Rhode Island,2019,2,571523,64.2,550637,61.8,20886,3.7
South Carolina,2019,2,2319434,58.3,2245515,56.4,73919,3.2
South Dakota,2019,2,461997,69.3,448963,67.3,13034,2.8
Tennessee,2019,2,3316132,61.7,3202022,59.6,114110,3.4
Texas,2019,2,13811128,63.8,13307135,61.5,503993,3.6
Utah,2019,2,1603860,68.4,1560140,66.5,43720,2.7
Vermont,2019,2,354683,66.7,346851,65.3,7832,2.2
Virginia,2019,2,4401454,65.7,4265872,63.7,135582,3.1
Washington,2019,2,3898819,65.0,3717843,62.0,180976,4.6
West Virginia,2019,2,792962,54.5,753819,51.8,39143,4.9
Wisconsin,2019,2,3112068,66.8,3017163,64.8,94905,3.0
Wyoming,2019,2,292167,65.4,281694,63.1,10473,3.6
Alabama,2019,3,2269628,57.8,2191567,55.8,78061,3.4
Alaska,2019,3,352689,64.7,332455,61.0,20234,5.7
Arizona,2019,3,3402988,61.8,3235840,58.8,167148,4.9
Arkansas,2019,3,1354001,58.2,1306615,56.1,47386,3.5
California,2019,3,19358569,62.4,18547526,59.8,811043,4.2
Los Angeles County,2019,3,5114703,63.3,4884410,60.5,230293,4.5
Colorado,2019,3,3090775,68.7,3005801,66.8,84974,2.7
Connecticut,2019,3,1932793,66.4,1864142,64.0,68651,3.6
Delaware,2019,3,484298,62.1,467213,59.9,17085,3.5
District of Columbia,2019,3,398984,70.9,375702,66.8,23282,5.8
Florida,2019,3,10203260,59.3,9857475,57.3,345785,3.4
Georgia,2019,3,5134722,62.8,4944622,60.5,190100,3.7
Hawaii,2019,3,684329,60.9,665862,59.2,18467,2.7
Idaho,2019,3,879984,64.2,854491,62.3,25493,2.9
Illinois,2019,3,6574964,64.9,6288440,62.1,286524,4.4
Indiana,2019,3,3401445,64.8,3287507,62.6,113938,3.3
Iowa,2019,3,1735308,69.9,1690540,68.1,44768,2.6
Kansas,2019,3,1498807,67.0,1449383,64.8,49424,3.3
Kentucky,2019,3,2058669,58.6,1973275,56.2,85394,4.1
Louisiana,2019,3,2104705,58.7,2010760,56.1,93945,4.5
Maine,2019,3,695866,62.3,675899,60.5,19967,2.9
Maryland,2019,3,3314555,68.5,3199527,66.1,115028,3.5
Massachusetts,2019,3,3842588,67.2,3721871,65.1,120717,3.1
Michigan,2019,3,4972222,61.8,4766403,59.3,205819,4.1
Minnesota,2019,3,3095055,69.7,2994930,67.4,100125,3.2
Mississippi,2019,3,1273486,55.9,1205055,52.9,68431,5.4
Missouri,2019,3,3062288,63.7,2964090,61.7,98198,3.2
Montana,2019,3,539763,63.4,520757,61.1,19006,3.5
Nebraska,2019,3,1047151,70.2,1014969,68.1,32182,3.1
Nevada,2019,3,1531890,64.0,1467753,61.3,64137,4.2
New Hampshire,2019,3,777197,69.0,757424,67.2,19773,2.5
New Jersey,2019,3,4639105,63.2,4486272,61.1,152833,3.3
New Mexico,2019,3,953444,58.1,905517,55.2,47927,5.0
New York,2019,3,9835870,60.6,9458865,58.3,377005,3.8
New York city,2019,3,4269425,60.0,4093336,57.6,176089,4.1
North Carolina,2019,3,4971127,61.4,4779738,59.0,191389,3.9
North Dakota,2019,3,414498,70.0,404990,68.4,9508,2.3
Ohio,2019,3,5849255,63.0,5610981,60.4,238274,4.1
Oklahoma,2019,3,1835270,61.0,1777965,59.1,57305,3.1
Oregon,2019,3,2095222,61.8,2012440,59.3,82782,4.0
Pennsylvania,2019,3,6563900,63.1,6279384,60.4,284516,4.3
Rhode Island,2019,3,571233,64.1,550924,61.9,20309,3.6
South Carolina,2019,3,2323303,58.3,2250293,56.5,73010,3.1
South Dakota,2019,3,462559,69.3,449492,67.3,13067,2.8
Tennessee,2019,3,3324707,61.8,3211607,59.7,113100,3.4
Texas,2019,3,13823117,63.8,13332306,61.5,490811,3.6
Utah,2019,3,1606935,68.4,1564065,66.6,42870,2.7
Vermont,2019,3,354244,66.6,346777,65.2,7467,2.1
Virginia,2019,3,4406129,65.7,4275093,63.8,131036,3.0
Washington,2019,3,3907300,65.1,3729379,62.1,177921,4.6
West Virginia,2019,3,792213,54.5,753843,51.8,38370,4.8
Wisconsin,2019,3,3111820,66.8,3015971,64.7,95849,3.1
Wyoming,2019,3,292071,65.4,281947,63.1,10124,3.5
Alabama,2019,4,2270687,57.8,2196095,55.9,74592,3.3
Alaska,2019,4,352819,64.7,332921,61.1,19898,5.6
Arizona,2019,4,3410012,61.9,3244842,58.9,165170,4.8
Arkansas,2019,4,1353141,58.1,1306797,56.1,46344,3.4
California,2019,4,19354579,62.4,18561791,59.8,792788,4.1
Los Angeles County,2019,4,5116806,63.4,4890908,60.6,225898,4.4
Colorado,2019,4,3094293,68.7,3012664,66.9,81629,2.6
Connecticut,2019,4,1932868,66.4,1865149,64.1,67719,3.5
Delaware,2019,4,484598,62.1,467532,59.9,17066,3.5
District of Columbia,2019,4,399731,71.0,376975,67.0,22756,5.7
Florida,2019,4,10222527,59.3,9882222,57.4,340305,3.3
Georgia,2019,4,5138778,62.8,4952273,60.5,186505,3.6
Hawaii,2019,4,683947,60.8,665888,59.2,18059,2.6
Idaho,2019,4,882163,64.2,857002,62.4,25161,2.9
Illinois,2019,4,6568376,64.9,6294678,62.2,273698,4.2
Indiana,2019,4,3397496,64.7,3286681,62.6,110815,3.3
Iowa,2019,4,1738816,70.0,1694012,68.2,44804,2.6
Kansas,2019,4,1499603,67.0,1450802,64.8,48801,3.3
Kentucky,2019,4,2062076,58.7,1976639,56.3,85437,4.1
Louisiana,2019,4,2103216,58.7,2010899,56.1,92317,4.4
Maine,2019,4,695349,62.2,676107,60.5,19242,2.8
Maryland,2019,4,3320517,68.6,3207406,66.3,113111,3.4
Massachusetts,2019,4,3844239,67.2,3725635,65.2,118604,3.1
Michigan,2019,4,4973954,61.8,4769277,59.3,204677,4.1
Minnesota,2019,4,3098022,69.7,2999096,67.5,98926,3.2
Mississippi,2019,4,1275385,55.9,1206756,52.9,68629,5.4
Missouri,2019,4,3062682,63.7,2967033,61.7,95649,3.1
Montana,2019,4,540329,63.4,521553,61.2,18776,3.5
Nebraska,2019,4,1048179,70.3,1016041,68.1,32138,3.1
Nevada,2019,4,1535651,64.0,1472519,61.4,63132,4.1
New Hampshire,2019,4,777808,69.0,758193,67.2,19615,2.5
New Jersey,2019,4,4648025,63.3,4499683,61.3,148342,3.2
New Mexico,2019,4,954169,58.1,906764,55.2,47405,5.0
New York,2019,4,9831378,60.6,9461587,58.3,369791,3.8
New York city,2019,4,4266912,60.0,4096751,57.6,170161,4.0
North Carolina,2019,4,4976373,61.4,4786566,59.0,189807,3.8
North Dakota,2019,4,414375,70.0,405146,68.4,9229,2.2
Ohio,2019,4,5854712,63.0,5622053,60.5,232659,4.0
Oklahoma,2019,4,1836250,61.0,1780082,59.1,56168,3.1
Oregon,2019,4,2094624,61.7,2014209,59.3,80415,3.8
Pennsylvania,2019,4,6562436,63.1,6281398,60.4,281038,4.3
Rhode Island,2019,4,571331,64.1,551423,61.9,19908,3.5
South Carolina,2019,4,2325931,58.3,2254908,56.5,71023,3.1
South Dakota,2019,4,463090,69.3,450023,67.4,13067,2.8
Tennessee,2019,4,3331704,61.9,3220354,59.8,111350,3.3
Texas,2019,4,13841337,63.8,13360705,61.6,480632,3.5
Utah,2019,4,1610196,68.4,1568152,66.6,42044,2.6
Vermont,2019,4,353700,66.5,346573,65.2,7127,2.0
Virginia,2019,4,4407440,65.7,4283241,63.9,124199,2.8
Washington,2019,4,3914380,65.1,3740812,62.2,173568,4.4
West Virginia,2019,4,792104,54.5,754326,51.9,37778,4.8
Wisconsin,2019,4,3112119,66.7,3014762,64.6,97357,3.1
Wyoming,2019,4,292190,65.4,282214,63.2,9976,3.4
Alabama,2019,5,2271498,57.8,2200089,56.0,71409,3.1
Alaska,2019,5,353153,64.8,333431,61.2,19722,5.6
Arizona,2019,5,3417572,61.9,3253918,58.9,163654,4.8
Arkansas,2019,5,1352252,58.1,1306500,56.1,45752,3.4
California,2019,5,19357506,62.4,18579975,59.9,777531,4.0
Los Angeles County,2019,5,5123021,63.5,4899937,60.7,223084,4.4
Colorado,2019,5,3098139,68.7,3018955,66.9,79184,2.6
Connecticut,2019,5,1933906,66.4,1866634,64.1,67272,3.5
Delaware,2019,5,484851,62.1,467721,59.9,17130,3.5
District of Columbia,2019,5,400261,71.1,378088,67.2,22173,5.5
Florida,2019,5,10247066,59.4,9910693,57.5,336373,3.3
Georgia,2019,5,5145242,62.8,4961161,60.6,184081,3.6
Hawaii,2019,5,683967,60.8,666326,59.3,17641,2.6
Idaho,2019,5,884592,64.3,859579,62.4,25013,2.8
Illinois,2019,5,6560571,64.8,6299386,62.2,261185,4.0
Indiana,2019,5,3394522,64.6,3285752,62.5,108770,3.2
Iowa,2019,5,1742294,70.1,1697160,68.3,45134,2.6
Kansas,2019,5,1500772,67.0,1452366,64.9,48406,3.2
Kentucky,2019,5,2065738,58.8,1980340,56.4,85398,4.1
Louisiana,2019,5,2101957,58.6,2009986,56.1,91971,4.4
Maine,2019,5,695531,62.2,676679,60.5,18852,2.7
Maryland,2019,5,3326680,68.7,3214618,66.4,112062,3.4
Massachusetts,2019,5,3845596,67.2,3728808,65.2,116788,3.0
Michigan,2019,5,4976278,61.9,4771686,59.3,204592,4.1
Minnesota,2019,5,3102053,69.7,3004022,67.5,98031,3.2
Mississippi,2019,5,1277714,56.1,1208442,53.0,69272,5.4
Missouri,2019,5,3063607,63.7,2970244,61.8,93363,3.0
Montana,2019,5,541302,63.5,522651,61.3,18651,3.4
Nebraska,2019,5,1049323,70.3,1017129,68.2,32194,3.1
Nevada,2019,5,1539538,64.1,1477224,61.5,62314,4.0
New Hampshire,2019,5,778642,69.0,759071,67.3,19571,2.5
New Jersey,2019,5,4660187,63.5,4513663,61.5,146524,3.1
New Mexico,2019,5,954993,58.1,907964,55.2,47029,4.9
New York,2019,5,9830577,60.6,9464972,58.3,365605,3.7
New York city,2019,5,4264013,60.0,4099198,57.6,164815,3.9
North Carolina,2019,5,4982179,61.4,4792219,59.1,189960,3.8
North Dakota,2019,5,414040,69.9,405104,68.4,8936,2.2
Ohio,2019,5,5862945,63.1,5631401,60.6,231544,3.9
Oklahoma,2019,5,1837367,61.0,1781834,59.2,55533,3.0
Oregon,2019,5,2094094,61.6,2015299,59.3,78795,3.8
Pennsylvania,2019,5,6561551,63.1,6283823,60.4,277728,4.2
Rhode Island,2019,5,571893,64.2,552140,62.0,19753,3.5
South Carolina,2019,5,2327059,58.3,2259261,56.6,67798,2.9
South Dakota,2019,5,463626,69.3,450586,67.4,13040,2.8
Tennessee,2019,5,3336783,61.9,3227570,59.9,109213,3.3
Texas,2019,5,13867232,63.8,13391079,61.6,476153,3.4
Utah,2019,5,1613572,68.4,1572264,66.7,41308,2.6
Vermont,2019,5,353145,66.4,346245,65.1,6900,2.0
Virginia,2019,5,4406785,65.7,4289833,63.9,116952,2.7
Washington,2019,5,3921007,65.2,3751956,62.3,169051,4.3
West Virginia,2019,5,792740,54.6,755192,52.0,37548,4.7
Wisconsin,2019,5,3112759,66.7,3013573,64.6,99186,3.2
Wyoming,2019,5,292513,65.4,282465,63.2,10048,3.4
Alabama,2019,6,2272349,57.8,2203355,56.0,68994,3.0
Alaska,2019,6,353494,64.9,333792,61.3,19702,5.6
Arizona,2019,6,3425814,61.9,3262719,59.0,163095,4.8
Arkansas,2019,6,1351886,58.0,1306120,56.1,45766,3.4
California,2019,6,19368357,62.4,18599205,59.9,769152,4.0
Los Angeles County,2019,6,5132650,63.6,4910150,60.8,222500,4.3
Colorado,2019,6,3102097,68.7,3024094,67.0,78003,2.5
Connecticut,2019,6,1935972,66.5,1868465,64.2,67507,3.5
Delaware,2019,6,485073,62.0,467756,59.8,17317,3.6
District of Columbia,2019,6,400513,71.1,378850,67.3,21663,5.4
Florida,2019,6,10274484,59.5,9940217,57.6,334267,3.3
Georgia,2019,6,5153452,62.9,4970634,60.6,182818,3.5
Hawaii,2019,6,684432,60.9,667155,59.4,17277,2.5
Idaho,2019,6,887258,64.3,862135,62.5,25123,2.8
Illinois,2019,6,6552567,64.7,6300928,62.2,251639,3.8
Indiana,2019,6,3393689,64.6,3285627,62.5,108062,3.2
Iowa,2019,6,1745510,70.2,1699633,68.3,45877,2.6
Kansas,2019,6,1502492,67.1,1454108,64.9,48384,3.2
Kentucky,2019,6,2069310,58.9,1983955,56.5,85355,4.1
Louisiana,2019,6,2101617,58.6,2008492,56.0,93125,4.4
Maine,2019,6,696328,62.2,677427,60.5,18901,2.7
Maryland,2019,6,3332979,68.8,3220992,66.5,111987,3.4
Massachusetts,2019,6,3846204,67.2,3730701,65.2,115503,3.0
Michigan,2019,6,4978465,61.9,4773235,59.3,205230,4.1
Minnesota,2019,6,3106703,69.8,3008666,67.6,98037,3.2
Mississippi,2019,6,1280321,56.2,1209906,53.1,70415,5.5
Missouri,2019,6,3066252,63.7,2973694,61.8,92558,3.0
Montana,2019,6,542642,63.6,523965,61.4,18677,3.4
Nebraska,2019,6,1050737,70.4,1018239,68.2,32498,3.1
Nevada,2019,6,1543662,64.1,1481740,61.6,61922,4.0
New Hampshire,2019,6,779744,69.0,760054,67.3,19690,2.5
New Jersey,2019,6,4675185,63.6,4526756,61.6,148429,3.2
New Mexico,2019,6,955825,58.1,908975,55.3,46850,4.9
New York,2019,6,9834810,60.6,9468743,58.3,366067,3.7
New York city,2019,6,4261786,59.9,4100222,57.6,161564,3.8
North Carolina,2019,6,4989160,61.4,4797394,59.1,191766,3.8
North Dakota,2019,6,413670,69.8,404947,68.3,8723,2.1
Ohio,2019,6,5872584,63.2,5637911,60.7,234673,4.0
Oklahoma,2019,6,1838792,61.0,1783014,59.2,55778,3.0
Oregon,2019,6,2093901,61.6,2016106,59.3,77795,3.7
Pennsylvania,2019,6,6562938,63.1,6286679,60.4,276259,4.2
Rhode Island,2019,6,572919,64.3,553075,62.0,19844,3.5
South Carolina,2019,6,2326762,58.2,2262867,56.6,63895,2.7
South Dakota,2019,6,464210,69.4,451185,67.4,13025,2.8
Tennessee,2019,6,3339502,61.9,3232038,59.9,107464,3.2
Texas,2019,6,13899578,63.9,13421091,61.7,478487,3.4
Utah,2019,6,1616979,68.4,1576286,66.7,40693,2.5
Vermont,2019,6,352718,66.3,345849,65.0,6869,1.9
Virginia,2019,6,4406279,65.6,4294740,64.0,111539,2.5
Washington,2019,6,3928123,65.2,3762718,62.4,165405,4.2
West Virginia,2019,6,793963,54.7,756149,52.1,37814,4.8
Wisconsin,2019,6,3113457,66.7,3012549,64.5,100908,3.2
Wyoming,2019,6,292974,65.5,282666,63.2,10308,3.5
Alabama,2019,7,2273507,57.8,2205842,56.0,67665,3.0
Alaska,2019,7,353702,64.9,333936,61.3,19766,5.6
Arizona,2019,7,3434461,62.0,3271005,59.1,163456,4.8
Arkansas,2019,7,1352449,58.0,1306096,56.0,46353,3.4
California,2019,7,19386134,62.4,18617193,59.9,768941,4.0
Los Angeles County,2019,7,5144277,63.8,4920327,61.0,223950,4.4
Colorado,2019,7,3106025,68.7,3028025,67.0,78000,2.5
Connecticut,2019,7,1938572,66.6,1870152,64.2,68420,3.5
Delaware,2019,7,485276,62.0,467678,59.7,17598,3.6
District of Columbia,2019,7,400452,71.1,379157,67.3,21295,5.3
Florida,2019,7,10301481,59.6,9968184,57.7,333297,3.2
Georgia,2019,7,5162281,62.9,4979988,60.7,182293,3.5
Hawaii,2019,7,685201,61.0,668196,59.4,17005,2.5
Idaho,2019,7,890034,64.4,864570,62.5,25464,2.9
Illinois,2019,7,6545329,64.6,6298913,62.2,246416,3.8
Indiana,2019,7,3395922,64.6,3287135,62.5,108787,3.2
Iowa,2019,7,1748232,70.3,1701239,68.4,46993,2.7
Kansas,2019,7,1504725,67.2,1455979,65.0,48746,3.2
Kentucky,2019,7,2072575,59.0,1987227,56.5,85348,4.1
Louisiana,2019,7,2102645,58.7,2007009,56.0,95636,4.5
Maine,2019,7,697512,62.3,678147,60.6,19365,2.8
Maryland,2019,7,3339062,68.9,3226539,66.6,112523,3.4
Massachusetts,2019,7,3845756,67.2,3731035,65.2,114721,3.0
Michigan,2019,7,4980149,61.9,4774162,59.3,205987,4.1
Minnesota,2019,7,3111171,69.8,3011930,67.6,99241,3.2
Mississippi,2019,7,1282240,56.2,1210430,53.1,71810,5.6
Missouri,2019,7,3071207,63.8,2977331,61.9,93876,3.1
Montana,2019,7,544123,63.7,525289,61.5,18834,3.5
Nebraska,2019,7,1052410,70.4,1019347,68.2,33063,3.1
Nevada,2019,7,1548026,64.2,1485980,61.6,62046,4.0
New Hampshire,2019,7,781034,69.1,761095,67.3,19939,2.6
New Jersey,2019,7,4691659,63.8,4537766,61.7,153893,3.3
New Mexico,2019,7,956516,58.1,909691,55.3,46825,4.9
New York,2019,7,9842925,60.6,9472035,58.3,370890,3.8
New York city,2019,7,4260487,59.9,4099835,57.6,160652,3.8
North Carolina,2019,7,4997179,61.5,4802847,59.1,194332,3.9
North Dakota,2019,7,413439,69.7,404795,68.3,8644,2.1
Ohio,2019,7,5881896,63.3,5641433,60.7,240463,4.1
Oklahoma,2019,7,1840658,61.1,1783792,59.2,56866,3.1
Oregon,2019,7,2094142,61.5,2017120,59.3,77022,3.7
Pennsylvania,2019,7,6567328,63.1,6289671,60.4,277657,4.2
Rhode Island,2019,7,574293,64.4,554197,62.1,20096,3.5
South Carolina,2019,7,2325645,58.1,2265379,56.6,60266,2.6
South Dakota,2019,7,464798,69.4,451741,67.4,13057,2.8
Tennessee,2019,7,3340584,61.9,3233639,59.9,106945,3.2
Texas,2019,7,13934585,64.0,13448594,61.7,485991,3.5
Utah,2019,7,1620347,68.4,1580126,66.7,40221,2.5
Vermont,2019,7,352536,66.2,345483,64.9,7053,2.0
Virginia,2019,7,4407707,65.6,4298145,64.0,109562,2.5
Washington,2019,7,3936274,65.2,3773125,62.5,163149,4.1
West Virginia,2019,7,795445,54.8,756881,52.1,38564,4.8
Wisconsin,2019,7,3113819,66.7,3011616,64.5,102203,3.3
Wyoming,2019,7,293471,65.6,282784,63.2,10687,3.6
Alabama,2019,8,2274863,57.8,2207547,56.0,67316,3.0
Alaska,2019,8,353702,64.9,333931,61.3,19771,5.6
Arizona,2019,8,3442943,62.0,3278899,59.1,164044,4.8
Arkansas,2019,8,1353931,58.1,1306750,56.0,47181,3.5
California,2019,8,19409740,62.5,18635662,60.0,774078,4.0
Los Angeles County,2019,8,5157396,63.9,4930880,61.1,226516,4.4
Colorado,2019,8,3110124,68.7,3031370,66.9,78754,2.5
Connecticut,2019,8,1941260,66.6,1871584,64.2,69676,3.6
Delaware,2019,8,485361,61.9,467496,59.6,17865,3.7
District of Columbia,2019,8,400265,71.1,379224,67.3,21041,5.3
Florida,2019,8,10325409,59.7,9993635,57.8,331774,3.2
Georgia,2019,8,5170691,62.9,4989063,60.7,181628,3.5
Hawaii,2019,8,686173,61.0,669379,59.5,16794,2.4
Idaho,2019,8,892687,64.4,866867,62.5,25820,2.9
Illinois,2019,8,6538622,64.6,6294310,62.2,244312,3.7
Indiana,2019,8,3400619,64.6,3290266,62.5,110353,3.2
Iowa,2019,8,1750163,70.3,1702071,68.4,48092,2.7
Kansas,2019,8,1507027,67.2,1457827,65.0,49200,3.3
Kentucky,2019,8,2075260,59.0,1990044,56.6,85216,4.1
Louisiana,2019,8,2104944,58.7,2006198,56.0,98746,4.7
Maine,2019,8,698734,62.3,678687,60.6,20047,2.9
Maryland,2019,8,3344334,69.0,3231601,66.6,112733,3.4
Massachusetts,2019,8,3843970,67.1,3729927,65.1,114043,3.0
Michigan,2019,8,4981041,61.9,4775068,59.3,205973,4.1
Minnesota,2019,8,3114786,69.9,3013791,67.6,100995,3.2
Mississippi,2019,8,1283384,56.3,1210524,53.1,72860,5.7
Missouri,2019,8,3077964,63.9,2980938,61.9,97026,3.2
Montana,2019,8,545521,63.8,526490,61.5,19031,3.5
Nebraska,2019,8,1054059,70.5,1020417,68.2,33642,3.2
Nevada,2019,8,1552494,64.3,1489955,61.7,62539,4.0
New Hampshire,2019,8,782346,69.2,762133,67.4,20213,2.6
New Jersey,2019,8,4707756,64.0,4546431,61.8,161325,3.4
New Mexico,2019,8,957066,58.1,910249,55.3,46817,4.9
New York,2019,8,9853617,60.7,9475946,58.3,377671,3.8
New York city,2019,8,4260193,59.9,4099097,57.6,161096,3.8
North Carolina,2019,8,5005158,61.5,4808970,59.1,196188,3.9
North Dakota,2019,8,413380,69.7,404706,68.2,8674,2.1
Ohio,2019,8,5889385,63.3,5642653,60.7,246732,4.2
Oklahoma,2019,8,1842859,61.1,1784657,59.2,58202,3.2
Oregon,2019,8,2094334,61.5,2018330,59.2,76004,3.6
Pennsylvania,2019,8,6574197,63.1,6292730,60.4,281467,4.3
Rhode Island,2019,8,575733,64.5,555392,62.2,20341,3.5
South Carolina,2019,8,2324574,58.0,2266856,56.5,57718,2.5
South Dakota,2019,8,465414,69.4,452319,67.5,13095,2.8
Tennessee,2019,8,3341343,61.8,3233449,59.8,107894,3.2
Texas,2019,8,13967268,64.0,13473161,61.8,494107,3.5
Utah,2019,8,1623654,68.5,1583783,66.8,39871,2.5
Vermont,2019,8,352612,66.2,345247,64.8,7365,2.1
Virginia,2019,8,4412242,65.6,4301027,64.0,111215,2.5
Washington,2019,8,3945475,65.3,3783381,62.6,162094,4.1
West Virginia,2019,8,796810,54.9,757310,52.2,39500,5.0
Wisconsin,2019,8,3113565,66.6,3010722,64.4,102843,3.3
Wyoming,2019,8,293912,65.7,282829,63.2,11083,3.8
Alabama,2019,9,2276161,57.7,2208693,56.0,67468,3.0
Alaska,2019,9,353496,64.9,333965,61.3,19531,5.5
Arizona,2019,9,3451406,62.1,3287572,59.1,163834,4.7
Arkansas,2019,9,1355927,58.1,1308223,56.1,47704,3.5
California,2019,9,19441074,62.6,18662231,60.1,778843,4.0
Los Angeles County,2019,9,5172937,64.2,4943828,61.3,229109,4.4
Colorado,2019,9,3115226,68.7,3035500,66.9,79726,2.6
Connecticut,2019,9,1943889,66.7,1873225,64.3,70664,3.6
Delaware,2019,9,485332,61.8,467362,59.5,17970,3.7
District of Columbia,2019,9,400397,71.1,379583,67.4,20814,5.2
Florida,2019,9,10347607,59.7,10019752,57.8,327855,3.2
Georgia,2019,9,5179324,63.0,4999343,60.8,179981,3.5
Hawaii,2019,9,687407,61.1,670831,59.7,16576,2.4
Idaho,2019,9,895172,64.4,869304,62.6,25868,2.9
Illinois,2019,9,6532159,64.5,6289915,62.1,242244,3.7
Indiana,2019,9,3406770,64.7,3295351,62.6,111419,3.3
Iowa,2019,9,1751371,70.3,1702786,68.4,48585,2.8
Kansas,2019,9,1509246,67.3,1459913,65.1,49333,3.3
Kentucky,2019,9,2077317,59.0,1992682,56.6,84635,4.1
Louisiana,2019,9,2108003,58.8,2006934,56.0,101069,4.8
Maine,2019,9,699779,62.4,679066,60.5,20713,3.0
Maryland,2019,9,3348935,69.0,3237448,66.7,111487,3.3
Massachusetts,2019,9,3841822,67.0,3728943,65.1,112879,2.9
Michigan,2019,9,4981560,61.8,4778213,59.3,203347,4.1
Minnesota,2019,9,3117923,69.9,3015951,67.6,101972,3.3
Mississippi,2019,9,1283302,56.3,1210487,53.1,72815,5.7
Missouri,2019,9,3085426,64.0,2984906,62.0,100520,3.3
Montana,2019,9,546873,63.8,527744,61.6,19129,3.5
Nebraska,2019,9,1055598,70.5,1021734,68.3,33864,3.2
Nevada,2019,9,1557129,64.3,1494110,61.7,63019,4.0
New Hampshire,2019,9,783557,69.2,763222,67.4,20335,2.6
New Jersey,2019,9,4722462,64.2,4554199,61.9,168263,3.6
New Mexico,2019,9,957740,58.1,911064,55.3,46676,4.9
New York,2019,9,9868458,60.8,9486126,58.4,382332,3.9
New York city,2019,9,4262622,60.0,4101341,57.7,161281,3.8
North Carolina,2019,9,5012386,61.5,4816739,59.1,195647,3.9
North Dakota,2019,9,413493,69.7,404784,68.2,8709,2.1
Ohio,2019,9,5896379,63.4,5645127,60.7,251252,4.3
Oklahoma,2019,9,1845117,61.1,1786225,59.2,58892,3.2
Oregon,2019,9,2094267,61.4,2019927,59.2,74340,3.5
Pennsylvania,2019,9,6582426,63.2,6297172,60.4,285254,4.3
Rhode Island,2019,9,576981,64.6,556657,62.3,20324,3.5
South Carolina,2019,9,2324827,57.9,2268247,56.5,56580,2.4
South Dakota,2019,9,465780,69.4,452750,67.5,13030,2.8
Tennessee,2019,9,3343303,61.8,3233596,59.8,109707,3.3
Texas,2019,9,13997343,64.1,13500270,61.8,497073,3.6
Utah,2019,9,1627213,68.5,1587717,66.8,39496,2.4
Vermont,2019,9,352910,66.2,345268,64.8,7642,2.2
Virginia,2019,9,4420285,65.7,4305261,64.0,115024,2.6
Washington,2019,9,3955447,65.4,3794734,62.7,160713,4.1
West Virginia,2019,9,797936,55.0,757791,52.2,40145,5.0
Wisconsin,2019,9,3112977,66.6,3010622,64.4,102355,3.3
Wyoming,2019,9,294275,65.7,282900,63.2,11375,3.9
Alabama,2019,10,2276933,57.7,2208773,56.0,68160,3.0
Alaska,2019,10,353202,64.8,334046,61.3,19156,5.4
Arizona,2019,10,3460160,62.1,3296609,59.2,163551,4.7
Arkansas,2019,10,1357707,58.2,1309804,56.1,47903,3.5
California,2019,10,19480690,62.7,18694897,60.1,785793,4.0
Los Angeles County,2019,10,5191613,64.4,4958641,61.5,232972,4.5
Colorado,2019,10,3121420,68.8,3039940,67.0,81480,2.6
Connecticut,2019,10,1946103,66.8,1874552,64.3,71551,3.7
Delaware,2019,10,485115,61.7,467197,59.4,17918,3.7
District of Columbia,2019,10,400943,71.1,380186,67.4,20757,5.2
Florida,2019,10,10368447,59.8,10045884,57.9,322563,3.1
Georgia,2019,10,5188228,63.0,5009722,60.8,178506,3.4
Hawaii,2019,10,688669,61.2,672333,59.8,16336,2.4
Idaho,2019,10,897416,64.4,871771,62.6,25645,2.9
Illinois,2019,10,6525954,64.5,6286173,62.1,239781,3.7
Indiana,2019,10,3412290,64.7,3300410,62.6,111880,3.3
Iowa,2019,10,1751349,70.3,1702985,68.3,48364,2.8
Kansas,2019,10,1511145,67.3,1461908,65.2,49237,3.3
Kentucky,2019,10,2078656,59.1,1994566,56.7,84090,4.0
Louisiana,2019,10,2110389,58.9,2008163,56.0,102226,4.8
Maine,2019,10,700469,62.4,679103,60.5,21366,3.1
Maryland,2019,10,3353342,69.1,3243692,66.8,109650,3.3
Massachusetts,2019,10,3839638,66.9,3727975,65.0,111663,2.9
Michigan,2019,10,4981280,61.8,4782814,59.4,198466,4.0
Minnesota,2019,10,3121525,69.9,3019036,67.6,102489,3.3
Mississippi,2019,10,1282481,56.2,1210413,53.1,72068,5.6
Missouri,2019,10,3091677,64.1,2988481,62.0,103196,3.3
Montana,2019,10,548198,63.9,528989,61.7,19209,3.5
Nebraska,2019,10,1056774,70.6,1023064,68.3,33710,3.2
Nevada,2019,10,1561801,64.4,1498156,61.8,63645,4.1
New Hampshire,2019,10,784414,69.2,764052,67.4,20362,2.6
New Jersey,2019,10,4735359,64.3,4560884,61.9,174475,3.7
New Mexico,2019,10,958729,58.1,911965,55.3,46764,4.9
New York,2019,10,9886761,60.9,9500903,58.5,385858,3.9
New York city,2019,10,4268073,60.1,4105974,57.8,162099,3.8
North Carolina,2019,10,5018415,61.5,4824917,59.1,193498,3.9
North Dakota,2019,10,413593,69.7,404898,68.2,8695,2.1
Ohio,2019,10,5904838,63.4,5650758,60.7,254080,4.3
Oklahoma,2019,10,1846557,61.1,1787697,59.2,58860,3.2
Oregon,2019,10,2094425,61.4,2021841,59.2,72584,3.5
Pennsylvania,2019,10,6589949,63.2,6301001,60.5,288948,4.4
Rhode Island,2019,10,577871,64.7,557700,62.4,20171,3.5
South Carolina,2019,10,2326504,57.9,2269392,56.5,57112,2.5
South Dakota,2019,10,466176,69.4,453315,67.5,12861,2.8
Tennessee,2019,10,3346601,61.8,3234369,59.7,112232,3.4
Texas,2019,10,14024711,64.1,13529427,61.8,495284,3.5
Utah,2019,10,1630934,68.5,1591627,66.8,39307,2.4
Vermont,2019,10,353223,66.2,345460,64.8,7763,2.2
Virginia,2019,10,4429848,65.8,4310206,64.0,119642,2.7
Washington,2019,10,3964612,65.5,3806436,62.9,158176,4.0
West Virginia,2019,10,798819,55.0,758284,52.2,40535,5.1
Wisconsin,2019,10,3111764,66.5,3010700,64.3,101064,3.2
Wyoming,2019,10,294589,65.7,282955,63.1,11634,3.9
Alabama,2019,11,2276651,57.7,2207391,55.9,69260,3.0
Alaska,2019,11,353046,64.8,334195,61.3,18851,5.3
Arizona,2019,11,3468810,62.1,3304986,59.2,163824,4.7
Arkansas,2019,11,1358510,58.2,1310605,56.1,47905,3.5
California,2019,11,19526010,62.8,18728829,60.2,797181,4.1
Los Angeles County,2019,11,5212480,64.7,4973651,61.7,238829,4.6
Colorado,2019,11,3128304,68.8,3043847,67.0,84457,2.7
Connecticut,2019,11,1947497,66.8,1875035,64.3,72462,3.7
Delaware,2019,11,484584,61.6,466823,59.3,17761,3.7
District of Columbia,2019,11,401741,71.2,380770,67.5,20971,5.2
Florida,2019,11,10387270,59.8,10069962,58.0,317308,3.1
Georgia,2019,11,5196567,63.0,5018217,60.9,178350,3.4
Hawaii,2019,11,689710,61.3,673683,59.9,16027,2.3
Idaho,2019,11,899249,64.4,874025,62.6,25224,2.8
Illinois,2019,11,6520059,64.4,6282493,62.1,237566,3.6
Indiana,2019,11,3414590,64.7,3302570,62.6,112020,3.3
Iowa,2019,11,1749368,70.2,1701780,68.3,47588,2.7
Kansas,2019,11,1512514,67.4,1463414,65.2,49100,3.2
Kentucky,2019,11,2078831,59.0,1994918,56.7,83913,4.0
Louisiana,2019,11,2110022,58.8,2007746,56.0,102276,4.8
Maine,2019,11,700668,62.4,678712,60.4,21956,3.1
Maryland,2019,11,3357914,69.2,3249248,66.9,108666,3.2
Massachusetts,2019,11,3836640,66.9,3726016,64.9,110624,2.9
Michigan,2019,11,4978893,61.8,4786071,59.4,192822,3.9
Minnesota,2019,11,3126229,70.0,3022952,67.7,103277,3.3
Mississippi,2019,11,1281580,56.2,1210245,53.1,71335,5.6
Missouri,2019,11,3095243,64.2,2991108,62.0,104135,3.4
Montana,2019,11,549340,64.0,530021,61.7,19319,3.5
Nebraska,2019,11,1057334,70.6,1024055,68.3,33279,3.1
Nevada,2019,11,1565992,64.5,1501574,61.8,64418,4.1
New Hampshire,2019,11,784633,69.2,764300,67.4,20333,2.6
New Jersey,2019,11,4746264,64.4,4566123,62.0,180141,3.8
New Mexico,2019,11,959947,58.2,912641,55.3,47306,4.9
New York,2019,11,9904428,61.0,9514584,58.6,389844,3.9
New York city,2019,11,4274975,60.2,4110148,57.8,164827,3.9
North Carolina,2019,11,5023056,61.5,4831883,59.2,191173,3.8
North Dakota,2019,11,413357,69.6,404802,68.1,8555,2.1
Ohio,2019,11,5915539,63.5,5660000,60.8,255539,4.3
Oklahoma,2019,11,1846306,61.1,1787984,59.1,58322,3.2
Oregon,2019,11,2094636,61.3,2023258,59.2,71378,3.4
Pennsylvania,2019,11,6593548,63.3,6301612,60.5,291936,4.4
Rhode Island,2019,11,578324,64.7,558232,62.5,20092,3.5
South Carolina,2019,11,2328768,57.9,2269784,56.4,58984,2.5
South Dakota,2019,11,466323,69.4,453706,67.5,12617,2.7
Tennessee,2019,11,3349654,61.8,3234902,59.7,114752,3.4
Texas,2019,11,14049832,64.1,13558434,61.9,491398,3.5
Utah,2019,11,1634430,68.5,1595027,66.9,39403,2.4
Vermont,2019,11,353248,66.2,345667,64.8,7581,2.1
Virginia,2019,11,4438033,65.9,4314533,64.0,123500,2.8
Washington,2019,11,3971480,65.5,3817222,63.0,154258,3.9
West Virginia,2019,11,799341,55.1,758515,52.3,40826,5.1
Wisconsin,2019,11,3109501,66.4,3010069,64.3,99432,3.2
Wyoming,2019,11,294890,65.7,282929,63.1,11961,4.1
Alabama,2019,12,2274286,57.6,2203603,55.8,70683,3.1
Alaska,2019,12,353020,64.8,334249,61.4,18771,5.3
Arizona,2019,12,3475107,62.1,3310351,59.2,164756,4.7
Arkansas,2019,12,1357794,58.1,1309953,56.1,47841,3.5
California,2019,12,19565560,62.9,18751201,60.3,814359,4.2
Los Angeles County,2019,12,5231456,64.9,4984345,61.9,247111,4.7
Colorado,2019,12,3133811,68.9,3045150,66.9,88661,2.8
Connecticut,2019,12,1946805,66.8,1873463,64.2,73342,3.8
Delaware,2019,12,483633,61.4,466032,59.1,17601,3.6
District of Columbia,2019,12,402396,71.3,380934,67.5,21462,5.3
Florida,2019,12,10396424,59.8,10083108,58.0,313316,3.0
Georgia,2019,12,5202079,63.0,5021928,60.9,180151,3.5
Hawaii,2019,12,690095,61.4,674409,60.0,15686,2.3
Idaho,2019,12,900353,64.3,875519,62.6,24834,2.8
Illinois,2019,12,6513265,64.3,6275833,62.0,237432,3.6
Indiana,2019,12,3412569,64.7,3299855,62.5,112714,3.3
Iowa,2019,12,1744525,70.0,1697885,68.1,46640,2.7
Kansas,2019,12,1512705,67.4,1463520,65.2,49185,3.3
Kentucky,2019,12,2076707,59.0,1992523,56.6,84184,4.1
Louisiana,2019,12,2105307,58.7,2003853,55.9,101454,4.8
Maine,2019,12,699997,62.3,677642,60.3,22355,3.2
Maryland,2019,12,3362081,69.2,3252096,67.0,109985,3.3
Massachusetts,2019,12,3829604,66.7,3720005,64.8,109599,2.9
Michigan,2019,12,4972310,61.7,4783505,59.3,188805,3.8
Minnesota,2019,12,3130379,70.0,3025549,67.7,104830,3.3
Mississippi,2019,12,1280058,56.1,1208806,53.0,71252,5.6
Missouri,2019,12,3094815,64.2,2991415,62.0,103400,3.3
Montana,2019,12,549838,64.0,530406,61.7,19432,3.5
Nebraska,2019,12,1056803,70.5,1024057,68.3,32746,3.1
Nevada,2019,12,1568672,64.5,1503316,61.8,65356,4.2
New Hampshire,2019,12,783667,69.1,763377,67.3,20290,2.6
New Jersey,2019,12,4752986,64.5,4567851,62.0,185135,3.9
New Mexico,2019,12,960760,58.2,912506,55.2,48254,5.0
New York,2019,12,9913846,61.0,9519010,58.6,394836,4.0
New York city,2019,12,4280022,60.3,4110433,57.9,169589,4.0
North Carolina,2019,12,5023963,61.5,4834082,59.1,189881,3.8
North Dakota,2019,12,412619,69.4,404207,68.0,8412,2.0
Ohio,2019,12,5924607,63.6,5666842,60.8,257765,4.4
Oklahoma,2019,12,1843930,61.0,1786162,59.0,57768,3.1
Oregon,2019,12,2093864,61.2,2022579,59.2,71285,3.4
Pennsylvania,2019,12,6588288,63.2,6293991,60.4,294297,4.5
Rhode Island,2019,12,578028,64.6,557740,62.4,20288,3.5
South Carolina,2019,12,2329660,57.8,2267885,56.3,61775,2.7
South Dakota,2019,12,466087,69.3,453726,67.5,12361,2.7
Tennessee,2019,12,3349275,61.7,3233025,59.6,116250,3.5
Texas,2019,12,14065707,64.1,13576338,61.9,489369,3.5
Utah,2019,12,1636696,68.5,1596964,66.8,39732,2.4
Vermont,2019,12,352852,66.1,345548,64.7,7304,2.1
Virginia,2019,12,4439914,65.8,4315067,64.0,124847,2.8
Washington,2019,12,3974992,65.5,3824379,63.0,150613,3.8
West Virginia,2019,12,799331,55.1,758068,52.2,41263,5.2
Wisconsin,2019,12,3105297,66.3,3007528,64.2,97769,3.1
Wyoming,2019,12,295088,65.8,282659,63.0,12429,4.2
Alabama,2020,1,2269715,57.5,2197356,55.6,72359,3.2
Alaska,2020,1,352920,64.8,333990,61.3,18930,5.4
Arizona,2020,1,3477155,62.1,3311092,59.1,166063,4.8
Arkansas,2020,1,1355834,58.0,1308003,55.9,47831,3.5
California,2020,1,19590529,63.0,18754316,60.3,836213,4.3
Los Angeles County,2020,1,5245158,65.1,4987797,61.9,257361,4.9
Colorado,2020,1,3136173,68.9,3042478,66.8,93695,3.0
Connecticut,2020,1,1943476,66.6,1869398,64.1,74078,3.8
Delaware,2020,1,482323,61.1,464813,58.9,17510,3.6
District of Columbia,2020,1,402467,71.3,380366,67.4,22101,5.5
Florida,2020,1,10387092,59.7,10076556,57.9,310536,3.0
Georgia,2020,1,5203244,63.0,5019687,60.8,183557,3.5
Hawaii,2020,1,689607,61.3,674250,59.9,15357,2.2
Idaho,2020,1,900710,64.2,875946,62.5,24764,2.7
Illinois,2020,1,6507618,64.3,6266207,61.9,241411,3.7
Indiana,2020,1,3406212,64.5,3292286,62.4,113926,3.3
Iowa,2020,1,1736848,69.6,1690991,67.8,45857,2.6
Kansas,2020,1,1511079,67.3,1461735,65.1,49344,3.3
Kentucky,2020,1,2071871,58.8,1987029,56.4,84842,4.1
Louisiana,2020,1,2097121,58.5,1997143,55.7,99978,4.8
Maine,2020,1,698238,62.1,675789,60.1,22449,3.2
Maryland,2020,1,3364825,69.3,3251292,66.9,113533,3.4
Massachusetts,2020,1,3815555,66.5,3707253,64.6,108302,2.8
Michigan,2020,1,4960110,61.5,4772430,59.2,187680,3.8
Minnesota,2020,1,3131633,70.0,3024453,67.6,107180,3.4
Mississippi,2020,1,1277947,56.0,1205864,52.9,72083,5.6
Missouri,2020,1,3091396,64.1,2988797,61.9,102599,3.3
Montana,2020,1,549481,63.9,530034,61.6,19447,3.5
Nebraska,2020,1,1054980,70.3,1022742,68.2,32238,3.1
Nevada,2020,1,1569274,64.4,1502659,61.7,66615,4.2
New Hampshire,2020,1,781294,68.8,761057,67.0,20237,2.6
New Jersey,2020,1,4753250,64.5,4563931,61.9,189319,4.0
New Mexico,2020,1,960609,58.1,911204,55.1,49405,5.1
New York,2020,1,9909100,61.0,9508711,58.5,400389,4.0
New York city,2020,1,4280567,60.3,4104862,57.8,175705,4.1
North Carolina,2020,1,5020586,61.4,4830887,59.0,189699,3.8
North Dakota,2020,1,411668,69.3,403150,67.8,8518,2.1
Ohio,2020,1,5926598,63.6,5663883,60.8,262715,4.4
Oklahoma,2020,1,1840004,60.8,1782431,58.9,57573,3.1
Oregon,2020,1,2091853,61.1,2019333,59.0,72520,3.5
Pennsylvania,2020,1,6574603,63.1,6275927,60.2,298676,4.5
Rhode Island,2020,1,576723,64.5,556008,62.2,20715,3.6
South Carolina,2020,1,2327774,57.7,2262788,56.1,64986,2.8
South Dakota,2020,1,465201,69.1,453124,67.3,12077,2.6
Tennessee,2020,1,3343516,61.6,3227352,59.4,116164,3.5
Texas,2020,1,14064669,64.0,13572739,61.8,491930,3.5
Utah,2020,1,1637058,68.4,1596928,66.7,40130,2.5
Vermont,2020,1,352193,66.0,344899,64.6,7294,2.1
Virginia,2020,1,4435880,65.7,4310258,63.9,125622,2.8
Washington,2020,1,3975766,65.4,3826405,63.0,149361,3.8
West Virginia,2020,1,798553,55.1,756806,52.2,41747,5.2
Wisconsin,2020,1,3098300,66.1,3002763,64.1,95537,3.1
Wyoming,2020,1,295103,65.7,282027,62.8,13076,4.4
Alabama,2020,2,2263536,57.3,2189357,55.4,74179,3.3
Alaska,2020,2,352509,64.7,333315,61.2,19194,5.4
Arizona,2020,2,3475147,61.9,3307090,59.0,168057,4.8
Arkansas,2020,2,1353366,57.9,1305298,55.8,48068,3.6
California,2020,2,19600700,63.0,18739937,60.3,860763,4.4
Los Angeles County,2020,2,5254129,65.3,4985099,61.9,269030,5.1
Colorado,2020,2,3134966,68.8,3035949,66.6,99017,3.2
Connecticut,2020,2,1937926,66.5,1863172,63.9,74754,3.9
Delaware,2020,2,480824,60.9,463272,58.7,17552,3.7
District of Columbia,2020,2,401557,71.2,378857,67.2,22700,5.7
Florida,2020,2,10355357,59.5,10047103,57.7,308254,3.0
Georgia,2020,2,5200327,62.9,5012344,60.6,187983,3.6
Hawaii,2020,2,688418,61.2,673337,59.9,15081,2.2
Idaho,2020,2,900434,64.1,875315,62.3,25119,2.8
Illinois,2020,2,6505487,64.3,6255066,61.8,250421,3.8
Indiana,2020,2,3395560,64.3,3280551,62.1,115009,3.4
Iowa,2020,2,1726959,69.2,1681760,67.4,45199,2.6
Kansas,2020,2,1507455,67.1,1458276,64.9,49179,3.3
Kentucky,2020,2,2064321,58.6,1978980,56.2,85341,4.1
Louisiana,2020,2,2088182,58.3,1990004,55.5,98178,4.7
Maine,2020,2,695507,61.8,673167,59.9,22340,3.2
Maryland,2020,2,3364687,69.2,3247302,66.8,117385,3.5
Massachusetts,2020,2,3793932,66.1,3687342,64.2,106590,2.8
Michigan,2020,2,4940523,61.3,4753232,59.0,187291,3.8
Minnesota,2020,2,3128603,69.9,3018477,67.5,110126,3.5
Mississippi,2020,2,1275096,55.9,1201565,52.7,73531,5.8
Missouri,2020,2,3087875,64.0,2983721,61.8,104154,3.4
Montana,2020,2,548362,63.7,529066,61.4,19296,3.5
Nebraska,2020,2,1052084,70.1,1020296,68.0,31788,3.0
Nevada,2020,2,1567999,64.3,1499482,61.5,68517,4.4
New Hampshire,2020,2,777768,68.5,757610,66.7,20158,2.6
New Jersey,2020,2,4745496,64.3,4553129,61.7,192367,4.1
New Mexico,2020,2,959276,58.0,908745,55.0,50531,5.3
New York,2020,2,9888746,60.9,9482072,58.4,406674,4.1
New York city,2020,2,4276190,60.2,4093110,57.7,183080,4.3
North Carolina,2020,2,5015309,61.2,4824639,58.9,190670,3.8
North Dakota,2020,2,410920,69.1,401870,67.6,9050,2.2
Ohio,2020,2,5917612,63.5,5647645,60.6,269967,4.6
Oklahoma,2020,2,1835566,60.6,1777580,58.7,57986,3.2
Oregon,2020,2,2088774,61.0,2013968,58.8,74806,3.6
Pennsylvania,2020,2,6558396,62.9,6249855,59.9,308541,4.7
Rhode Island,2020,2,574293,64.2,553279,61.8,21014,3.7
South Carolina,2020,2,2322982,57.5,2254742,55.8,68240,2.9
South Dakota,2020,2,463763,68.9,452047,67.1,11716,2.5
Tennessee,2020,2,3333416,61.3,3217481,59.2,115935,3.5
Texas,2020,2,14044023,63.8,13544117,61.6,499906,3.6
Utah,2020,2,1635501,68.2,1595056,66.5,40445,2.5
Vermont,2020,2,351542,65.8,343765,64.4,7777,2.2
Virginia,2020,2,4431692,65.7,4301256,63.7,130436,2.9
Washington,2020,2,3975448,65.4,3823597,62.9,151851,3.8
West Virginia,2020,2,796737,55.0,754670,52.1,42067,5.3
Wisconsin,2020,2,3088456,65.9,2995950,63.9,92506,3.0
Wyoming,2020,2,294899,65.7,281045,62.6,13854,4.7
Alabama,2020,3,2257190,57.1,2181563,55.2,75627,3.4
Alaska,2020,3,351776,64.6,332470,61.1,19306,5.5
Arizona,2020,3,3471496,61.8,3300867,58.7,170629,4.9
Arkansas,2020,3,1370421,58.6,1303311,55.7,67110,4.9
California,2020,3,19279024,62.0,18214858,58.6,1064166,5.5
Los Angeles County,2020,3,4996994,62.1,4688915,58.3,308079,6.2
Colorado,2020,3,3131873,68.6,3028141,66.4,103732,3.3
Connecticut,2020,3,1931567,66.2,1856382,63.7,75185,3.9
Delaware,2020,3,486281,61.5,461818,58.4,24463,5.0
District of Columbia,2020,3,402059,71.3,379017,67.2,23042,5.7
Florida,2020,3,10185817,58.4,9779208,56.1,406609,4.0
Georgia,2020,3,5195902,62.8,5004093,60.5,191809,3.7
Hawaii,2020,3,687050,61.1,672197,59.8,14853,2.2
Idaho,2020,3,898624,63.8,874283,62.1,24341,2.7
Illinois,2020,3,6453631,63.8,6128533,60.6,325098,5.0
Indiana,2020,3,3316930,62.8,3201982,60.6,114948,3.5
Iowa,2020,3,1716150,68.8,1671967,67.0,44183,2.6
Kansas,2020,3,1502714,66.9,1454455,64.7,48259,3.2
Kentucky,2020,3,2055235,58.3,1970322,55.9,84913,4.1
Louisiana,2020,3,2127433,59.4,1985884,55.4,141549,6.7
Maine,2020,3,692447,61.5,670338,59.6,22109,3.2
Maryland,2020,3,3362070,69.2,3243118,66.7,118952,3.5
Massachusetts,2020,3,3767296,65.6,3663226,63.8,104070,2.8
Michigan,2020,3,4914397,61.0,4730654,58.7,183743,3.7
Minnesota,2020,3,3121760,69.8,3009157,67.3,112603,3.6
Mississippi,2020,3,1272954,55.8,1198039,52.6,74915,5.9
Missouri,2020,3,3087475,64.0,2978541,61.7,108934,3.5
Montana,2020,3,546745,63.4,527842,61.2,18903,3.5
Nebraska,2020,3,1057331,70.4,1011018,67.4,46313,4.4
Nevada,2020,3,1541337,63.1,1429679,58.5,111658,7.2
New Hampshire,2020,3,773772,68.1,753809,66.3,19963,2.6
New Jersey,2020,3,4731203,64.1,4538549,61.5,192654,4.1
New Mexico,2020,3,947047,57.2,892283,53.9,54764,5.8
New York,2020,3,9857996,60.7,9446108,58.2,411888,4.2
New York city,2020,3,4269813,60.2,4079042,57.5,190771,4.5
North Carolina,2020,3,4794704,58.5,4604557,56.2,190147,4.0
North Dakota,2020,3,410875,69.1,400840,67.4,10035,2.4
Ohio,2020,3,5836200,62.6,5559433,59.7,276767,4.7
Oklahoma,2020,3,1832151,60.5,1773343,58.5,58808,3.2
Oregon,2020,3,2085592,60.9,2008419,58.6,77173,3.7
Pennsylvania,2020,3,6544736,62.8,6221656,59.7,323080,4.9
Rhode Island,2020,3,570496,63.7,549728,61.4,20768,3.6
South Carolina,2020,3,2316819,57.3,2245791,55.6,71028,3.1
South Dakota,2020,3,462536,68.7,451294,67.0,11242,2.4
Tennessee,2020,3,3322132,61.1,3204962,58.9,117170,3.5
Texas,2020,3,13886742,63.0,13192514,59.9,694228,5.0
Utah,2020,3,1633126,68.0,1592671,66.3,40455,2.5
Vermont,2020,3,351214,65.8,342469,64.1,8745,2.5
Virginia,2020,3,4435006,65.7,4293314,63.6,141692,3.2
Washington,2020,3,3959292,65.0,3752772,61.6,206520,5.2
West Virginia,2020,3,794006,54.8,751985,51.9,42021,5.3
Wisconsin,2020,3,3077856,65.6,2989234,63.8,88622,2.9
Wyoming,2020,3,294534,65.6,279961,62.3,14573,4.9
Alabama,2020,4,2197212,55.5,1894333,47.8,302879,13.8
Alaska,2020,4,337740,62.0,297837,54.7,39903,11.8
Arizona,2020,4,3392569,60.2,2924473,51.9,468096,13.8
Arkansas,2020,4,1354929,57.8,1217892,52.0,137037,10.1
California,2020,4,18734307,60.0,15715696,50.3,3018611,16.1
Los Angeles County,2020,4,4800114,59.4,3964435,49.1,835679,17.4
Colorado,2020,4,3010172,65.7,2674983,58.4,335189,11.1
Connecticut,2020,4,1837410,63.1,1686681,57.9,150729,8.2
Delaware,2020,4,471552,59.4,410044,51.6,61508,13.0
District of Columbia,2020,4,391969,69.3,348069,61.5,43900,11.2
Florida,2020,4,9419108,53.9,8168575,46.8,1250533,13.3
Georgia,2020,4,4961228,59.8,4347117,52.4,614111,12.4
Hawaii,2020,4,648464,57.5,502109,44.5,146355,22.6
Idaho,2020,4,886924,62.7,783130,55.3,103794,11.7
Illinois,2020,4,6266872,61.8,5137718,50.6,1129154,18.0
Indiana,2020,4,3234173,61.1,2691549,50.8,542624,16.8
Iowa,2020,4,1691996,67.7,1508098,60.4,183898,10.9
Kansas,2020,4,1496966,66.5,1311273,58.2,185693,12.4
Kentucky,2020,4,2050779,58.1,1707751,48.4,343028,16.7
Louisiana,2020,4,1995747,55.5,1726753,48.0,268994,13.5
Maine,2020,4,654428,58.1,593707,52.7,60721,9.3
Maryland,2020,4,3210541,65.9,2921072,59.9,289469,9.0
Massachusetts,2020,4,3476035,60.4,2889467,50.2,586568,16.9
Michigan,2020,4,4568963,56.6,3537612,43.8,1031351,22.6
Minnesota,2020,4,3035053,67.7,2767200,61.7,267853,8.8
Mississippi,2020,4,1208977,53.0,1020894,44.7,188083,15.6
Missouri,2020,4,2935721,60.7,2600695,53.8,335026,11.4
Montana,2020,4,539358,62.5,474993,55.0,64365,11.9
Nebraska,2020,4,1048044,69.7,963257,64.0,84787,8.1
Nevada,2020,4,1471006,60.0,1020828,41.6,450178,30.6
New Hampshire,2020,4,747950,65.7,628133,55.1,119817,16.0
New Jersey,2020,4,4486453,60.6,3817083,51.5,669370,14.9
New Mexico,2020,4,902428,54.3,820897,49.4,81531,9.0
New York,2020,4,9140152,56.1,7711204,47.3,1428948,15.6
New York city,2020,4,3720286,52.2,3248594,45.6,471692,12.7
North Carolina,2020,4,4635833,56.5,3979213,48.5,656620,14.2
North Dakota,2020,4,411084,69.1,375275,63.1,35809,8.7
Ohio,2020,4,5557283,59.5,4646478,49.7,910805,16.4
Oklahoma,2020,4,1809858,59.7,1583753,52.2,226105,12.5
Oregon,2020,4,2042159,59.4,1761686,51.3,280473,13.7
Pennsylvania,2020,4,6369649,60.9,5339307,51.0,1030342,16.2
Rhode Island,2020,4,547167,61.0,448613,50.0,98554,18.0
South Carolina,2020,4,2317899,57.2,2046298,50.5,271601,11.7
South Dakota,2020,4,462800,68.6,422147,62.6,40653,8.8
Tennessee,2020,4,3203528,58.7,2698710,49.4,504818,15.8
Texas,2020,4,13317744,60.3,11617489,52.6,1700255,12.8
Utah,2020,4,1629752,67.4,1467247,60.7,162505,10.0
Vermont,2020,4,353034,66.0,303528,56.7,49506,14.0
Virginia,2020,4,4323875,63.9,3806812,56.3,517063,12.0
Washington,2020,4,4048654,66.2,3377478,55.3,671176,16.6
West Virginia,2020,4,762225,52.7,642446,44.4,119779,15.7
Wisconsin,2020,4,3082790,65.5,2649524,56.3,433266,14.1
Wyoming,2020,4,288459,64.1,273355,60.8,15104,5.2
Alabama,2020,5,2274762,57.4,2038561,51.5,236201,10.4
Alaska,2020,5,345853,63.5,304530,55.9,41323,11.9
Arizona,2020,5,3444165,61.0,3060008,54.2,384157,11.2
Arkansas,2020,5,1349087,57.6,1229469,52.5,119618,8.9
California,2020,5,18569197,59.5,15646706,50.1,2922491,15.7
Los Angeles County,2020,5,4738468,58.8,3845416,47.7,893052,18.8
Colorado,2020,5,3105334,67.7,2744531,59.9,360803,11.6
Connecticut,2020,5,1911162,65.7,1687056,58.0,224106,11.7
Delaware,2020,5,495546,62.4,429058,54.0,66488,13.4
District of Columbia,2020,5,380232,67.9,346946,62.0,33286,8.8
Florida,2020,5,10138960,58.0,8704588,49.8,1434372,14.1
Georgia,2020,5,5067568,61.1,4575498,55.1,492070,9.7
Hawaii,2020,5,664576,59.0,526353,46.7,138223,20.8
Idaho,2020,5,897876,63.3,816989,57.6,80887,9.0
Illinois,2020,5,6315556,62.3,5388506,53.1,927050,14.7
Indiana,2020,5,3307922,62.4,2897837,54.7,410085,12.4
Iowa,2020,5,1659218,66.4,1522041,60.9,137177,8.3
Kansas,2020,5,1501689,66.6,1362384,60.5,139305,9.3
Kentucky,2020,5,2063063,58.5,1798634,51.0,264429,12.8
Louisiana,2020,5,2032169,56.5,1783841,49.6,248328,12.2
Maine,2020,5,670902,59.6,607630,53.9,63272,9.4
Maryland,2020,5,3213263,65.9,2929783,60.1,283480,8.8
Massachusetts,2020,5,3726748,64.9,3149808,54.8,576940,15.5
Michigan,2020,5,4888407,60.6,3953619,49.0,934788,19.1
Minnesota,2020,5,3106169,69.2,2762590,61.6,343579,11.1
Mississippi,2020,5,1221715,53.5,1085227,47.5,136488,11.2
Missouri,2020,5,2880490,59.6,2607814,53.9,272676,9.5
Montana,2020,5,543992,62.9,493917,57.1,50075,9.2
Nebraska,2020,5,1048323,69.7,982187,65.3,66136,6.3
Nevada,2020,5,1389146,56.6,1046210,42.6,342936,24.7
New Hampshire,2020,5,760856,66.8,671558,58.9,89298,11.7
New Jersey,2020,5,4590276,62.0,3885849,52.5,704427,15.3
New Mexico,2020,5,913262,54.9,828683,49.8,84579,9.3
New York,2020,5,9434270,58.0,7864597,48.3,1569673,16.6
New York city,2020,5,3937341,55.4,3093828,43.5,843513,21.4
North Carolina,2020,5,4771625,58.1,4219979,51.4,551646,11.6
North Dakota,2020,5,408145,68.6,378775,63.6,29370,7.2
Ohio,2020,5,5675145,60.8,4951605,53.0,723540,12.7
Oklahoma,2020,5,1831742,60.4,1653490,54.5,178252,9.7
Oregon,2020,5,2100473,61.1,1852579,53.9,247894,11.8
Pennsylvania,2020,5,6479924,61.9,5642398,53.9,837526,12.9
Rhode Island,2020,5,571680,63.7,483857,54.0,87823,15.4
South Carolina,2020,5,2329579,57.4,2114319,52.1,215260,9.2
South Dakota,2020,5,463556,68.7,432964,64.2,30592,6.6
Tennessee,2020,5,3267657,59.8,2872078,52.6,395579,12.1
Texas,2020,5,13868197,62.7,12254153,55.4,1614044,11.6
Utah,2020,5,1640390,67.8,1514093,62.6,126297,7.7
Vermont,2020,5,339774,63.5,307409,57.4,32365,9.5
Virginia,2020,5,4299215,63.5,3870146,57.2,429069,10.0
Washington,2020,5,3982220,65.1,3457466,56.5,524754,13.2
West Virginia,2020,5,775679,53.6,679637,47.0,96042,12.4
Wisconsin,2020,5,3097053,65.8,2772923,58.9,324130,10.5
Wyoming,2020,5,299132,66.5,273106,60.7,26026,8.7
Alabama,2020,6,2276502,57.4,2081263,52.5,195239,8.6
Alaska,2020,6,347269,63.8,307579,56.5,39690,11.4
Arizona,2020,6,3445264,61.0,3109605,55.0,335659,9.7
Arkansas,2020,6,1343602,57.3,1237706,52.8,105896,7.9
California,2020,6,19050812,61.0,16424668,52.6,2626144,13.8
Los Angeles County,2020,6,4956578,61.6,4083519,50.7,873059,17.6
Colorado,2020,6,3125586,68.1,2776808,60.5,348778,11.2
Connecticut,2020,6,1904308,65.5,1686345,58.0,217963,11.4
Delaware,2020,6,500905,63.0,436741,54.9,64164,12.8
District of Columbia,2020,6,378708,68.4,346291,62.6,32417,8.6
Florida,2020,6,10053598,57.4,8872185,50.7,1181413,11.8
Georgia,2020,6,5003221,60.2,4584799,55.2,418422,8.4
Hawaii,2020,6,663336,58.9,547545,48.7,115791,17.5
Idaho,2020,6,897008,63.1,829959,58.4,67049,7.5
Illinois,2020,6,6288865,62.1,5488334,54.2,800531,12.7
Indiana,2020,6,3314501,62.5,2973961,56.1,340540,10.3
Iowa,2020,6,1639140,65.6,1529956,61.2,109184,6.7
Kansas,2020,6,1492645,66.2,1381135,61.3,111510,7.5
Kentucky,2020,6,1931603,54.7,1830109,51.8,101494,5.3
Louisiana,2020,6,2037453,56.7,1813748,50.5,223705,11.0
Maine,2020,6,656415,58.2,613304,54.4,43111,6.6
Maryland,2020,6,3195743,65.6,2938058,60.3,257685,8.1
Massachusetts,2020,6,3773836,65.8,3230811,56.3,543025,14.4
Michigan,2020,6,5015040,62.1,4290779,53.2,724261,14.4
Minnesota,2020,6,3232180,72.0,2953016,65.8,279164,8.6
Mississippi,2020,6,1223105,53.6,1108177,48.6,114928,9.4
Missouri,2020,6,2978306,61.5,2741260,56.6,237046,8.0
Montana,2020,6,542535,62.7,501089,57.9,41446,7.6
Nebraska,2020,6,1044037,69.3,989776,65.7,54261,5.2
Nevada,2020,6,1497493,60.9,1215366,49.4,282127,18.8
New Hampshire,2020,6,758604,66.5,685970,60.2,72634,9.6
New Jersey,2020,6,4645951,62.8,3976612,53.7,669339,14.4
New Mexico,2020,6,915184,55.0,832754,50.1,82430,9.0
New York,2020,6,9525690,58.6,8235435,50.7,1290255,13.5
New York city,2020,6,4061283,57.3,3365560,47.5,695723,17.1
North Carolina,2020,6,4773330,58.1,4310991,52.5,462339,9.7
North Dakota,2020,6,407284,68.4,381308,64.0,25976,6.4
Ohio,2020,6,5679799,60.8,5053510,54.1,626289,11.0
Oklahoma,2020,6,1831890,60.3,1681183,55.4,150707,8.2
Oregon,2020,6,2101211,61.1,1887874,54.9,213337,10.2
Pennsylvania,2020,6,6480046,62.0,5744837,54.9,735209,11.3
Rhode Island,2020,6,571780,63.7,495567,55.3,76213,13.3
South Carolina,2020,6,2322595,57.2,2140780,52.7,181815,7.8
South Dakota,2020,6,461729,68.4,437146,64.8,24583,5.3
Tennessee,2020,6,3262076,59.7,2931348,53.6,330728,10.1
Texas,2020,6,13871747,62.6,12471138,56.3,1400609,10.1
Utah,2020,6,1638684,67.6,1533370,63.2,105314,6.4
Vermont,2020,6,335423,62.7,309198,57.8,26225,7.8
Virginia,2020,6,4289651,63.4,3909852,57.8,379799,8.9
Washington,2020,6,3935183,64.3,3489700,57.0,445483,11.3
West Virginia,2020,6,772832,53.5,691613,47.8,81219,10.5
Wisconsin,2020,6,3086743,65.6,2818825,59.9,267918,8.7
Wyoming,2020,6,295094,65.5,273390,60.7,21704,7.4
Alabama,2020,7,2287141,57.6,2115495,53.3,171646,7.5
Alaska,2020,7,351053,64.4,311229,57.1,39824,11.3
Arizona,2020,7,3466802,61.2,3156864,55.7,309938,8.9
Arkansas,2020,7,1345815,57.3,1247571,53.2,98244,7.3
California,2020,7,19086844,61.1,16573188,53.1,2513656,13.2
Los Angeles County,2020,7,5052937,62.8,4153853,51.7,899084,17.8
Colorado,2020,7,3008280,65.5,2814286,61.2,193994,6.4
Connecticut,2020,7,1912511,65.8,1690355,58.1,222156,11.6
Delaware,2020,7,480446,60.4,444327,55.8,36119,7.5
District of Columbia,2020,7,379624,69.3,346885,63.4,32739,8.6
Florida,2020,7,10245328,58.5,9036419,51.6,1208909,11.8
Georgia,2020,7,4989547,60.0,4607520,55.4,382027,7.7
Hawaii,2020,7,672658,59.8,567057,50.4,105601,15.7
Idaho,2020,7,901438,63.2,842379,59.1,59059,6.6
Illinois,2020,7,6318926,62.4,5591846,55.2,727080,11.5
Indiana,2020,7,3344019,63.1,3046011,57.4,298008,8.9
Iowa,2020,7,1640297,65.6,1543550,61.7,96747,5.9
Kansas,2020,7,1498159,66.4,1399039,62.0,99120,6.6
Kentucky,2020,7,1972535,55.9,1858849,52.6,113686,5.8
Louisiana,2020,7,2058038,57.3,1845482,51.3,212556,10.3
Maine,2020,7,662143,58.7,620423,55.0,41720,6.3
Maryland,2020,7,3204457,65.7,2954800,60.6,249657,7.8
Massachusetts,2020,7,3785367,66.1,3305506,57.7,479861,12.7
Michigan,2020,7,4953956,61.4,4337346,53.7,616610,12.4
Minnesota,2020,7,3205761,71.4,2956335,65.8,249426,7.8
Mississippi,2020,7,1232815,54.0,1130134,49.5,102681,8.3
Missouri,2020,7,3087321,63.8,2866362,59.2,220959,7.2
Montana,2020,7,544609,62.9,507997,58.6,36612,6.7
Nebraska,2020,7,1045498,69.4,997508,66.2,47990,4.6
Nevada,2020,7,1509346,61.3,1258476,51.1,250870,16.6
New Hampshire,2020,7,762018,66.8,699269,61.3,62749,8.2
New Jersey,2020,7,4747442,64.2,4064793,55.0,682649,14.4
New Mexico,2020,7,922253,55.4,839318,50.4,82935,9.0
New York,2020,7,9566448,59.0,8371925,51.6,1194523,12.5
New York city,2020,7,4084589,57.8,3411805,48.3,672784,16.5
North Carolina,2020,7,4813793,58.6,4398921,53.5,414872,8.6
North Dakota,2020,7,409237,68.7,384428,64.6,24809,6.1
Ohio,2020,7,5720005,61.2,5154558,55.2,565447,9.9
Oklahoma,2020,7,1843200,60.6,1707089,56.2,136111,7.4
Oregon,2020,7,2116997,61.4,1921869,55.8,195128,9.2
Pennsylvania,2020,7,6522306,62.4,5837934,55.8,684372,10.5
Rhode Island,2020,7,575969,64.2,506340,56.4,69629,12.1
South Carolina,2020,7,2334328,57.4,2168435,53.3,165893,7.1
South Dakota,2020,7,463523,68.6,441611,65.4,21912,4.7
Tennessee,2020,7,3284367,60.0,2989704,54.6,294663,9.0
Texas,2020,7,13972720,62.9,12676263,57.1,1296457,9.3
Utah,2020,7,1647030,67.8,1552744,63.9,94286,5.7
Vermont,2020,7,334359,62.4,311911,58.3,22448,6.7
Virginia,2020,7,4316158,63.7,3960823,58.5,355335,8.2
Washington,2020,7,3926251,64.0,3526334,57.5,399917,10.2
West Virginia,2020,7,775973,53.7,702689,48.6,73284,9.4
Wisconsin,2020,7,3097559,65.8,2861968,60.8,235591,7.6
Wyoming,2020,7,294469,65.3,274275,60.8,20194,6.9
Alabama,2020,8,2284261,57.5,2139397,53.9,144864,6.3
Alaska,2020,8,340587,62.5,314551,57.7,26036,7.6
Arizona,2020,8,3472159,61.2,3195661,56.3,276498,8.0
Arkansas,2020,8,1340966,57.1,1255201,53.5,85765,6.4
California,2020,8,18943393,60.7,16690488,53.5,2252905,11.9
Los Angeles County,2020,8,5063189,63.0,4208026,52.4,855163,16.9
Colorado,2020,8,3033867,66.0,2845904,61.9,187963,6.2
Connecticut,2020,8,1871192,64.3,1692382,58.1,178810,9.6
Delaware,2020,8,486497,61.0,450669,56.5,35828,7.4
District of Columbia,2020,8,379500,69.3,347532,63.5,31968,8.4
Florida,2020,8,10062378,57.3,9169747,52.3,892631,8.9
Georgia,2020,8,4961306,59.6,4624993,55.6,336313,6.8
Hawaii,2020,8,670396,59.6,582177,51.8,88219,13.2
Idaho,2020,8,901794,63.1,852733,59.7,49061,5.4
Illinois,2020,8,6288657,62.1,5669653,56.0,619004,9.8
Indiana,2020,8,3346288,63.1,3103740,58.5,242548,7.2
Iowa,2020,8,1640607,65.6,1557213,62.3,83394,5.1
Kansas,2020,8,1499455,66.5,1413802,62.7,85653,5.7
Kentucky,2020,8,1982758,56.1,1879633,53.2,103125,5.2
Louisiana,2020,8,2058269,57.3,1870435,52.1,187834,9.1
Maine,2020,8,654156,57.9,626773,55.5,27383,4.2
Maryland,2020,8,3194467,65.5,2966070,60.8,228397,7.1
Massachusetts,2020,8,3760914,65.6,3363172,58.7,397742,10.6
Michigan,2020,8,4879029,60.4,4398167,54.5,480862,9.9
Minnesota,2020,8,3174473,70.7,2960150,65.9,214323,6.8
Mississippi,2020,8,1238133,54.2,1145687,50.2,92446,7.5
Missouri,2020,8,3074748,63.5,2876654,59.4,198094,6.4
Montana,2020,8,544363,62.7,513561,59.2,30802,5.7
Nebraska,2020,8,1045249,69.4,1004069,66.6,41180,3.9
Nevada,2020,8,1499486,60.8,1290350,52.3,209136,13.9
New Hampshire,2020,8,759986,66.6,709384,62.1,50602,6.7
New Jersey,2020,8,4768751,64.5,4135248,55.9,633503,13.3
New Mexico,2020,8,924678,55.5,845017,50.7,79661,8.6
New York,2020,8,9506207,58.6,8478569,52.3,1027638,10.8
New York city,2020,8,4047232,57.4,3448352,48.9,598880,14.8
North Carolina,2020,8,4816198,58.5,4465810,54.3,350388,7.3
North Dakota,2020,8,409814,68.8,386978,65.0,22836,5.6
Ohio,2020,8,5720031,61.2,5237607,56.1,482424,8.4
Oklahoma,2020,8,1844570,60.6,1727209,56.8,117361,6.4
Oregon,2020,8,2118354,61.4,1949821,56.6,168533,8.0
Pennsylvania,2020,8,6518262,62.3,5907954,56.5,610308,9.4
Rhode Island,2020,8,572866,63.8,514640,57.3,58226,10.2
South Carolina,2020,8,2337960,57.4,2192526,53.9,145434,6.2
South Dakota,2020,8,464204,68.6,445206,65.8,18998,4.1
Tennessee,2020,8,3290562,60.1,3038735,55.5,251827,7.7
Texas,2020,8,13972537,62.9,12843548,57.8,1128989,8.1
Utah,2020,8,1649901,67.8,1569610,64.5,80291,4.9
Vermont,2020,8,332539,62.1,314045,58.6,18494,5.6
Virginia,2020,8,4317448,63.7,4003555,59.1,313893,7.3
Washington,2020,8,3894456,63.5,3555651,58.0,338805,8.7
West Virginia,2020,8,774966,53.6,711247,49.2,63719,8.2
Wisconsin,2020,8,3090242,65.6,2896215,61.5,194027,6.3
Wyoming,2020,8,293495,65.1,275244,61.0,18251,6.2
Alabama,2020,9,2291147,57.7,2155822,54.2,135325,5.9
Alaska,2020,9,343836,63.1,317723,58.3,26113,7.6
Arizona,2020,9,3491963,61.5,3227770,56.8,264193,7.6
Arkansas,2020,9,1341849,57.1,1261375,53.7,80474,6.0
California,2020,9,18687818,59.9,16820909,53.9,1866909,10.0
Los Angeles County,2020,9,4797737,59.8,4264717,53.2,533020,11.1
Colorado,2020,9,3068712,66.7,2874030,62.4,194682,6.3
Connecticut,2020,9,1859323,63.8,1695666,58.2,163657,8.8
Delaware,2020,9,493097,61.8,455749,57.1,37348,7.6
District of Columbia,2020,9,380274,69.5,348264,63.6,32010,8.4
Florida,2020,9,10110087,57.5,9288710,52.9,821377,8.1
Georgia,2020,9,4957808,59.5,4643127,55.7,314681,6.3
Hawaii,2020,9,620674,55.2,537055,47.7,83619,13.5
Idaho,2020,9,906393,63.2,861401,60.1,44992,5.0
Illinois,2020,9,6314096,62.4,5737579,56.7,576517,9.1
Indiana,2020,9,3368461,63.4,3150234,59.3,218227,6.5
Iowa,2020,9,1649235,65.9,1570921,62.8,78314,4.7
Kansas,2020,9,1505260,66.7,1425583,63.2,79677,5.3
Kentucky,2020,9,1996248,56.5,1895562,53.7,100686,5.0
Louisiana,2020,9,2071008,57.6,1890833,52.6,180175,8.7
Maine,2020,9,659947,58.4,633107,56.0,26840,4.1
Maryland,2020,9,3202111,65.7,2976517,61.0,225594,7.0
Massachusetts,2020,9,3787541,66.1,3410540,59.5,377001,10.0
Michigan,2020,9,4866153,60.3,4440420,55.0,425733,8.7
Minnesota,2020,9,3155756,70.2,2960112,65.9,195644,6.2
Mississippi,2020,9,1248018,54.7,1158965,50.8,89053,7.1
Missouri,2020,9,3069925,63.4,2886145,59.6,183780,6.0
Montana,2020,9,546258,62.8,517783,59.5,28475,5.2
Nebraska,2020,9,1046658,69.4,1008990,66.9,37668,3.6
Nevada,2020,9,1510535,61.2,1317662,53.3,192873,12.8
New Hampshire,2020,9,763363,66.8,717357,62.8,46006,6.0
New Jersey,2020,9,4532467,61.2,4196699,56.7,335768,7.4
New Mexico,2020,9,931457,55.9,850398,51.0,81059,8.7
New York,2020,9,9539035,58.9,8571168,52.9,967867,10.1
New York city,2020,9,4067842,57.9,3486351,49.6,581491,14.3
North Carolina,2020,9,4843023,58.8,4520209,54.8,322814,6.7
North Dakota,2020,9,410559,68.9,388907,65.3,21652,5.3
Ohio,2020,9,5751167,61.6,5308133,56.8,443034,7.7
Oklahoma,2020,9,1853475,60.9,1742520,57.2,110955,6.0
Oregon,2020,9,2131681,61.8,1971569,57.2,160112,7.5
Pennsylvania,2020,9,6536898,62.4,5959347,56.9,577551,8.8
Rhode Island,2020,9,577508,64.3,521326,58.1,56182,9.7
South Carolina,2020,9,2348476,57.6,2212299,54.3,136177,5.8
South Dakota,2020,9,465893,68.8,448197,66.2,17696,3.8
Tennessee,2020,9,3319704,60.5,3082636,56.2,237068,7.1
Texas,2020,9,14064583,63.2,12982569,58.3,1082014,7.7
Utah,2020,9,1658936,68.0,1583895,64.9,75041,4.5
Vermont,2020,9,332535,62.0,316045,58.9,16490,5.0
Virginia,2020,9,4327423,63.8,4041654,59.6,285769,6.6
Washington,2020,9,3894992,63.5,3582957,58.4,312035,8.0
West Virginia,2020,9,776931,53.8,717974,49.7,58957,7.6
Wisconsin,2020,9,3101745,65.8,2923474,62.0,178271,5.7
Wyoming,2020,9,293324,65.0,276031,61.1,17293,5.9
Alabama,2020,10,2284097,57.4,2164082,54.4,120015,5.3
Alaska,2020,10,345210,63.3,320002,58.7,25208,7.3
Arizona,2020,10,3496257,61.5,3249938,57.1,246319,7.0
Arkansas,2020,10,1337477,56.9,1264320,53.8,73157,5.5
California,2020,10,18641650,59.7,16903156,54.2,1738494,9.3
Los Angeles County,2020,10,4825581,60.2,4302069,53.7,523512,10.8
Colorado,2020,10,3084269,66.9,2892718,62.8,191551,6.2
Connecticut,2020,10,1839340,63.0,1694777,58.1,144563,7.9
Delaware,2020,10,483998,60.5,459010,57.4,24988,5.2
District of Columbia,2020,10,378974,69.2,348234,63.6,30740,8.1
Florida,2020,10,10097014,57.4,9375745,53.3,721269,7.1
Georgia,2020,10,5204807,62.4,4916541,59.0,288266,5.5
Hawaii,2020,10,641644,57.0,568155,50.5,73489,11.5
Idaho,2020,10,907628,63.1,867473,60.3,40155,4.4
Illinois,2020,10,6297303,62.2,5778297,57.1,519006,8.2
Indiana,2020,10,3368775,63.4,3179289,59.8,189486,5.6
Iowa,2020,10,1653675,66.0,1581343,63.2,72332,4.4
Kansas,2020,10,1505209,66.7,1433411,63.5,71798,4.8
Kentucky,2020,10,2001321,56.6,1904310,53.9,97011,4.8
Louisiana,2020,10,2067666,57.6,1903175,53.0,164491,8.0
Maine,2020,10,663389,58.6,637880,56.3,25509,3.8
Maryland,2020,10,3191594,65.4,2978137,61.0,213457,6.7
Massachusetts,2020,10,3768069,65.7,3440360,60.0,327709,8.7
Michigan,2020,10,4822558,59.7,4458887,55.2,363671,7.5
Minnesota,2020,10,3125509,69.5,2953373,65.7,172136,5.5
Mississippi,2020,10,1252420,54.9,1166615,51.1,85805,6.9
Missouri,2020,10,3058168,63.1,2891763,59.6,166405,5.4
Montana,2020,10,545622,62.6,520206,59.7,25416,4.7
Nebraska,2020,10,1045918,69.3,1011756,67.1,34162,3.3
Nevada,2020,10,1505280,60.9,1336719,54.0,168561,11.2
New Hampshire,2020,10,761694,66.6,722080,63.1,39614,5.2
New Jersey,2020,10,4563271,61.6,4239295,57.3,323976,7.1
New Mexico,2020,10,932170,55.9,853551,51.2,78619,8.4
New York,2020,10,9505536,58.7,8628753,53.3,876783,9.2
New York city,2020,10,4045350,57.7,3511295,50.1,534055,13.2
North Carolina,2020,10,4844441,58.7,4553291,55.2,291150,6.0
North Dakota,2020,10,409751,68.8,389848,65.4,19903,4.9
Ohio,2020,10,5749387,61.5,5352186,57.3,397201,6.9
Oklahoma,2020,10,1854784,60.9,1751997,57.5,102787,5.5
Oregon,2020,10,2131300,61.7,1984519,57.5,146781,6.9
Pennsylvania,2020,10,6524827,62.3,5987705,57.2,537122,8.2
Rhode Island,2020,10,565217,62.9,525601,58.5,39616,7.0
South Carolina,2020,10,2350061,57.6,2225375,54.5,124686,5.3
South Dakota,2020,10,466131,68.8,450082,66.4,16049,3.4
Tennessee,2020,10,3325990,60.6,3113637,56.7,212353,6.4
Texas,2020,10,14076072,63.1,13072928,58.6,1003144,7.1
Utah,2020,10,1661540,67.9,1594155,65.2,67385,4.1
Vermont,2020,10,331661,61.8,316900,59.0,14761,4.5
Virginia,2020,10,4316092,63.6,4064715,59.9,251377,5.8
Washington,2020,10,3879534,63.2,3600124,58.6,279410,7.2
West Virginia,2020,10,775973,53.7,722278,50.0,53695,6.9
Wisconsin,2020,10,3099417,65.8,2940416,62.4,159001,5.1
Wyoming,2020,10,292624,64.8,276292,61.1,16332,5.6
Alabama,2020,11,2277442,57.2,2166877,54.5,110565,4.9
Alaska,2020,11,346732,63.6,321704,59.0,25028,7.2
Arizona,2020,11,3502267,61.5,3265207,57.3,237060,6.8
Arkansas,2020,11,1335765,56.8,1265973,53.8,69792,5.2
California,2020,11,18673527,59.9,16978055,54.4,1695472,9.1
Los Angeles County,2020,11,4864150,60.8,4335721,54.2,528429,10.9
Colorado,2020,11,3099612,67.2,2905688,63.0,193924,6.3
Connecticut,2020,11,1830246,62.7,1693230,58.0,137016,7.5
Delaware,2020,11,486973,60.8,460960,57.6,26013,5.3
District of Columbia,2020,11,377606,69.0,347932,63.6,29674,7.9
Florida,2020,11,10113652,57.4,9444155,53.6,669497,6.6
Georgia,2020,11,5194761,62.2,4922469,59.0,272292,5.2
Hawaii,2020,11,653469,58.1,584029,51.9,69440,10.6
Idaho,2020,11,910053,63.1,871655,60.4,38398,4.2
Illinois,2020,11,6303835,62.3,5808104,57.4,495731,7.9
Indiana,2020,11,3372402,63.4,3195971,60.1,176431,5.2
Iowa,2020,11,1660834,66.3,1589647,63.5,71187,4.3
Kansas,2020,11,1505941,66.7,1438258,63.7,67683,4.5
Kentucky,2020,11,2004637,56.7,1908872,54.0,95765,4.8
Louisiana,2020,11,2070057,57.6,1912266,53.3,157791,7.6
Maine,2020,11,668141,58.9,641825,56.6,26316,3.9
Maryland,2020,11,3188968,65.3,2978502,61.0,210466,6.6
Massachusetts,2020,11,3765586,65.6,3458710,60.3,306876,8.1
Michigan,2020,11,4806266,59.5,4464357,55.3,341909,7.1
Minnesota,2020,11,3100321,68.9,2941355,65.4,158966,5.1
Mississippi,2020,11,1255147,55.0,1170845,51.3,84302,6.7
Missouri,2020,11,3053005,62.9,2895399,59.7,157606,5.2
Montana,2020,11,545295,62.5,521496,59.8,23799,4.4
Nebraska,2020,11,1045891,69.3,1012952,67.1,32939,3.1
Nevada,2020,11,1506305,60.8,1351062,54.6,155243,10.3
New Hampshire,2020,11,761245,66.5,724667,63.3,36578,4.8
New Jersey,2020,11,4600843,62.1,4270347,57.7,330496,7.2
New Mexico,2020,11,933930,56.0,855557,51.3,78373,8.4
New York,2020,11,9522787,58.9,8670558,53.6,852229,8.9
New York city,2020,11,4059855,58.1,3535136,50.6,524719,12.9
North Carolina,2020,11,4856357,58.8,4575803,55.4,280554,5.8
North Dakota,2020,11,409234,68.7,390345,65.5,18889,4.6
Ohio,2020,11,5752137,61.6,5375995,57.5,376142,6.5
Oklahoma,2020,11,1857532,60.9,1757990,57.6,99542,5.4
Oregon,2020,11,2133836,61.8,1991637,57.7,142199,6.7
Pennsylvania,2020,11,6520126,62.2,6001996,57.3,518130,7.9
Rhode Island,2020,11,568165,63.2,528496,58.8,39669,7.0
South Carolina,2020,11,2351556,57.5,2233232,54.7,118324,5.0
South Dakota,2020,11,466626,68.8,451322,66.5,15304,3.3
Tennessee,2020,11,3331816,60.7,3133156,57.0,198660,6.0
Texas,2020,11,14113809,63.2,13128293,58.8,985516,7.0
Utah,2020,11,1664625,67.9,1601424,65.3,63201,3.8
Vermont,2020,11,331630,61.7,317286,59.0,14344,4.3
Virginia,2020,11,4310020,63.5,4080779,60.1,229241,5.3
Washington,2020,11,3877574,63.1,3613018,58.8,264556,6.8
West Virginia,2020,11,776002,53.7,725272,50.2,50730,6.5
Wisconsin,2020,11,3102565,65.8,2950507,62.6,152058,4.9
Wyoming,2020,11,292079,64.6,276149,61.1,15930,5.5
Alabama,2020,12,2270119,57.0,2167276,54.5,102843,4.5
Alaska,2020,12,348274,63.9,322956,59.2,25318,7.3
Arizona,2020,12,3507739,61.5,3276236,57.4,231503,6.6
Arkansas,2020,12,1334865,56.7,1267096,53.8,67769,5.1
California,2020,12,18735535,60.1,17039902,54.7,1695633,9.1
Los Angeles County,2020,12,4904416,61.3,4363587,54.6,540829,11.0
Colorado,2020,12,3113441,67.5,2914795,63.2,198646,6.4
Connecticut,2020,12,1824434,62.4,1690919,57.9,133515,7.3
Delaware,2020,12,489233,61.0,461993,57.6,27240,5.6
District of Columbia,2020,12,376252,68.8,347304,63.5,28948,7.7
Florida,2020,12,10145597,57.5,9497736,53.9,647861,6.4
Georgia,2020,12,5188215,62.1,4926232,59.0,261983,5.0
Hawaii,2020,12,664749,59.1,596300,53.0,68449,10.3
Idaho,2020,12,912686,63.1,874637,60.5,38049,4.2
Illinois,2020,12,6312829,62.4,5831334,57.7,481495,7.6
Indiana,2020,12,3371215,63.4,3203228,60.2,167987,5.0
Iowa,2020,12,1666532,66.5,1595240,63.7,71292,4.3
Kansas,2020,12,1505096,66.6,1441054,63.8,64042,4.3
Kentucky,2020,12,2006542,56.8,1911759,54.1,94783,4.7
Louisiana,2020,12,2072842,57.7,1919768,53.5,153074,7.4
Maine,2020,12,673123,59.3,644853,56.8,28270,4.2
Maryland,2020,12,3190254,65.4,2977306,61.0,212948,6.7
Massachusetts,2020,12,3762478,65.6,3469086,60.4,293392,7.8
Michigan,2020,12,4718047,58.5,4387004,54.4,331043,7.0
Minnesota,2020,12,3076511,68.4,2927313,65.1,149198,4.8
Mississippi,2020,12,1256416,55.0,1173267,51.4,83149,6.6
Missouri,2020,12,3050629,62.9,2897211,59.7,153418,5.0
Montana,2020,12,545079,62.4,522261,59.7,22818,4.2
Nebraska,2020,12,1045847,69.3,1013333,67.2,32514,3.1
Nevada,2020,12,1507895,60.8,1361289,54.9,146606,9.7
New Hampshire,2020,12,760449,66.4,725848,63.4,34601,4.6
New Jersey,2020,12,4624093,62.4,4289974,57.9,334119,7.2
New Mexico,2020,12,935893,56.1,856735,51.4,79158,8.5
New York,2020,12,9526609,58.9,8697410,53.8,829199,8.7
New York city,2020,12,4065914,58.3,3554297,51.0,511617,12.6
North Carolina,2020,12,4872029,58.9,4589903,55.5,282126,5.8
North Dakota,2020,12,408758,68.6,390672,65.6,18086,4.4
Ohio,2020,12,5748142,61.5,5384791,57.6,363351,6.3
Oklahoma,2020,12,1859057,60.9,1761913,57.7,97144,5.2
Oregon,2020,12,2137476,61.9,1995697,57.8,141779,6.6
Pennsylvania,2020,12,6508921,62.1,6007799,57.3,501122,7.7
Rhode Island,2020,12,569778,63.4,530586,59.0,39192,6.9
South Carolina,2020,12,2352009,57.5,2237497,54.7,114512,4.9
South Dakota,2020,12,466781,68.7,452027,66.5,14754,3.2
Tennessee,2020,12,3332182,60.6,3142588,57.2,189594,5.7
Texas,2020,12,14142894,63.3,13162136,58.9,980758,6.9
Utah,2020,12,1667179,67.9,1606828,65.4,60351,3.6
Vermont,2020,12,332022,61.7,317422,59.0,14600,4.4
Virginia,2020,12,4309426,63.5,4090991,60.3,218435,5.1
Washington,2020,12,3880153,63.1,3622422,58.9,257731,6.6
West Virginia,2020,12,776433,53.7,727336,50.3,49097,6.3
Wisconsin,2020,12,3104550,65.9,2956180,62.7,148370,4.8
Wyoming,2020,12,291617,64.5,275785,61.0,15832,5.4
Alabama,2021,1,2261678,56.8,2167745,54.5,93933,4.2
Alaska,2021,1,348800,64.0,324035,59.4,24765,7.1
Arizona,2021,1,3510237,61.5,3286574,57.5,223663,6.4
Arkansas,2021,1,1333940,56.7,1268631,53.9,65309,4.9
California,2021,1,18730775,60.1,17096125,54.9,1634650,8.7
Los Angeles County,2021,1,4918799,61.6,4388070,55.0,530729,10.8
Colorado,2021,1,3118553,67.6,2923228,63.3,195325,6.3
Connecticut,2021,1,1816716,62.1,1688878,57.7,127838,7.0
Delaware,2021,1,490772,61.1,462744,57.6,28028,5.7
District of Columbia,2021,1,374073,68.4,346750,63.4,27323,7.3
Florida,2021,1,10146298,57.5,9548255,54.1,598043,5.9
Georgia,2021,1,5178158,62.0,4930758,59.0,247400,4.8
Hawaii,2021,1,669555,59.5,605622,53.8,63933,9.5
Idaho,2021,1,914363,63.1,877309,60.5,37054,4.1
Illinois,2021,1,6306831,62.4,5851977,57.9,454854,7.2
Indiana,2021,1,3362509,63.2,3206032,60.3,156477,4.7
Iowa,2021,1,1669558,66.6,1599849,63.8,69709,4.2
Kansas,2021,1,1501997,66.5,1443340,63.9,58657,3.9
Kentucky,2021,1,2007292,56.8,1914708,54.2,92584,4.6
Louisiana,2021,1,2072093,57.8,1926841,53.7,145252,7.0
Maine,2021,1,676829,59.6,647269,57.0,29560,4.4
Maryland,2021,1,3178999,65.1,2976494,61.0,202505,6.4
Massachusetts,2021,1,3743442,65.2,3477470,60.6,265972,7.1
Michigan,2021,1,4770719,59.1,4460627,55.3,310092,6.5
Minnesota,2021,1,3052667,67.9,2915803,64.8,136864,4.5
Mississippi,2021,1,1255936,55.0,1174439,51.5,81497,6.5
Missouri,2021,1,3048625,62.8,2899887,59.8,148738,4.9
Montana,2021,1,544748,62.2,523160,59.8,21588,4.0
Nebraska,2021,1,1045449,69.3,1013939,67.2,31510,3.0
Nevada,2021,1,1504285,60.6,1368998,55.2,135287,9.0
New Hampshire,2021,1,758709,66.2,726594,63.4,32115,4.2
New Jersey,2021,1,4639477,62.7,4303297,58.1,336180,7.2
New Mexico,2021,1,934848,56.0,857911,51.4,76937,8.2
New York,2021,1,9529706,59.0,8719038,54.0,810668,8.5
New York city,2021,1,4070174,58.5,3570953,51.3,499221,12.3
North Carolina,2021,1,4873781,58.8,4600085,55.5,273696,5.6
North Dakota,2021,1,408207,68.5,391269,65.7,16938,4.1
Ohio,2021,1,5733419,61.4,5387825,57.7,345594,6.0
Oklahoma,2021,1,1858943,60.9,1765348,57.8,93595,5.0
Oregon,2021,1,2136923,61.8,1999731,57.9,137192,6.4
Pennsylvania,2021,1,6497094,62.0,6012410,57.4,484684,7.5
Rhode Island,2021,1,569252,63.4,532511,59.3,36741,6.5
South Carolina,2021,1,2349189,57.4,2240855,54.7,108334,4.6
South Dakota,2021,1,466643,68.6,452750,66.6,13893,3.0
Tennessee,2021,1,3324322,60.5,3144458,57.2,179864,5.4
Texas,2021,1,14146900,63.2,13194031,59.0,952869,6.7
Utah,2021,1,1668327,67.8,1611870,65.5,56457,3.4
Vermont,2021,1,332596,61.8,317719,59.1,14877,4.5
Virginia,2021,1,4308509,63.5,4099663,60.4,208846,4.8
Washington,2021,1,3876921,63.1,3630780,59.1,246141,6.3
West Virginia,2021,1,775888,53.7,728990,50.5,46898,6.0
Wisconsin,2021,1,3101889,65.8,2960266,62.8,141623,4.6
Wyoming,2021,1,291140,64.3,275485,60.9,15655,5.4
Alabama,2021,2,2257848,56.7,2169569,54.5,88279,3.9
Alaska,2021,2,349792,64.2,325131,59.6,24661,7.1
Arizona,2021,2,3516451,61.5,3298198,57.7,218253,6.2
Arkansas,2021,2,1334644,56.7,1270812,54.0,63832,4.8
California,2021,2,18769981,60.3,17165377,55.1,1604604,8.5
Los Angeles County,2021,2,4941424,62.0,4415938,55.4,525486,10.6
Colorado,2021,2,3129165,67.8,2933331,63.5,195834,6.3
Connecticut,2021,2,1813938,62.0,1688035,57.7,125903,6.9
Delaware,2021,2,492425,61.3,463673,57.7,28752,5.8
District of Columbia,2021,2,373122,68.2,346690,63.4,26432,7.1
Florida,2021,2,10169604,57.6,9603143,54.4,566461,5.6
Georgia,2021,2,5174112,61.9,4937540,59.1,236572,4.6
Hawaii,2021,2,674948,60.0,613005,54.5,61943,9.2
Idaho,2021,2,916685,63.1,880157,60.6,36528,4.0
Illinois,2021,2,6315677,62.5,5873382,58.2,442295,7.0
Indiana,2021,2,3360683,63.2,3209198,60.3,151485,4.5
Iowa,2021,2,1673892,66.8,1604351,64.0,69541,4.2
Kansas,2021,2,1500995,66.5,1445630,64.0,55365,3.7
Kentucky,2021,2,2010297,56.9,1919009,54.3,91288,4.5
Louisiana,2021,2,2073956,57.8,1933367,53.9,140589,6.8
Maine,2021,2,680821,59.9,649453,57.2,31368,4.6
Maryland,2021,2,3172878,65.0,2977470,61.0,195408,6.2
Massachusetts,2021,2,3739265,65.2,3487618,60.8,251647,6.7
Michigan,2021,2,4763640,59.1,4460982,55.3,302658,6.4
Minnesota,2021,2,3038854,67.6,2909371,64.7,129483,4.3
Mississippi,2021,2,1256059,55.1,1176182,51.6,79877,6.4
Missouri,2021,2,3049931,62.8,2903574,59.8,146357,4.8
Montana,2021,2,545476,62.2,524507,59.8,20969,3.8
Nebraska,2021,2,1046022,69.3,1015089,67.3,30933,3.0
Nevada,2021,2,1503903,60.6,1375796,55.4,128107,8.5
New Hampshire,2021,2,758174,66.2,727439,63.5,30735,4.1
New Jersey,2021,2,4651945,62.8,4315408,58.3,336537,7.2
New Mexico,2021,2,936253,56.1,859958,51.6,76295,8.1
New York,2021,2,9536568,59.1,8743816,54.2,792752,8.3
New York city,2021,2,4075152,58.7,3588738,51.7,486414,11.9
North Carolina,2021,2,4876713,58.8,4608583,55.6,268130,5.5
North Dakota,2021,2,408163,68.5,392183,65.8,15980,3.9
Ohio,2021,2,5728382,61.4,5391710,57.8,336672,5.9
Oklahoma,2021,2,1860033,60.9,1769081,57.9,90952,4.9
Oregon,2021,2,2140331,61.9,2005894,58.0,134437,6.3
Pennsylvania,2021,2,6485858,61.9,6019056,57.4,466802,7.2
Rhode Island,2021,2,570094,63.4,534467,59.5,35627,6.2
South Carolina,2021,2,2348725,57.3,2244898,54.8,103827,4.4
South Dakota,2021,2,467041,68.7,453571,66.7,13470,2.9
Tennessee,2021,2,3319263,60.3,3144250,57.2,175013,5.3
Texas,2021,2,14168563,63.3,13234536,59.1,934027,6.6
Utah,2021,2,1671287,67.8,1617376,65.6,53911,3.2
Vermont,2021,2,333490,62.0,318443,59.2,15047,4.5
Virginia,2021,2,4312387,63.5,4109431,60.5,202956,4.7
Washington,2021,2,3878148,63.1,3640705,59.2,237443,6.1
West Virginia,2021,2,776303,53.8,730675,50.6,45628,5.9
Wisconsin,2021,2,3103920,65.9,2964828,62.9,139092,4.5
Wyoming,2021,2,290906,64.3,275416,60.8,15490,5.3
Alabama,2021,3,2257026,56.7,2172677,54.6,84349,3.7
Alaska,2021,3,351030,64.4,326308,59.8,24722,7.0
Arizona,2021,3,3522772,61.5,3311717,57.8,211055,6.0
Arkansas,2021,3,1336541,56.7,1274387,54.1,62154,4.7
California,2021,3,18841613,60.6,17259385,55.5,1582228,8.4
Los Angeles County,2021,3,4970625,62.4,4451336,55.9,519289,10.4
Colorado,2021,3,3138614,67.9,2945861,63.7,192753,6.1
Connecticut,2021,3,1813046,61.9,1688664,57.7,124382,6.9
Delaware,2021,3,494172,61.4,464920,57.8,29252,5.9
District of Columbia,2021,3,373766,68.4,347514,63.6,26252,7.0
Florida,2021,3,10212331,57.7,9667587,54.7,544744,5.3
Georgia,2021,3,5175916,61.9,4948163,59.1,227753,4.4
Hawaii,2021,3,676301,60.1,619280,55.1,57021,8.4
Idaho,2021,3,918933,63.1,883353,60.6,35580,3.9
Illinois,2021,3,6327813,62.7,5897875,58.4,429938,6.8
Indiana,2021,3,3361857,63.2,3214865,60.4,146992,4.4
Iowa,2021,3,1680437,67.0,1610404,64.2,70033,4.2
Kansas,2021,3,1501777,66.5,1448085,64.1,53692,3.6
Kentucky,2021,3,2015011,57.1,1924418,54.5,90593,4.5
Louisiana,2021,3,2077073,58.0,1940874,54.2,136199,6.6
Maine,2021,3,684051,60.1,651510,57.3,32541,4.8
Maryland,2021,3,3173857,65.0,2983241,61.1,190616,6.0
Massachusetts,2021,3,3740036,65.2,3500858,61.0,239178,6.4
Michigan,2021,3,4762269,59.1,4465028,55.4,297241,6.2
Minnesota,2021,3,3034263,67.5,2909230,64.7,125033,4.1
Mississippi,2021,3,1257229,55.1,1179106,51.7,78123,6.2
Missouri,2021,3,3052684,62.9,2909046,59.9,143638,4.7
Montana,2021,3,546814,62.3,526393,59.9,20421,3.7
Nebraska,2021,3,1047171,69.4,1016730,67.4,30441,2.9
Nevada,2021,3,1503443,60.5,1382561,55.6,120882,8.0
New Hampshire,2021,3,758200,66.1,728617,63.5,29583,3.9
New Jersey,2021,3,4661230,62.9,4329648,58.5,331582,7.1
New Mexico,2021,3,937876,56.2,863432,51.7,74444,7.9
New York,2021,3,9541206,59.2,8776986,54.5,764220,8.0
New York city,2021,3,4076465,58.9,3611200,52.2,465265,11.4
North Carolina,2021,3,4882082,58.8,4619631,55.7,262451,5.4
North Dakota,2021,3,408473,68.6,393412,66.1,15061,3.7
Ohio,2021,3,5729596,61.4,5401316,57.9,328280,5.7
Oklahoma,2021,3,1861964,60.9,1773542,58.0,88422,4.7
Oregon,2021,3,2145840,62.0,2014661,58.3,131179,6.1
Pennsylvania,2021,3,6476878,61.8,6029628,57.5,447250,6.9
Rhode Island,2021,3,571146,63.6,536401,59.7,34745,6.1
South Carolina,2021,3,2350934,57.3,2250340,54.8,100594,4.3
South Dakota,2021,3,467944,68.7,454640,66.8,13304,2.8
Tennessee,2021,3,3317431,60.3,3146908,57.2,170523,5.1
Texas,2021,3,14199656,63.3,13291247,59.3,908409,6.4
Utah,2021,3,1675126,67.9,1623597,65.8,51529,3.1
Vermont,2021,3,334449,62.1,319653,59.4,14796,4.4
Virginia,2021,3,4320400,63.6,4123484,60.7,196916,4.6
Washington,2021,3,3882171,63.1,3653458,59.4,228713,5.9
West Virginia,2021,3,777498,53.9,732775,50.8,44723,5.8
Wisconsin,2021,3,3106637,65.9,2970699,63.1,135938,4.4
Wyoming,2021,3,290762,64.2,275607,60.9,15155,5.2
Alabama,2021,4,2257943,56.7,2175666,54.6,82277,3.6
Alaska,2021,4,352250,64.6,327470,60.0,24780,7.0
Arizona,2021,4,3529604,61.6,3325839,58.0,203765,5.8
Arkansas,2021,4,1338220,56.8,1277934,54.2,60286,4.5
California,2021,4,18928168,60.9,17367539,55.8,1560629,8.2
Los Angeles County,2021,4,5000999,62.8,4490141,56.4,510858,10.2
Colorado,2021,4,3151329,68.1,2959199,64.0,192130,6.1
Connecticut,2021,4,1814471,61.9,1689909,57.6,124562,6.9
Delaware,2021,4,495534,61.5,466169,57.9,29365,5.9
District of Columbia,2021,4,375273,68.7,348849,63.8,26424,7.0
Florida,2021,4,10260663,57.9,9736226,55.0,524437,5.1
Georgia,2021,4,5179627,61.8,4959867,59.2,219760,4.2
Hawaii,2021,4,677128,60.2,624691,55.5,52437,7.7
Idaho,2021,4,921375,63.0,886613,60.7,34762,3.8
Illinois,2021,4,6344326,62.9,5922625,58.7,421701,6.6
Indiana,2021,4,3365126,63.2,3221208,60.5,143918,4.3
Iowa,2021,4,1687311,67.3,1616865,64.5,70446,4.2
Kansas,2021,4,1503382,66.5,1450239,64.2,53143,3.5
Kentucky,2021,4,2019666,57.2,1928992,54.6,90674,4.5
Louisiana,2021,4,2079974,58.1,1947756,54.4,132218,6.4
Maine,2021,4,686838,60.3,653160,57.4,33678,4.9
Maryland,2021,4,3176530,65.1,2990622,61.3,185908,5.9
Massachusetts,2021,4,3750513,65.3,3515529,61.2,234984,6.3
Michigan,2021,4,4767875,59.1,4471099,55.5,296776,6.2
Minnesota,2021,4,3035497,67.5,2913114,64.7,122383,4.0
Mississippi,2021,4,1257839,55.2,1181493,51.8,76346,6.1
Missouri,2021,4,3054204,62.9,2914476,60.0,139728,4.6
Montana,2021,4,548529,62.4,528398,60.1,20131,3.7
Nebraska,2021,4,1048338,69.4,1018448,67.5,29890,2.9
Nevada,2021,4,1504520,60.4,1388969,55.8,115551,7.7
New Hampshire,2021,4,758614,66.1,729823,63.6,28791,3.8
New Jersey,2021,4,4675579,63.1,4343837,58.6,331742,7.1
New Mexico,2021,4,941571,56.4,867850,52.0,73721,7.8
New York,2021,4,9558780,59.4,8814695,54.7,744085,7.8
New York city,2021,4,4088882,59.3,3636464,52.7,452418,11.1
North Carolina,2021,4,4886886,58.8,4630964,55.7,255922,5.2
North Dakota,2021,4,408705,68.6,394562,66.2,14143,3.5
Ohio,2021,4,5735826,61.5,5414936,58.0,320890,5.6
Oklahoma,2021,4,1863862,60.9,1777846,58.1,86016,4.6
Oregon,2021,4,2151417,62.2,2024294,58.5,127123,5.9
Pennsylvania,2021,4,6471769,61.7,6041633,57.6,430136,6.6
Rhode Island,2021,4,572836,63.7,538034,59.9,34802,6.1
South Carolina,2021,4,2354386,57.3,2256080,54.9,98306,4.2
South Dakota,2021,4,468912,68.8,455658,66.9,13254,2.8
Tennessee,2021,4,3320166,60.3,3153494,57.2,166672,5.0
Texas,2021,4,14238796,63.4,13356777,59.5,882019,6.2
Utah,2021,4,1679889,67.9,1629918,65.9,49971,3.0
Vermont,2021,4,335265,62.2,321094,59.6,14171,4.2
Virginia,2021,4,4327112,63.7,4137966,60.9,189146,4.4
Washington,2021,4,3887981,63.2,3667512,59.6,220469,5.7
West Virginia,2021,4,778884,54.0,735084,51.0,43800,5.6
Wisconsin,2021,4,3110041,66.0,2976961,63.2,133080,4.3
Wyoming,2021,4,290590,64.1,275886,60.9,14704,5.1
Alabama,2021,5,2257588,56.6,2177799,54.6,79789,3.5
Alaska,2021,5,352599,64.6,328554,60.2,24045,6.8
Arizona,2021,5,3533615,61.5,3339217,58.2,194398,5.5
Arkansas,2021,5,1338964,56.8,1281096,54.3,57868,4.3
California,2021,5,18966081,61.0,17470425,56.2,1495656,7.9
Los Angeles County,2021,5,5009648,63.0,4524507,56.9,485141,9.7
Colorado,2021,5,3156466,68.2,2971599,64.2,184867,5.9
Connecticut,2021,5,1812894,61.8,1691533,57.6,121361,6.7
Delaware,2021,5,496118,61.5,467077,57.9,29041,5.9
District of Columbia,2021,5,377194,69.0,350600,64.1,26594,7.1
Florida,2021,5,10308309,58.1,9804480,55.3,503829,4.9
Georgia,2021,5,5183214,61.8,4971177,59.3,212037,4.1
Hawaii,2021,5,675425,60.1,629135,55.9,46290,6.9
Idaho,2021,5,923300,63.0,889675,60.7,33625,3.6
Illinois,2021,5,6355520,63.0,5946567,58.9,408953,6.4
Indiana,2021,5,3365445,63.2,3225960,60.6,139485,4.1
Iowa,2021,5,1692792,67.5,1622936,64.7,69856,4.1
Kansas,2021,5,1504458,66.6,1451840,64.2,52618,3.5
Kentucky,2021,5,2022997,57.3,1932134,54.7,90863,4.5
Louisiana,2021,5,2080141,58.1,1953870,54.5,126271,6.1
Maine,2021,5,687603,60.3,654349,57.4,33254,4.8
Maryland,2021,5,3179389,65.1,2998799,61.4,180590,5.7
Massachusetts,2021,5,3747162,65.2,3528915,61.4,218247,5.8
Michigan,2021,5,4773124,59.2,4478057,55.5,295067,6.2
Minnesota,2021,5,3037231,67.5,2918024,64.8,119207,3.9
Mississippi,2021,5,1258113,55.2,1183855,51.9,74258,5.9
Missouri,2021,5,3053413,62.8,2919490,60.1,133923,4.4
Montana,2021,5,549708,62.4,530032,60.1,19676,3.6
Nebraska,2021,5,1049118,69.5,1019987,67.5,29131,2.8
Nevada,2021,5,1503525,60.3,1394370,55.9,109155,7.3
New Hampshire,2021,5,758275,66.0,730725,63.6,27550,3.6
New Jersey,2021,5,4678360,63.1,4355340,58.8,323020,6.9
New Mexico,2021,5,942751,56.5,872264,52.2,70487,7.5
New York,2021,5,9558574,59.4,8852224,55.0,706350,7.4
New York city,2021,5,4086988,59.4,3661866,53.2,425122,10.4
North Carolina,2021,5,4890841,58.8,4641385,55.8,249456,5.1
North Dakota,2021,5,408641,68.6,395461,66.4,13180,3.2
Ohio,2021,5,5739281,61.5,5428999,58.2,310282,5.4
Oklahoma,2021,5,1864565,60.9,1781550,58.2,83015,4.5
Oregon,2021,5,2152762,62.2,2032813,58.7,119949,5.6
Pennsylvania,2021,5,6464335,61.6,6051491,57.7,412844,6.4
Rhode Island,2021,5,573069,63.7,539224,60.0,33845,5.9
South Carolina,2021,5,2357454,57.3,2260898,55.0,96556,4.1
South Dakota,2021,5,469659,68.8,456536,66.9,13123,2.8
Tennessee,2021,5,3323858,60.3,3163526,57.4,160332,4.8
Texas,2021,5,14272260,63.5,13424638,59.7,847622,5.9
Utah,2021,5,1683902,67.9,1635746,66.0,48156,2.9
Vermont,2021,5,335786,62.2,322499,59.8,13287,4.0
Virginia,2021,5,4331863,63.7,4151293,61.1,180570,4.2
Washington,2021,5,3892531,63.2,3680710,59.8,211821,5.4
West Virginia,2021,5,779972,54.1,737307,51.1,42665,5.5
Wisconsin,2021,5,3111142,66.0,2982566,63.3,128576,4.1
Wyoming,2021,5,290163,64.0,276068,60.9,14095,4.9
Alabama,2021,6,2256834,56.6,2178735,54.6,78099,3.5
Alaska,2021,6,353649,64.8,329589,60.4,24060,6.8
Arizona,2021,6,3536243,61.5,3350595,58.3,185648,5.2
Arkansas,2021,6,1339341,56.7,1283435,54.4,55906,4.2
California,2021,6,19053546,61.3,17570885,56.5,1482661,7.8
Los Angeles County,2021,6,5033365,63.4,4555340,57.4,478025,9.5
Colorado,2021,6,3166563,68.3,2982191,64.4,184372,5.8
Connecticut,2021,6,1835081,62.5,1712988,58.3,122093,6.7
Delaware,2021,6,496055,61.4,467349,57.8,28706,5.8
District of Columbia,2021,6,379747,69.5,352375,64.5,27372,7.2
Florida,2021,6,10365645,58.4,9865545,55.6,500100,4.8
Georgia,2021,6,5185097,61.8,4978936,59.3,206161,4.0
Hawaii,2021,6,675350,60.0,632759,56.3,42591,6.3
Idaho,2021,6,925271,62.9,892321,60.7,32950,3.6
Illinois,2021,6,6371760,63.2,5966471,59.2,405289,6.4
Indiana,2021,6,3363914,63.1,3227295,60.5,136619,4.1
Iowa,2021,6,1697570,67.6,1628287,64.9,69283,4.1
Kansas,2021,6,1505241,66.6,1452604,64.3,52637,3.5
Kentucky,2021,6,2025464,57.3,1933762,54.7,91702,4.5
Louisiana,2021,6,2080576,58.1,1958296,54.7,122280,5.9
Maine,2021,6,688993,60.3,654873,57.4,34120,5.0
Maryland,2021,6,3186196,65.2,3004389,61.5,181807,5.7
Massachusetts,2021,6,3758717,65.4,3538885,61.6,219832,5.8
Michigan,2021,6,4783380,59.3,4484801,55.6,298579,6.2
Minnesota,2021,6,3038621,67.5,2920746,64.9,117875,3.9
Mississippi,2021,6,1257602,55.1,1185668,52.0,71934,5.7
Missouri,2021,6,3052928,62.8,2924215,60.1,128713,4.2
Montana,2021,6,550519,62.3,531119,60.1,19400,3.5
Nebraska,2021,6,1049898,69.5,1021102,67.6,28796,2.7
Nevada,2021,6,1503407,60.2,1398651,56.0,104756,7.0
New Hampshire,2021,6,757836,65.9,731038,63.6,26798,3.5
New Jersey,2021,6,4695852,63.4,4362613,58.9,333239,7.1
New Mexico,2021,6,946124,56.6,876131,52.4,69993,7.4
New York,2021,6,9590039,59.6,8885116,55.3,704923,7.4
New York city,2021,6,4116222,60.0,3685527,53.7,430695,10.5
North Carolina,2021,6,4923333,59.1,4674900,56.1,248433,5.0
North Dakota,2021,6,408534,68.6,396116,66.5,12418,3.0
Ohio,2021,6,5741468,61.5,5439237,58.3,302231,5.3
Oklahoma,2021,6,1864019,60.8,1784190,58.2,79829,4.3
Oregon,2021,6,2154506,62.2,2038536,58.8,115970,5.4
Pennsylvania,2021,6,6458105,61.5,6057076,57.7,401029,6.2
Rhode Island,2021,6,574515,63.9,539972,60.0,34543,6.0
South Carolina,2021,6,2359228,57.3,2263556,54.9,95672,4.1
South Dakota,2021,6,470382,68.9,457276,66.9,13106,2.8
Tennessee,2021,6,3328054,60.3,3173586,57.5,154468,4.6
Texas,2021,6,14322661,63.6,13486729,59.9,835932,5.8
Utah,2021,6,1687526,67.9,1640549,66.0,46977,2.8
Vermont,2021,6,336051,62.2,323587,59.9,12464,3.7
Virginia,2021,6,4332793,63.7,4160596,61.2,172197,4.0
Washington,2021,6,3900052,63.3,3693110,60.0,206942,5.3
West Virginia,2021,6,780593,54.1,739001,51.2,41592,5.3
Wisconsin,2021,6,3110985,66.0,2985836,63.3,125149,4.0
Wyoming,2021,6,289620,63.8,276053,60.8,13567,4.7
Alabama,2021,7,2254990,56.5,2179692,54.6,75298,3.3
Alaska,2021,7,353548,64.7,330645,60.6,22903,6.5
Arizona,2021,7,3535501,61.4,3360228,58.3,175273,5.0
Arkansas,2021,7,1338179,56.6,1285144,54.4,53035,4.0
California,2021,7,19046459,61.3,17644769,56.8,1401690,7.4
Los Angeles County,2021,7,5020942,63.3,4574359,57.7,446583,8.9
Colorado,2021,7,3168200,68.3,2991063,64.5,177137,5.6
Connecticut,2021,7,1851127,62.9,1732894,58.9,118233,6.4
Delaware,2021,7,494982,61.2,467169,57.7,27813,5.6
District of Columbia,2021,7,380756,69.7,353984,64.8,26772,7.0
Florida,2021,7,10394916,58.5,9918993,55.8,475923,4.6
Georgia,2021,7,5181556,61.7,4983312,59.3,198244,3.8
Hawaii,2021,7,671850,59.7,635023,56.4,36827,5.5
Idaho,2021,7,926763,62.9,894644,60.7,32119,3.5
Illinois,2021,7,6374958,63.2,5983175,59.3,391783,6.1
Indiana,2021,7,3357472,62.9,3226159,60.5,131313,3.9
Iowa,2021,7,1699282,67.6,1631935,65.0,67347,4.0
Kansas,2021,7,1504175,66.5,1452674,64.2,51501,3.4
Kentucky,2021,7,2027360,57.4,1935378,54.8,91982,4.5
Louisiana,2021,7,2075042,58.0,1961109,54.8,113933,5.5
Maine,2021,7,688249,60.2,654838,57.3,33411,4.9
Maryland,2021,7,3180660,65.1,3007207,61.5,173453,5.5
Massachusetts,2021,7,3750656,65.2,3545826,61.7,204830,5.5
Michigan,2021,7,4787408,59.4,4492972,55.7,294436,6.2
Minnesota,2021,7,3036721,67.4,2921297,64.8,115424,3.8
Mississippi,2021,7,1255694,55.1,1186727,52.0,68967,5.5
Missouri,2021,7,3050214,62.7,2927441,60.2,122773,4.0
Montana,2021,7,550874,62.3,531999,60.1,18875,3.4
Nebraska,2021,7,1050315,69.5,1021945,67.6,28370,2.7
Nevada,2021,7,1500687,60.1,1401193,56.1,99494,6.6
New Hampshire,2021,7,756569,65.8,731028,63.5,25541,3.4
New Jersey,2021,7,4686044,63.2,4365599,58.9,320445,6.8
New Mexico,2021,7,946425,56.6,879165,52.6,67260,7.1
New York,2021,7,9576306,59.6,8909301,55.5,667005,7.0
New York city,2021,7,4106555,60.0,3702934,54.1,403621,9.8
North Carolina,2021,7,4949461,59.3,4705802,56.4,243659,4.9
North Dakota,2021,7,408252,68.5,396572,66.5,11680,2.9
Ohio,2021,7,5736695,61.5,5445248,58.4,291447,5.1
Oklahoma,2021,7,1861239,60.7,1786245,58.3,74994,4.0
Oregon,2021,7,2150367,62.0,2041599,58.9,108768,5.1
Pennsylvania,2021,7,6444912,61.3,6060044,57.7,384868,6.0
Rhode Island,2021,7,574087,63.8,540595,60.1,33492,5.8
South Carolina,2021,7,2358053,57.2,2264543,54.9,93510,4.0
South Dakota,2021,7,470593,68.8,457723,66.9,12870,2.7
Tennessee,2021,7,3328375,60.3,3181465,57.6,146910,4.4
Texas,2021,7,14339051,63.6,13541793,60.1,797258,5.6
Utah,2021,7,1689942,67.9,1644550,66.0,45392,2.7
Vermont,2021,7,336049,62.2,324261,60.0,11788,3.5
Virginia,2021,7,4328913,63.6,4166858,61.2,162055,3.7
Washington,2021,7,3902844,63.3,3702387,60.1,200457,5.1
West Virginia,2021,7,780178,54.1,740243,51.3,39935,5.1
Wisconsin,2021,7,3106266,65.9,2986781,63.3,119485,3.8
Wyoming,2021,7,288910,63.6,275835,60.7,13075,4.5
Alabama,2021,8,2254517,56.5,2182295,54.6,72222,3.2
Alaska,2021,8,354035,64.8,331860,60.8,22175,6.3
Arizona,2021,8,3533835,61.3,3369357,58.4,164478,4.7
Arkansas,2021,8,1337928,56.6,1287361,54.4,50567,3.8
California,2021,8,19064774,61.4,17724539,57.0,1340235,7.0
Los Angeles County,2021,8,5018604,63.3,4594152,58.0,424452,8.5
Colorado,2021,8,3169842,68.3,3000556,64.6,169286,5.3
Connecticut,2021,8,1868126,63.5,1753157,59.6,114969,6.2
Delaware,2021,8,493937,61.0,467001,57.6,26936,5.5
District of Columbia,2021,8,381670,69.8,355338,65.0,26332,6.9
Florida,2021,8,10428151,58.6,9968996,56.0,459155,4.4
Georgia,2021,8,5178225,61.6,4988018,59.3,190207,3.7
Hawaii,2021,8,668729,59.4,636768,56.6,31961,4.8
Idaho,2021,8,928218,62.8,896945,60.7,31273,3.4
Illinois,2021,8,6379836,63.3,6004069,59.6,375767,5.9
Indiana,2021,8,3349882,62.8,3224643,60.4,125239,3.7
Iowa,2021,8,1699024,67.6,1634435,65.0,64589,3.8
Kansas,2021,8,1502040,66.4,1452555,64.2,49485,3.3
Kentucky,2021,8,2029977,57.4,1938559,54.8,91418,4.5
Louisiana,2021,8,2070917,57.9,1964063,54.9,106854,5.2
Maine,2021,8,687707,60.1,654723,57.2,32984,4.8
Maryland,2021,8,3178050,65.0,3011151,61.6,166899,5.3
Massachusetts,2021,8,3746540,65.2,3551533,61.8,195007,5.2
Michigan,2021,8,4789657,59.4,4504961,55.8,284696,5.9
Minnesota,2021,8,3035765,67.4,2923115,64.9,112650,3.7
Mississippi,2021,8,1253983,55.0,1188478,52.1,65505,5.2
Missouri,2021,8,3048293,62.6,2931085,60.2,117208,3.8
Montana,2021,8,551284,62.2,533077,60.1,18207,3.3
Nebraska,2021,8,1050703,69.5,1022798,67.6,27905,2.7
Nevada,2021,8,1497840,59.9,1403270,56.1,94570,6.3
New Hampshire,2021,8,755448,65.6,731143,63.5,24305,3.2
New Jersey,2021,8,4683082,63.2,4368476,58.9,314606,6.7
New Mexico,2021,8,946870,56.6,882150,52.8,64720,6.8
New York,2021,8,9577488,59.6,8932320,55.6,645168,6.7
New York city,2021,8,4111508,60.1,3718097,54.4,393411,9.6
North Carolina,2021,8,4977641,59.6,4738050,56.7,239591,4.8
North Dakota,2021,8,408238,68.4,397146,66.6,11092,2.7
Ohio,2021,8,5729906,61.4,5449562,58.4,280344,4.9
Oklahoma,2021,8,1858341,60.6,1788776,58.3,69565,3.7
Oregon,2021,8,2147464,61.9,2043798,58.9,103666,4.8
Pennsylvania,2021,8,6430518,61.2,6064094,57.7,366424,5.7
Rhode Island,2021,8,573477,63.7,541372,60.1,32105,5.6
South Carolina,2021,8,2355995,57.0,2265166,54.8,90829,3.9
South Dakota,2021,8,470689,68.7,458199,66.9,12490,2.7
Tennessee,2021,8,3326586,60.1,3187101,57.6,139485,4.2
Texas,2021,8,14364126,63.6,13593093,60.2,771033,5.4
Utah,2021,8,1692136,67.8,1648414,66.1,43722,2.6
Vermont,2021,8,336212,62.2,324908,60.1,11304,3.4
Virginia,2021,8,4327488,63.6,4173992,61.3,153496,3.5
Washington,2021,8,3906340,63.3,3712391,60.2,193949,5.0
West Virginia,2021,8,779587,54.1,741465,51.4,38122,4.9
Wisconsin,2021,8,3099968,65.7,2986638,63.3,113330,3.7
Wyoming,2021,8,288256,63.4,275604,60.6,12652,4.4
Alabama,2021,9,2255950,56.5,2186982,54.7,68968,3.1
Alaska,2021,9,354208,64.9,333205,61.0,21003,5.9
Arizona,2021,9,3532779,61.1,3378889,58.5,153890,4.4
Arkansas,2021,9,1338825,56.6,1290650,54.6,48175,3.6
California,2021,9,19037677,61.3,17793674,57.3,1244003,6.5
Los Angeles County,2021,9,5000543,63.1,4609650,58.2,390893,7.8
Colorado,2021,9,3165738,68.1,3011307,64.8,154431,4.9
Connecticut,2021,9,1883309,64.0,1773148,60.3,110161,5.8
Delaware,2021,9,493003,60.8,467212,57.6,25791,5.2
District of Columbia,2021,9,381059,69.7,356041,65.1,25018,6.6
Florida,2021,9,10444912,58.5,10016246,56.1,428666,4.1
Georgia,2021,9,5175297,61.5,4993517,59.3,181780,3.5
Hawaii,2021,9,664661,59.1,637879,56.7,26782,4.0
Idaho,2021,9,929659,62.8,899474,60.8,30185,3.2
Illinois,2021,9,6383937,63.4,6030126,59.9,353811,5.5
Indiana,2021,9,3343102,62.6,3225114,60.4,117988,3.5
Iowa,2021,9,1696647,67.5,1635797,65.1,60850,3.6
Kansas,2021,9,1499175,66.2,1452733,64.2,46442,3.1
Kentucky,2021,9,2033486,57.5,1943558,55.0,89928,4.4
Louisiana,2021,9,2066869,57.8,1968213,55.0,98656,4.8
Maine,2021,9,686342,59.9,654571,57.2,31771,4.6
Maryland,2021,9,3167097,64.8,3014818,61.7,152279,4.8
Massachusetts,2021,9,3737893,65.0,3557550,61.9,180343,4.8
Michigan,2021,9,4789394,59.4,4520745,56.0,268649,5.6
Minnesota,2021,9,3035912,67.3,2927368,64.9,108544,3.6
Mississippi,2021,9,1253059,54.9,1190913,52.2,62146,5.0
Missouri,2021,9,3045808,62.6,2934175,60.3,111633,3.7
Montana,2021,9,552012,62.2,534650,60.2,17362,3.1
Nebraska,2021,9,1050982,69.5,1023879,67.7,27103,2.6
Nevada,2021,9,1494556,59.7,1404908,56.1,89648,6.0
New Hampshire,2021,9,754560,65.5,731620,63.5,22940,3.0
New Jersey,2021,9,4662465,62.9,4371438,58.9,291027,6.2
New Mexico,2021,9,944759,56.5,885068,52.9,59691,6.3
New York,2021,9,9553876,59.5,8956839,55.8,597037,6.2
New York city,2021,9,4091212,59.9,3731079,54.6,360133,8.8
North Carolina,2021,9,5003211,59.8,4772401,57.0,230810,4.6
North Dakota,2021,9,408466,68.5,397876,66.7,10590,2.6
Ohio,2021,9,5721752,61.3,5453523,58.4,268229,4.7
Oklahoma,2021,9,1856226,60.4,1792295,58.4,63931,3.4
Oregon,2021,9,2144952,61.9,2047470,59.0,97482,4.5
Pennsylvania,2021,9,6416798,61.1,6071236,57.8,345562,5.4
Rhode Island,2021,9,571984,63.5,542372,60.3,29612,5.2
South Carolina,2021,9,2353863,56.9,2266371,54.8,87492,3.7
South Dakota,2021,9,470520,68.6,458605,66.8,11915,2.5
Tennessee,2021,9,3324395,60.0,3191910,57.6,132485,4.0
Texas,2021,9,14376211,63.6,13644738,60.3,731473,5.1
Utah,2021,9,1694486,67.8,1652646,66.1,41840,2.5
Vermont,2021,9,336491,62.2,325541,60.2,10950,3.3
Virginia,2021,9,4328172,63.5,4182358,61.4,145814,3.4
Washington,2021,9,3907590,63.3,3721760,60.3,185830,4.8
West Virginia,2021,9,779073,54.0,742949,51.5,36124,4.6
Wisconsin,2021,9,3093323,65.5,2986694,63.3,106629,3.4
Wyoming,2021,9,287686,63.2,275457,60.5,12229,4.3
Alabama,2021,10,2260318,56.5,2193949,54.9,66369,2.9
Alaska,2021,10,355257,65.0,334795,61.3,20462,5.8
Arizona,2021,10,3535221,61.1,3390079,58.6,145142,4.1
Arkansas,2021,10,1342354,56.7,1295854,54.7,46500,3.5
California,2021,10,19064571,61.3,17886523,57.6,1178048,6.2
Los Angeles County,2021,10,5004085,63.2,4633274,58.5,370811,7.4
Colorado,2021,10,3172038,68.2,3024673,65.1,147365,4.6
Connecticut,2021,10,1901339,64.6,1794555,61.0,106784,5.6
Delaware,2021,10,493080,60.7,468098,57.6,24982,5.1
District of Columbia,2021,10,381059,69.6,356546,65.1,24513,6.4
Florida,2021,10,10477350,58.6,10065312,56.3,412038,3.9
Georgia,2021,10,5178785,61.4,5003580,59.4,175205,3.4
Hawaii,2021,10,661609,58.8,639268,56.8,22341,3.4
Idaho,2021,10,931604,62.8,902598,60.9,29006,3.1
Illinois,2021,10,6401340,63.6,6065021,60.2,336319,5.3
Indiana,2021,10,3342060,62.6,3230596,60.5,111464,3.3
Iowa,2021,10,1696240,67.5,1639255,65.2,56985,3.4
Kansas,2021,10,1497188,66.1,1453753,64.2,43435,2.9
Kentucky,2021,10,2038428,57.6,1950505,55.2,87923,4.3
Louisiana,2021,10,2067899,57.8,1974690,55.2,93209,4.5
Maine,2021,10,685460,59.8,654681,57.1,30779,4.5
Maryland,2021,10,3165541,64.8,3023548,61.9,141993,4.5
Massachusetts,2021,10,3738267,65.0,3566159,62.0,172108,4.6
Michigan,2021,10,4791389,59.4,4539758,56.3,251631,5.3
Minnesota,2021,10,3039608,67.4,2935441,65.1,104167,3.4
Mississippi,2021,10,1253849,55.0,1194771,52.4,59078,4.7
Missouri,2021,10,3047222,62.6,2940576,60.4,106646,3.5
Montana,2021,10,553513,62.3,536997,60.4,16516,3.0
Nebraska,2021,10,1051532,69.5,1025473,67.7,26059,2.5
Nevada,2021,10,1493591,59.6,1407374,56.1,86217,5.8
New Hampshire,2021,10,754457,65.4,732898,63.6,21559,2.9
New Jersey,2021,10,4655775,62.8,4378549,59.0,277226,6.0
New Mexico,2021,10,946111,56.6,888510,53.1,57601,6.1
New York,2021,10,9557783,59.6,8989806,56.0,567977,5.9
New York city,2021,10,4093748,60.0,3747174,54.9,346574,8.5
North Carolina,2021,10,5033666,60.1,4812191,57.4,221475,4.4
North Dakota,2021,10,409356,68.6,399140,66.9,10216,2.5
Ohio,2021,10,5717974,61.3,5460427,58.5,257547,4.5
Oklahoma,2021,10,1856755,60.4,1797348,58.5,59407,3.2
Oregon,2021,10,2147552,61.9,2054139,59.2,93413,4.3
Pennsylvania,2021,10,6409611,61.0,6083528,57.9,326083,5.1
Rhode Island,2021,10,570793,63.4,543754,60.4,27039,4.7
South Carolina,2021,10,2353701,56.8,2269143,54.7,84558,3.6
South Dakota,2021,10,470827,68.5,459540,66.9,11287,2.4
Tennessee,2021,10,3325481,60.0,3198414,57.7,127067,3.8
Texas,2021,10,14410330,63.6,13702700,60.5,707630,4.9
Utah,2021,10,1698177,67.9,1657900,66.2,40277,2.4
Vermont,2021,10,337101,62.3,326507,60.4,10594,3.1
Virginia,2021,10,4336676,63.6,4196709,61.6,139967,3.2
Washington,2021,10,3912080,63.3,3734664,60.4,177416,4.5
West Virginia,2021,10,779247,54.1,744914,51.7,34333,4.4
Wisconsin,2021,10,3089325,65.4,2988745,63.3,100580,3.3
Wyoming,2021,10,287364,63.1,275583,60.5,11781,4.1
Alabama,2021,11,2266041,56.7,2202255,55.1,63786,2.8
Alaska,2021,11,355994,65.2,336389,61.6,19605,5.5
Arizona,2021,11,3540974,61.1,3402868,58.7,138106,3.9
Arkansas,2021,11,1347185,56.9,1302097,55.0,45088,3.3
California,2021,11,19078014,61.4,17980818,57.9,1097196,5.8
Los Angeles County,2021,11,5002905,63.2,4657402,58.8,345503,6.9
Colorado,2021,11,3180011,68.3,3039694,65.3,140317,4.4
Connecticut,2021,11,1918331,65.2,1816463,61.7,101868,5.3
Delaware,2021,11,493816,60.7,469624,57.7,24192,4.9
District of Columbia,2021,11,380674,69.5,356764,65.2,23910,6.3
Florida,2021,11,10509000,58.7,10115529,56.5,393471,3.7
Georgia,2021,11,5186129,61.5,5016402,59.5,169727,3.3
Hawaii,2021,11,662318,58.9,640663,57.0,21655,3.3
Idaho,2021,11,933901,62.9,906261,61.0,27640,3.0
Illinois,2021,11,6422034,63.8,6101290,60.6,320744,5.0
Indiana,2021,11,3346831,62.6,3241334,60.7,105497,3.2
Iowa,2021,11,1696850,67.5,1644060,65.4,52790,3.1
Kansas,2021,11,1496100,66.1,1455595,64.3,40505,2.7
Kentucky,2021,11,2043698,57.8,1958284,55.4,85414,4.2
Louisiana,2021,11,2071020,58.0,1982892,55.5,88128,4.3
Maine,2021,11,683775,59.6,655004,57.1,28771,4.2
Maryland,2021,11,3163512,64.7,3033748,62.1,129764,4.1
Massachusetts,2021,11,3734644,65.0,3577114,62.2,157530,4.2
Michigan,2021,11,4794945,59.4,4560295,56.5,234650,4.9
Minnesota,2021,11,3043627,67.5,2945562,65.3,98065,3.2
Mississippi,2021,11,1255316,55.1,1199008,52.6,56308,4.5
Missouri,2021,11,3048613,62.6,2947333,60.5,101280,3.3
Montana,2021,11,555653,62.4,539985,60.7,15668,2.8
Nebraska,2021,11,1052207,69.5,1027538,67.9,24669,2.3
Nevada,2021,11,1493612,59.5,1410063,56.2,83549,5.6
New Hampshire,2021,11,755042,65.4,734981,63.7,20061,2.7
New Jersey,2021,11,4648884,62.7,4388549,59.2,260335,5.6
New Mexico,2021,11,947661,56.6,892197,53.3,55464,5.9
New York,2021,11,9562350,59.6,9026895,56.3,535455,5.6
New York city,2021,11,4093657,60.1,3763483,55.2,330174,8.1
North Carolina,2021,11,5064990,60.4,4855474,57.9,209516,4.1
North Dakota,2021,11,410514,68.8,400644,67.1,9870,2.4
Ohio,2021,11,5717562,61.3,5469344,58.6,248218,4.3
Oklahoma,2021,11,1860085,60.5,1803855,58.6,56230,3.0
Oregon,2021,11,2152075,62.1,2063266,59.5,88809,4.1
Pennsylvania,2021,11,6410152,61.0,6101152,58.1,309000,4.8
Rhode Island,2021,11,569439,63.3,545390,60.6,24049,4.2
South Carolina,2021,11,2355619,56.7,2273789,54.8,81830,3.5
South Dakota,2021,11,471145,68.5,460573,66.9,10572,2.2
Tennessee,2021,11,3330132,60.0,3208044,57.8,122088,3.7
Texas,2021,11,14440478,63.7,13766342,60.7,674136,4.7
Utah,2021,11,1703144,68.0,1664205,66.4,38939,2.3
Vermont,2021,11,337824,62.4,327678,60.6,10146,3.0
Virginia,2021,11,4350117,63.8,4215207,61.8,134910,3.1
Washington,2021,11,3917448,63.3,3748407,60.6,169041,4.3
West Virginia,2021,11,779943,54.2,747271,51.9,32672,4.2
Wisconsin,2021,11,3087863,65.4,2992838,63.3,95025,3.1
Wyoming,2021,11,287211,63.0,275933,60.6,11278,3.9
Alabama,2021,12,2272467,56.8,2210635,55.3,61832,2.7
Alaska,2021,12,357050,65.4,337926,61.9,19124,5.4
Arizona,2021,12,3550075,61.2,3417105,58.9,132970,3.7
Arkansas,2021,12,1353116,57.1,1308958,55.2,44158,3.3
California,2021,12,19143658,61.6,18095739,58.2,1047919,5.5
Los Angeles County,2021,12,5021539,63.5,4688593,59.3,332946,6.6
Colorado,2021,12,3190176,68.5,3056057,65.6,134119,4.2
Connecticut,2021,12,1937363,65.8,1839087,62.5,98276,5.1
Delaware,2021,12,495074,60.8,471588,57.9,23486,4.7
District of Columbia,2021,12,380333,69.4,357003,65.2,23330,6.1
Florida,2021,12,10544190,58.8,10168586,56.7,375604,3.6
Georgia,2021,12,5197155,61.5,5032168,59.6,164987,3.2
Hawaii,2021,12,663974,59.0,642642,57.1,21332,3.2
Idaho,2021,12,936574,62.9,910325,61.2,26249,2.8
Illinois,2021,12,6448827,64.1,6136052,61.0,312775,4.9
Indiana,2021,12,3357013,62.8,3256372,60.9,100641,3.0
Iowa,2021,12,1699856,67.6,1651024,65.6,48832,2.9
Kansas,2021,12,1496637,66.1,1458310,64.4,38327,2.6
Kentucky,2021,12,2048726,57.9,1965641,55.6,83085,4.1
Louisiana,2021,12,2077478,58.2,1992802,55.8,84676,4.1
Maine,2021,12,682601,59.5,655725,57.2,26876,3.9
Maryland,2021,12,3163212,64.7,3045785,62.3,117427,3.7
Massachusetts,2021,12,3736348,65.0,3589145,62.4,147203,3.9
Michigan,2021,12,4802239,59.5,4581790,56.8,220449,4.6
Minnesota,2021,12,3048237,67.6,2956873,65.5,91364,3.0
Mississippi,2021,12,1257422,55.1,1203546,52.8,53876,4.3
Missouri,2021,12,3051578,62.6,2955793,60.7,95785,3.1
Montana,2021,12,558283,62.6,543332,60.9,14951,2.7
Nebraska,2021,12,1053265,69.5,1030007,68.0,23258,2.2
Nevada,2021,12,1495301,59.5,1413547,56.2,81754,5.5
New Hampshire,2021,12,756394,65.5,737732,63.9,18662,2.5
New Jersey,2021,12,4655098,62.8,4401723,59.3,253375,5.4
New Mexico,2021,12,950040,56.8,896380,53.6,53660,5.6
New York,2021,12,9587317,59.8,9067724,56.6,519593,5.4
New York city,2021,12,4110209,60.4,3781438,55.6,328771,8.0
North Carolina,2021,12,5098391,60.7,4901956,58.4,196435,3.9
North Dakota,2021,12,411941,69.0,402331,67.4,9610,2.3
Ohio,2021,12,5723284,61.3,5482261,58.7,241023,4.2
Oklahoma,2021,12,1865865,60.6,1811441,58.9,54424,2.9
Oregon,2021,12,2159852,62.3,2073813,59.8,86039,4.0
Pennsylvania,2021,12,6420876,61.2,6124585,58.3,296291,4.6
Rhode Island,2021,12,568803,63.2,547251,60.8,21552,3.8
South Carolina,2021,12,2360020,56.8,2280395,54.8,79625,3.4
South Dakota,2021,12,471809,68.5,461875,67.0,9934,2.1
Tennessee,2021,12,3340490,60.1,3221675,58.0,118815,3.6
Texas,2021,12,14486259,63.8,13835000,60.9,651259,4.5
Utah,2021,12,1709434,68.1,1671444,66.6,37990,2.2
Vermont,2021,12,338672,62.6,329101,60.8,9571,2.8
Virginia,2021,12,4368982,64.1,4237842,62.1,131140,3.0
Washington,2021,12,3927463,63.4,3764862,60.8,162601,4.1
West Virginia,2021,12,781138,54.3,750031,52.1,31107,4.0
Wisconsin,2021,12,3088889,65.4,2998382,63.4,90507,2.9
Wyoming,2021,12,287235,63.0,276506,60.7,10729,3.7
Alabama,2022,1,2278519,56.9,2218249,55.4,60270,2.6
Alaska,2022,1,357699,65.5,339409,62.1,18290,5.1
Arizona,2022,1,3562073,61.3,3432058,59.1,130015,3.6
Arkansas,2022,1,1359125,57.3,1315324,55.5,43801,3.2
California,2022,1,19200001,61.8,18205836,58.6,994165,5.2
Los Angeles County,2022,1,5034593,63.6,4717059,59.6,317534,6.3
Colorado,2022,1,3199508,68.7,3072499,65.9,127009,4.0
Connecticut,2022,1,1956669,66.5,1862039,63.3,94630,4.8
Delaware,2022,1,496669,60.9,473600,58.1,23069,4.6
District of Columbia,2022,1,383681,70.0,360522,65.8,23159,6.0
Florida,2022,1,10595755,59.0,10224527,56.9,371228,3.5
Georgia,2022,1,5210533,61.6,5048978,59.7,161555,3.1
Hawaii,2022,1,666270,59.3,644870,57.3,21400,3.2
Idaho,2022,1,939689,63.0,914562,61.3,25127,2.7
Illinois,2022,1,6473046,64.4,6164248,61.3,308798,4.8
Indiana,2022,1,3370014,63.1,3272839,61.2,97175,2.9
Iowa,2022,1,1704321,67.8,1659074,66.0,45247,2.7
Kansas,2022,1,1498559,66.2,1461629,64.5,36930,2.5
Kentucky,2022,1,2052685,58.0,1971515,55.7,81170,4.0
Louisiana,2022,1,2086684,58.5,2003051,56.1,83633,4.0
Maine,2022,1,681545,59.4,656769,57.2,24776,3.6
Maryland,2022,1,3172616,64.9,3056712,62.6,115904,3.7
Massachusetts,2022,1,3752622,65.3,3600641,62.6,151981,4.0
Michigan,2022,1,4813511,59.6,4603343,57.0,210168,4.4
Minnesota,2022,1,3056628,67.8,2971950,65.9,84678,2.8
Mississippi,2022,1,1259077,55.2,1207303,53.0,51774,4.1
Missouri,2022,1,3053803,62.7,2964225,60.8,89578,2.9
Montana,2022,1,561073,62.9,546550,61.2,14523,2.6
Nebraska,2022,1,1054637,69.6,1032595,68.1,22042,2.1
Nevada,2022,1,1506448,59.9,1425261,56.6,81187,5.4
New Hampshire,2022,1,758462,65.7,740891,64.1,17571,2.3
New Jersey,2022,1,4678306,63.1,4439967,59.9,238339,5.1
New Mexico,2022,1,952185,56.9,900599,53.8,51586,5.4
New York,2022,1,9602911,60.0,9109926,56.9,492985,5.1
New York city,2022,1,4113670,60.5,3800369,55.9,313301,7.6
North Carolina,2022,1,5136163,61.1,4949439,58.9,186724,3.6
North Dakota,2022,1,413280,69.2,403890,67.6,9390,2.3
Ohio,2022,1,5734686,61.4,5498833,58.9,235853,4.1
Oklahoma,2022,1,1873012,60.8,1819207,59.1,53805,2.9
Oregon,2022,1,2166951,62.5,2083697,60.1,83254,3.8
Pennsylvania,2022,1,6440285,61.4,6151448,58.6,288837,4.5
Rhode Island,2022,1,569398,63.3,549318,61.1,20080,3.5
South Carolina,2022,1,2366671,56.8,2288249,54.9,78422,3.3
South Dakota,2022,1,472607,68.5,463168,67.1,9439,2.0
Tennessee,2022,1,3355106,60.3,3238437,58.2,116669,3.5
Texas,2022,1,14536799,63.9,13905907,61.1,630892,4.3
Utah,2022,1,1716885,68.3,1679210,66.8,37675,2.2
Vermont,2022,1,339517,62.7,330578,61.1,8939,2.6
Virginia,2022,1,4390475,64.4,4261556,62.5,128919,2.9
Washington,2022,1,3940239,63.6,3781328,61.0,158911,4.0
West Virginia,2022,1,782880,54.4,753003,52.3,29877,3.8
Wisconsin,2022,1,3091724,65.4,3004230,63.5,87494,2.8
Wyoming,2022,1,288078,63.2,277867,60.9,10211,3.5
Alabama,2022,2,2283545,57.1,2224602,55.6,58943,2.6
Alaska,2022,2,357505,65.5,340773,62.4,16732,4.7
Arizona,2022,2,3574947,61.4,3446656,59.2,128291,3.6
Arkansas,2022,2,1364164,57.5,1320798,55.7,43366,3.2
California,2022,2,19211201,61.8,18301764,58.9,909437,4.7
Los Angeles County,2022,2,5028059,63.6,4739155,59.9,288904,5.7
Colorado,2022,2,3203198,68.7,3087732,66.2,115466,3.6
Connecticut,2022,2,1953675,66.4,1864494,63.4,89181,4.6
Delaware,2022,2,497596,61.0,475249,58.2,22347,4.5
District of Columbia,2022,2,385691,70.4,364028,66.4,21663,5.6
Florida,2022,2,10632437,59.1,10282914,57.2,349523,3.3
Georgia,2022,2,5223335,61.7,5065290,59.8,158045,3.0
Hawaii,2022,2,668791,59.5,647214,57.6,21577,3.2
Idaho,2022,2,942876,63.2,918643,61.5,24233,2.6
Illinois,2022,2,6485800,64.5,6184622,61.5,301178,4.6
Indiana,2022,2,3382674,63.3,3288140,61.5,94534,2.8
Iowa,2022,2,1709447,68.0,1667279,66.3,42168,2.5
Kansas,2022,2,1501071,66.3,1465088,64.7,35983,2.4
Kentucky,2022,2,2054866,58.1,1975348,55.9,79518,3.9
Louisiana,2022,2,2093335,58.7,2012304,56.4,81031,3.9
Maine,2022,2,679873,59.2,657983,57.3,21890,3.2
Maryland,2022,2,3173470,65.0,3065843,62.8,107627,3.4
Massachusetts,2022,2,3756186,65.4,3610429,62.8,145757,3.9
Michigan,2022,2,4825236,59.8,4623433,57.3,201803,4.2
Minnesota,2022,2,3063341,67.9,2984937,66.2,78404,2.6
Mississippi,2022,2,1259950,55.3,1210080,53.1,49870,4.0
Missouri,2022,2,3055452,62.7,2973164,61.0,82288,2.7
Montana,2022,2,563576,63.1,549250,61.5,14326,2.5
Nebraska,2022,2,1056108,69.7,1034945,68.3,21163,2.0
Nevada,2022,2,1517654,60.3,1436822,57.1,80832,5.3
New Hampshire,2022,2,760828,65.9,744129,64.4,16699,2.2
New Jersey,2022,2,4693448,63.3,4477726,60.4,215722,4.6
New Mexico,2022,2,952130,56.9,904419,54.0,47711,5.0
New York,2022,2,9607227,60.1,9151475,57.2,455752,4.7
New York city,2022,2,4104375,60.4,3820294,56.3,284081,6.9
North Carolina,2022,2,5145038,61.1,4967832,59.0,177206,3.4
North Dakota,2022,2,414319,69.4,405212,67.8,9107,2.2
Ohio,2022,2,5747444,61.6,5517007,59.1,230437,4.0
Oklahoma,2022,2,1879627,61.0,1826202,59.3,53425,2.8
Oregon,2022,2,2170160,62.6,2090906,60.3,79254,3.7
Pennsylvania,2022,2,6461662,61.6,6177395,58.9,284267,4.4
Rhode Island,2022,2,569892,63.4,551481,61.3,18411,3.2
South Carolina,2022,2,2373294,56.9,2296061,55.1,77233,3.3
South Dakota,2022,2,473591,68.5,464495,67.2,9096,1.9
Tennessee,2022,2,3370203,60.6,3255407,58.5,114796,3.4
Texas,2022,2,14573420,64.0,13975315,61.3,598105,4.1
Utah,2022,2,1724549,68.5,1686890,67.0,37659,2.2
Vermont,2022,2,340337,62.9,332023,61.4,8314,2.4
Virginia,2022,2,4409478,64.6,4283613,62.8,125865,2.9
Washington,2022,2,3953065,63.8,3796706,61.3,156359,4.0
West Virginia,2022,2,784581,54.6,755664,52.6,28917,3.7
Wisconsin,2022,2,3094323,65.4,3008765,63.6,85558,2.8
Wyoming,2022,2,288931,63.3,279182,61.2,9749,3.4
Alabama,2022,3,2287334,57.1,2229260,55.7,58074,2.5
Alaska,2022,3,357273,65.4,341906,62.6,15367,4.3
Arizona,2022,3,3587441,61.6,3459342,59.4,128099,3.6
Arkansas,2022,3,1367533,57.6,1324471,55.8,43062,3.1
California,2022,3,19219905,61.9,18382817,59.2,837088,4.4
Los Angeles County,2022,3,5019203,63.5,4755340,60.2,263863,5.3
Colorado,2022,3,3204876,68.7,3100075,66.5,104801,3.3
Connecticut,2022,3,1950423,66.3,1865953,63.4,84470,4.3
Delaware,2022,3,498091,61.0,476238,58.3,21853,4.4
District of Columbia,2022,3,387619,70.7,367319,67.0,20300,5.2
Florida,2022,3,10672069,59.3,10340203,57.4,331866,3.1
Georgia,2022,3,5233419,61.8,5077845,59.9,155574,3.0
Hawaii,2022,3,671502,59.8,649586,57.8,21916,3.3
Idaho,2022,3,945839,63.2,922107,61.7,23732,2.5
Illinois,2022,3,6490596,64.6,6196105,61.7,294491,4.5
Indiana,2022,3,3394391,63.5,3300416,61.7,93975,2.8
Iowa,2022,3,1713877,68.1,1673531,66.5,40346,2.4
Kansas,2022,3,1503552,66.4,1467848,64.8,35704,2.4
Kentucky,2022,3,2055534,58.1,1976902,55.9,78632,3.8
Louisiana,2022,3,2096410,58.8,2018345,56.6,78065,3.7
Maine,2022,3,678426,59.1,658955,57.4,19471,2.9
Maryland,2022,3,3173331,65.0,3071258,62.9,102073,3.2
Massachusetts,2022,3,3755168,65.3,3616871,62.9,138297,3.7
Michigan,2022,3,4835578,59.9,4639558,57.5,196020,4.1
Minnesota,2022,3,3068131,68.0,2994059,66.4,74072,2.4
Mississippi,2022,3,1259725,55.3,1211539,53.2,48186,3.8
Missouri,2022,3,3056255,62.7,2981115,61.2,75140,2.5
Montana,2022,3,565622,63.2,551238,61.6,14384,2.5
Nebraska,2022,3,1057550,69.8,1036632,68.4,20918,2.0
Nevada,2022,3,1528283,60.6,1447623,57.4,80660,5.3
New Hampshire,2022,3,763215,66.0,746945,64.6,16270,2.1
New Jersey,2022,3,4706634,63.5,4511597,60.9,195037,4.1
New Mexico,2022,3,951121,56.8,907328,54.2,43793,4.6
New York,2022,3,9611138,60.1,9186959,57.5,424179,4.4
New York city,2022,3,4095338,60.4,3839193,56.6,256145,6.3
North Carolina,2022,3,5153298,61.2,4981094,59.1,172204,3.3
North Dakota,2022,3,414911,69.4,406114,68.0,8797,2.1
Ohio,2022,3,5758127,61.7,5532083,59.3,226044,3.9
Oklahoma,2022,3,1884603,61.1,1831337,59.4,53266,2.8
Oregon,2022,3,2171252,62.7,2094311,60.5,76941,3.5
Pennsylvania,2022,3,6478879,61.8,6197038,59.1,281841,4.4
Rhode Island,2022,3,570640,63.5,553450,61.5,17190,3.0
South Carolina,2022,3,2378214,56.9,2302045,55.1,76169,3.2
South Dakota,2022,3,474598,68.6,465603,67.3,8995,1.9
Tennessee,2022,3,3380792,60.7,3267802,58.7,112990,3.3
Texas,2022,3,14605471,64.0,14035637,61.5,569834,3.9
Utah,2022,3,1731501,68.7,1693613,67.2,37888,2.2
Vermont,2022,3,341055,63.0,333230,61.6,7825,2.3
Virginia,2022,3,4421757,64.8,4300032,63.0,121725,2.8
Washington,2022,3,3965105,63.9,3810117,61.4,154988,3.9
West Virginia,2022,3,785927,54.7,757359,52.7,28568,3.6
Wisconsin,2022,3,3095420,65.4,3010244,63.6,85176,2.8
Wyoming,2022,3,289736,63.5,280300,61.4,9436,3.3
Alabama,2022,4,2289967,57.2,2232255,55.7,57712,2.5
Alaska,2022,4,357300,65.4,342753,62.7,14547,4.1
Arizona,2022,4,3598901,61.7,3469541,59.5,129360,3.6
Arkansas,2022,4,1369620,57.7,1326516,55.9,43104,3.1
California,2022,4,19246821,61.9,18455355,59.4,791466,4.1
Los Angeles County,2022,4,5016106,63.5,4768582,60.4,247524,4.9
Colorado,2022,4,3207533,68.7,3108954,66.6,98579,3.1
Connecticut,2022,4,1947722,66.2,1865809,63.4,81913,4.2
Delaware,2022,4,498094,60.9,476549,58.2,21545,4.3
District of Columbia,2022,4,389336,71.0,370343,67.5,18993,4.9
Florida,2022,4,10711678,59.4,10394879,57.6,316799,3.0
Georgia,2022,4,5240391,61.8,5086208,59.9,154183,2.9
Hawaii,2022,4,674343,60.0,652006,58.0,22337,3.3
Idaho,2022,4,948461,63.3,924763,61.7,23698,2.5
Illinois,2022,4,6490960,64.7,6201366,61.8,289594,4.5
Indiana,2022,4,3404629,63.7,3309355,61.9,95274,2.8
Iowa,2022,4,1717078,68.3,1676991,66.7,40087,2.3
Kansas,2022,4,1505453,66.5,1469417,64.9,36036,2.4
Kentucky,2022,4,2055514,58.1,1976946,55.9,78568,3.8
Louisiana,2022,4,2096684,58.9,2020644,56.7,76040,3.6
Maine,2022,4,677710,59.0,659458,57.4,18252,2.7
Maryland,2022,4,3173560,65.0,3075234,63.0,98326,3.1
Massachusetts,2022,4,3758814,65.4,3619534,63.0,139280,3.7
Michigan,2022,4,4843204,60.0,4650614,57.6,192590,4.0
Minnesota,2022,4,3072002,68.1,2999924,66.5,72078,2.3
Mississippi,2022,4,1258719,55.2,1211880,53.2,46839,3.7
Missouri,2022,4,3056746,62.7,2987676,61.3,69070,2.3
Montana,2022,4,567311,63.3,552665,61.7,14646,2.6
Nebraska,2022,4,1058812,69.8,1037469,68.4,21343,2.0
Nevada,2022,4,1538332,61.0,1457650,57.8,80682,5.2
New Hampshire,2022,4,765496,66.2,749090,64.8,16406,2.1
New Jersey,2022,4,4725353,63.7,4542322,61.3,183031,3.9
New Mexico,2022,4,950651,56.8,909503,54.3,41148,4.3
New York,2022,4,9625656,60.2,9216267,57.7,409389,4.3
New York city,2022,4,4099568,60.5,3858830,56.9,240738,5.9
North Carolina,2022,4,5160841,61.2,4988505,59.1,172336,3.3
North Dakota,2022,4,415075,69.4,406589,68.0,8486,2.0
Ohio,2022,4,5765906,61.8,5542612,59.4,223294,3.9
Oklahoma,2022,4,1887601,61.2,1834046,59.4,53555,2.8
Oregon,2022,4,2171623,62.7,2094370,60.5,77253,3.6
Pennsylvania,2022,4,6489022,61.9,6208504,59.2,280518,4.3
Rhode Island,2022,4,571812,63.6,554984,61.7,16828,2.9
South Carolina,2022,4,2380759,56.9,2305463,55.1,75296,3.2
South Dakota,2022,4,475518,68.6,466418,67.3,9100,1.9
Tennessee,2022,4,3384499,60.7,3273420,58.7,111079,3.3
Texas,2022,4,14642266,64.1,14083185,61.6,559081,3.8
Utah,2022,4,1737348,68.8,1699026,67.3,38322,2.2
Vermont,2022,4,341723,63.2,334166,61.8,7557,2.2
Virginia,2022,4,4427764,64.8,4310885,63.1,116879,2.6
Washington,2022,4,3976161,64.1,3821603,61.6,154558,3.9
West Virginia,2022,4,786667,54.8,757846,52.8,28821,3.7
Wisconsin,2022,4,3094462,65.4,3008302,63.6,86160,2.8
Wyoming,2022,4,290533,63.6,281196,61.6,9337,3.2
Alabama,2022,5,2291313,57.2,2233447,55.7,57866,2.5
Alaska,2022,5,357262,65.4,343223,62.8,14039,3.9
Arizona,2022,5,3608904,61.7,3476931,59.5,131973,3.7
Arkansas,2022,5,1370505,57.7,1326982,55.9,43523,3.2
California,2022,5,19249758,61.9,18489323,59.5,760435,4.0
Los Angeles County,2022,5,5002993,63.4,4768435,60.4,234558,4.7
Colorado,2022,5,3207626,68.6,3113493,66.6,94133,2.9
Connecticut,2022,5,1943371,66.0,1863559,63.3,79812,4.1
Delaware,2022,5,497820,60.8,476324,58.1,21496,4.3
District of Columbia,2022,5,390802,71.2,372745,67.9,18057,4.6
Florida,2022,5,10751810,59.5,10442444,57.8,309366,2.9
Georgia,2022,5,5242586,61.7,5088415,59.9,154171,2.9
Hawaii,2022,5,676621,60.2,653882,58.2,22739,3.4
Idaho,2022,5,950622,63.3,926507,61.7,24115,2.5
Illinois,2022,5,6485489,64.6,6199081,61.8,286408,4.4
Indiana,2022,5,3412280,63.8,3314617,61.9,97663,2.9
Iowa,2022,5,1718689,68.3,1677203,66.6,41486,2.4
Kansas,2022,5,1506531,66.5,1469550,64.9,36981,2.5
Kentucky,2022,5,2055139,58.1,1976078,55.8,79061,3.8
Louisiana,2022,5,2093536,58.8,2019232,56.7,74304,3.5
Maine,2022,5,676810,58.8,659108,57.3,17702,2.6
Maryland,2022,5,3174985,65.0,3075361,63.0,99624,3.1
Massachusetts,2022,5,3758999,65.4,3618734,63.0,140265,3.7
Michigan,2022,5,4847298,60.0,4655481,57.7,191817,4.0
Minnesota,2022,5,3076008,68.1,3003534,66.5,72474,2.4
Mississippi,2022,5,1256776,55.2,1210638,53.1,46138,3.7
Missouri,2022,5,3056569,62.7,2991122,61.3,65447,2.1
Montana,2022,5,568667,63.3,553650,61.7,15017,2.6
Nebraska,2022,5,1059733,69.8,1037349,68.4,22384,2.1
Nevada,2022,5,1547113,61.2,1466173,58.0,80940,5.2
New Hampshire,2022,5,767417,66.3,750354,64.8,17063,2.2
New Jersey,2022,5,4740508,63.9,4568268,61.6,172240,3.6
New Mexico,2022,5,949572,56.7,910671,54.4,38901,4.1
New York,2022,5,9633295,60.3,9234958,57.8,398337,4.1
New York city,2022,5,4100927,60.6,3874414,57.2,226513,5.5
North Carolina,2022,5,5167941,61.2,4990450,59.1,177491,3.4
North Dakota,2022,5,414834,69.4,406590,68.0,8244,2.0
Ohio,2022,5,5768443,61.8,5545779,59.4,222664,3.9
Oklahoma,2022,5,1888776,61.1,1834295,59.4,54481,2.9
Oregon,2022,5,2171706,62.7,2092070,60.4,79636,3.7
Pennsylvania,2022,5,6491428,61.9,6212506,59.2,278922,4.3
Rhode Island,2022,5,572701,63.7,555726,61.8,16975,3.0
South Carolina,2022,5,2381220,56.8,2306087,55.0,75133,3.2
South Dakota,2022,5,476052,68.6,466691,67.2,9361,2.0
Tennessee,2022,5,3381397,60.6,3271927,58.6,109470,3.2
Texas,2022,5,14670702,64.1,14115385,61.6,555317,3.8
Utah,2022,5,1741923,68.9,1702969,67.3,38954,2.2
Vermont,2022,5,342130,63.2,334547,61.8,7583,2.2
Virginia,2022,5,4428210,64.8,4315572,63.2,112638,2.5
Washington,2022,5,3982923,64.1,3827845,61.6,155078,3.9
West Virginia,2022,5,786778,54.8,757211,52.7,29567,3.8
Wisconsin,2022,5,3091575,65.3,3003347,63.4,88228,2.9
Wyoming,2022,5,291283,63.7,281802,61.6,9481,3.3
Alabama,2022,6,2291067,57.1,2232562,55.7,58505,2.6
Alaska,2022,6,357081,65.3,343312,62.8,13769,3.9
Arizona,2022,6,3617360,61.8,3481384,59.5,135976,3.8
Arkansas,2022,6,1370828,57.7,1326451,55.8,44377,3.2
California,2022,6,19255959,61.9,18512138,59.5,743821,3.9
Los Angeles County,2022,6,4990026,63.2,4765194,60.4,224832,4.5
Colorado,2022,6,3204080,68.5,3113910,66.6,90170,2.8
Connecticut,2022,6,1937025,65.8,1859072,63.1,77953,4.0
Delaware,2022,6,497283,60.6,475707,58.0,21576,4.3
District of Columbia,2022,6,391459,71.3,374370,68.1,17089,4.4
Florida,2022,6,10781980,59.5,10478903,57.9,303077,2.8
Georgia,2022,6,5241279,61.6,5085704,59.8,155575,3.0
Hawaii,2022,6,678633,60.4,655472,58.3,23161,3.4
Idaho,2022,6,952211,63.3,927342,61.6,24869,2.6
Illinois,2022,6,6477152,64.5,6192255,61.7,284897,4.4
Indiana,2022,6,3416553,63.8,3315777,61.9,100776,2.9
Iowa,2022,6,1719312,68.3,1675184,66.5,44128,2.6
Kansas,2022,6,1506629,66.5,1468208,64.8,38421,2.6
Kentucky,2022,6,2054100,58.0,1974100,55.8,80000,3.9
Louisiana,2022,6,2088396,58.7,2015425,56.6,72971,3.5
Maine,2022,6,675511,58.7,657830,57.1,17681,2.6
Maryland,2022,6,3175018,65.0,3073410,62.9,101608,3.2
Massachusetts,2022,6,3754800,65.3,3614737,62.9,140063,3.7
Michigan,2022,6,4847689,60.0,4653476,57.6,194213,4.0
Minnesota,2022,6,3080031,68.2,3005232,66.5,74799,2.4
Mississippi,2022,6,1254410,55.0,1208093,53.0,46317,3.7
Missouri,2022,6,3057595,62.7,2992413,61.3,65182,2.1
Montana,2022,6,569529,63.3,554171,61.6,15358,2.7
Nebraska,2022,6,1060126,69.8,1036297,68.2,23829,2.2
Nevada,2022,6,1555018,61.5,1473407,58.2,81611,5.2
New Hampshire,2022,6,768709,66.3,750556,64.8,18153,2.4
New Jersey,2022,6,4752862,64.1,4589644,61.9,163218,3.4
New Mexico,2022,6,947571,56.6,911008,54.4,36563,3.9
New York,2022,6,9634076,60.3,9243670,57.9,390406,4.1
New York city,2022,6,4099680,60.6,3885409,57.5,214271,5.2
North Carolina,2022,6,5172158,61.1,4986858,59.0,185300,3.6
North Dakota,2022,6,414422,69.3,406298,67.9,8124,2.0
Ohio,2022,6,5763974,61.7,5539753,59.3,224221,3.9
Oklahoma,2022,6,1888719,61.1,1832659,59.3,56060,3.0
Oregon,2022,6,2172493,62.7,2088565,60.3,83928,3.9
Pennsylvania,2022,6,6487238,61.9,6209889,59.2,277349,4.3
Rhode Island,2022,6,572947,63.7,555402,61.8,17545,3.1
South Carolina,2022,6,2379963,56.7,2304145,54.9,75818,3.2
South Dakota,2022,6,476270,68.5,466581,67.1,9689,2.0
Tennessee,2022,6,3372661,60.3,3263662,58.4,108999,3.2
Texas,2022,6,14685320,64.0,14131166,61.6,554154,3.8
Utah,2022,6,1745158,68.9,1705385,67.3,39773,2.3
Vermont,2022,6,342332,63.2,334385,61.7,7947,2.3
Virginia,2022,6,4427042,64.8,4315557,63.1,111485,2.5
Washington,2022,6,3989296,64.1,3831804,61.6,157492,3.9
West Virginia,2022,6,786407,54.8,755815,52.7,30592,3.9
Wisconsin,2022,6,3087381,65.2,2996415,63.2,90966,2.9
Wyoming,2022,6,291985,63.8,282155,61.7,9830,3.4
Alabama,2022,7,2289193,57.0,2229784,55.5,59409,2.6
Alaska,2022,7,356496,65.2,343071,62.7,13425,3.8
Arizona,2022,7,3624868,61.8,3484191,59.4,140677,3.9
Arkansas,2022,7,1370797,57.6,1325233,55.7,45564,3.3
California,2022,7,19238318,61.9,18506108,59.5,732210,3.8
Los Angeles County,2022,7,4967204,63.0,4752189,60.2,215015,4.3
Colorado,2022,7,3197903,68.3,3111015,66.4,86888,2.7
Connecticut,2022,7,1928717,65.4,1852511,62.9,76206,4.0
Delaware,2022,7,496549,60.4,474740,57.8,21809,4.4
District of Columbia,2022,7,391272,71.2,375093,68.2,16179,4.1
Florida,2022,7,10801332,59.5,10504464,57.9,296868,2.7
Georgia,2022,7,5238140,61.5,5080028,59.6,158112,3.0
Hawaii,2022,7,679768,60.5,656075,58.4,23693,3.5
Idaho,2022,7,953307,63.2,927563,61.5,25744,2.7
Illinois,2022,7,6467085,64.5,6180467,61.6,286618,4.4
Indiana,2022,7,3417189,63.8,3313069,61.8,104120,3.0
Iowa,2022,7,1718959,68.2,1671434,66.3,47525,2.8
Kansas,2022,7,1506089,66.4,1465760,64.6,40329,2.7
Kentucky,2022,7,2051409,57.9,1970465,55.7,80944,3.9
Louisiana,2022,7,2083058,58.5,2010677,56.5,72381,3.5
Maine,2022,7,673647,58.4,655640,56.9,18007,2.7
Maryland,2022,7,3172947,64.9,3070519,62.8,102428,3.2
Massachusetts,2022,7,3744688,65.1,3607550,62.7,137138,3.7
Michigan,2022,7,4844794,60.0,4645182,57.5,199612,4.1
Minnesota,2022,7,3083668,68.2,3004572,66.5,79096,2.6
Mississippi,2022,7,1250913,54.9,1203507,52.8,47406,3.8
Missouri,2022,7,3059073,62.7,2990537,61.3,68536,2.2
Montana,2022,7,569874,63.3,554322,61.5,15552,2.7
Nebraska,2022,7,1060069,69.8,1034555,68.1,25514,2.4
Nevada,2022,7,1562093,61.7,1479206,58.4,82887,5.3
New Hampshire,2022,7,769303,66.3,749773,64.7,19530,2.5
New Jersey,2022,7,4758983,64.1,4605705,62.1,153278,3.2
New Mexico,2022,7,944667,56.4,910507,54.3,34160,3.6
New York,2022,7,9621185,60.3,9240249,57.9,380936,4.0
New York city,2022,7,4089665,60.6,3889446,57.6,200219,4.9
North Carolina,2022,7,5172083,61.1,4978541,58.8,193542,3.7
North Dakota,2022,7,413948,69.1,405754,67.8,8194,2.0
Ohio,2022,7,5752223,61.6,5524392,59.2,227831,4.0
Oklahoma,2022,7,1888268,61.0,1830274,59.1,57994,3.1
Oregon,2022,7,2174031,62.7,2084751,60.2,89280,4.1
Pennsylvania,2022,7,6480352,61.8,6203029,59.1,277323,4.3
Rhode Island,2022,7,572107,63.6,553828,61.6,18279,3.2
South Carolina,2022,7,2377358,56.5,2300379,54.7,76979,3.2
South Dakota,2022,7,476011,68.3,465974,66.9,10037,2.1
Tennessee,2022,7,3358742,60.0,3248809,58.0,109933,3.3
Texas,2022,7,14686731,63.9,14134693,61.5,552038,3.8
Utah,2022,7,1747609,68.8,1706860,67.2,40749,2.3
Vermont,2022,7,342369,63.2,333742,61.6,8627,2.5
Virginia,2022,7,4428430,64.7,4313022,63.1,115408,2.6
Washington,2022,7,3994794,64.2,3831951,61.5,162843,4.1
West Virginia,2022,7,785694,54.7,754091,52.5,31603,4.0
Wisconsin,2022,7,3081980,65.0,2988446,63.0,93534,3.0
Wyoming,2022,7,292652,63.9,282321,61.6,10331,3.5
Alabama,2022,8,2286594,56.9,2226394,55.4,60200,2.6
Alaska,2022,8,355685,65.0,342753,62.7,12932,3.6
Arizona,2022,8,3631543,61.8,3486736,59.4,144807,4.0
Arkansas,2022,8,1370846,57.6,1324036,55.6,46810,3.4
California,2022,8,19212139,61.8,18488550,59.4,723589,3.8
Los Angeles County,2022,8,4941993,62.7,4736220,60.1,205773,4.2
Colorado,2022,8,3190633,68.1,3107150,66.3,83483,2.6
Connecticut,2022,8,1919853,65.1,1845609,62.6,74244,3.9
Delaware,2022,8,495780,60.2,473684,57.6,22096,4.5
District of Columbia,2022,8,390938,71.1,375521,68.3,15417,3.9
Florida,2022,8,10814521,59.5,10520867,57.9,293654,2.7
Georgia,2022,8,5234702,61.4,5073755,59.5,160947,3.1
Hawaii,2022,8,680168,60.5,655850,58.4,24318,3.6
Idaho,2022,8,954053,63.1,927590,61.4,26463,2.8
Illinois,2022,8,6457256,64.4,6167724,61.5,289532,4.5
Indiana,2022,8,3415553,63.7,3308714,61.7,106839,3.1
Iowa,2022,8,1718732,68.2,1668070,66.2,50662,2.9
Kansas,2022,8,1505498,66.4,1463230,64.5,42268,2.8
Kentucky,2022,8,2047587,57.8,1966123,55.5,81464,4.0
Louisiana,2022,8,2080426,58.5,2006959,56.4,73467,3.5
Maine,2022,8,671521,58.2,653200,56.6,18321,2.7
Maryland,2022,8,3173602,64.9,3067002,62.8,106600,3.4
Massachusetts,2022,8,3744533,65.1,3599484,62.6,145049,3.9
Michigan,2022,8,4840450,59.9,4634484,57.3,205966,4.3
Minnesota,2022,8,3086899,68.3,3002741,66.4,84158,2.7
Mississippi,2022,8,1247000,54.7,1198207,52.6,48793,3.9
Missouri,2022,8,3061587,62.7,2987457,61.2,74130,2.4
Montana,2022,8,569904,63.1,554355,61.4,15549,2.7
Nebraska,2022,8,1059848,69.7,1032810,67.9,27038,2.6
Nevada,2022,8,1569078,61.8,1484533,58.5,84545,5.4
New Hampshire,2022,8,769417,66.3,748561,64.5,20856,2.7
New Jersey,2022,8,4762369,64.2,4619344,62.2,143025,3.0
New Mexico,2022,8,941509,56.1,909818,54.2,31691,3.4
New York,2022,8,9599565,60.2,9229179,57.8,370386,3.9
New York city,2022,8,4074030,60.4,3888351,57.6,185679,4.6
North Carolina,2022,8,5169698,60.9,4969344,58.6,200354,3.9
North Dakota,2022,8,413674,69.1,405254,67.7,8420,2.0
Ohio,2022,8,5737556,61.4,5505051,58.9,232505,4.1
Oklahoma,2022,8,1888234,60.9,1828492,59.0,59742,3.2
Oregon,2022,8,2176306,62.8,2081765,60.1,94541,4.3
Pennsylvania,2022,8,6475811,61.7,6196637,59.1,279174,4.3
Rhode Island,2022,8,570735,63.4,551588,61.3,19147,3.4
South Carolina,2022,8,2374500,56.3,2296410,54.5,78090,3.3
South Dakota,2022,8,475538,68.1,465227,66.7,10311,2.2
Tennessee,2022,8,3343404,59.6,3231479,57.7,111925,3.3
Texas,2022,8,14679033,63.8,14133565,61.4,545468,3.7
Utah,2022,8,1749751,68.8,1708053,67.2,41698,2.4
Vermont,2022,8,342427,63.2,332995,61.4,9432,2.8
Virginia,2022,8,4434229,64.8,4311198,63.0,123031,2.8
Washington,2022,8,4000998,64.2,3830664,61.5,170334,4.3
West Virginia,2022,8,784920,54.7,752630,52.4,32290,4.1
Wisconsin,2022,8,3076435,64.8,2981530,62.8,94905,3.1
Wyoming,2022,8,293347,64.0,282507,61.6,10840,3.7
Alabama,2022,9,2284341,56.8,2223853,55.3,60488,2.6
Alaska,2022,9,355945,65.0,342618,62.6,13327,3.7
Arizona,2022,9,3637210,61.8,3490047,59.3,147163,4.0
Arkansas,2022,9,1371057,57.5,1323459,55.5,47598,3.5
California,2022,9,19240773,61.9,18471241,59.4,769532,4.0
Los Angeles County,2022,9,4942392,62.7,4721852,59.9,220540,4.5
Colorado,2022,9,3193207,68.1,3104869,66.2,88338,2.8
Connecticut,2022,9,1916141,65.0,1840211,62.4,75930,4.0
Delaware,2022,9,495533,60.1,472839,57.4,22694,4.6
District of Columbia,2022,9,388991,70.7,373095,67.8,15896,4.1
Florida,2022,9,10827234,59.4,10532788,57.8,294446,2.7
Georgia,2022,9,5232374,61.3,5069852,59.4,162522,3.1
Hawaii,2022,9,680020,60.5,655164,58.3,24856,3.7
Idaho,2022,9,954601,63.0,927810,61.3,26791,2.8
Illinois,2022,9,6455228,64.4,6158839,61.4,296389,4.6
Indiana,2022,9,3413060,63.6,3304890,61.6,108170,3.2
Iowa,2022,9,1718868,68.1,1666231,66.1,52637,3.1
Kansas,2022,9,1505261,66.3,1461583,64.4,43678,2.9
Kentucky,2022,9,2043711,57.7,1962380,55.4,81331,4.0
Louisiana,2022,9,2079544,58.5,2005684,56.4,73860,3.6
Maine,2022,9,671247,58.1,651296,56.4,19951,3.0
Maryland,2022,9,3166219,64.8,3064376,62.7,101843,3.2
Massachusetts,2022,9,3729695,64.8,3592850,62.4,136845,3.7
Michigan,2022,9,4836382,59.8,4626195,57.2,210187,4.3
Minnesota,2022,9,3085824,68.2,2997470,66.3,88354,2.9
Mississippi,2022,9,1243730,54.5,1193931,52.4,49799,4.0
Missouri,2022,9,3064250,62.7,2984563,61.1,79687,2.6
Montana,2022,9,569827,63.0,554449,61.3,15378,2.7
Nebraska,2022,9,1059779,69.6,1031709,67.8,28070,2.6
Nevada,2022,9,1568315,61.7,1482355,58.3,85960,5.5
New Hampshire,2022,9,769339,66.2,747523,64.3,21816,2.8
New Jersey,2022,9,4763708,64.2,4611149,62.1,152559,3.2
New Mexico,2022,9,942368,56.2,909647,54.2,32721,3.5
New York,2022,9,9605907,60.2,9217893,57.8,388014,4.0
New York city,2022,9,4086901,60.6,3885439,57.7,201462,4.9
North Carolina,2022,9,5165820,60.8,4963098,58.4,202722,3.9
North Dakota,2022,9,413700,69.0,405014,67.6,8686,2.1
Ohio,2022,9,5724932,61.3,5488897,58.7,236035,4.1
Oklahoma,2022,9,1888883,60.9,1828227,58.9,60656,3.2
Oregon,2022,9,2181291,62.9,2079968,60.0,101323,4.6
Pennsylvania,2022,9,6475764,61.7,6194769,59.0,280995,4.3
Rhode Island,2022,9,568765,63.2,549502,61.1,19263,3.4
South Carolina,2022,9,2372324,56.2,2293917,54.3,78407,3.3
South Dakota,2022,9,475036,67.9,464602,66.4,10434,2.2
Tennessee,2022,9,3330399,59.3,3216188,57.3,114211,3.4
Texas,2022,9,14696194,63.7,14135365,61.3,560829,3.8
Utah,2022,9,1751907,68.8,1709509,67.1,42398,2.4
Vermont,2022,9,342661,63.2,332538,61.3,10123,3.0
Virginia,2022,9,4445177,64.9,4312867,63.0,132310,3.0
Washington,2022,9,4007520,64.2,3829822,61.4,177698,4.4
West Virginia,2022,9,784352,54.7,751923,52.4,32429,4.1
Wisconsin,2022,9,3071775,64.7,2977169,62.7,94606,3.1
Wyoming,2022,9,293412,63.9,282184,61.5,11228,3.8
Alabama,2022,10,2283211,56.8,2222768,55.2,60443,2.6
Alaska,2022,10,356176,65.1,342725,62.6,13451,3.8
Arizona,2022,10,3641254,61.8,3493494,59.3,147760,4.1
Arkansas,2022,10,1371549,57.5,1323587,55.5,47962,3.5
California,2022,10,19274330,62.0,18475849,59.4,798481,4.1
Los Angeles County,2022,10,4947936,62.8,4717681,59.9,230255,4.7
Colorado,2022,10,3195674,68.1,3104939,66.1,90735,2.8
Connecticut,2022,10,1913816,64.9,1837039,62.3,76777,4.0
Delaware,2022,10,495393,60.0,472299,57.2,23094,4.7
District of Columbia,2022,10,387812,70.4,371532,67.4,16280,4.2
Florida,2022,10,10840406,59.4,10543091,57.7,297315,2.7
Georgia,2022,10,5232570,61.2,5069721,59.3,162849,3.1
Hawaii,2022,10,679952,60.5,654688,58.3,25264,3.7
Idaho,2022,10,954969,62.9,928189,61.2,26780,2.8
Illinois,2022,10,6456564,64.4,6156524,61.4,300040,4.6
Indiana,2022,10,3410756,63.5,3302300,61.5,108456,3.2
Iowa,2022,10,1719735,68.1,1666336,66.0,53399,3.1
Kansas,2022,10,1505448,66.3,1461036,64.3,44412,3.0
Kentucky,2022,10,2040464,57.5,1959677,55.3,80787,4.0
Louisiana,2022,10,2081232,58.5,2006364,56.4,74868,3.6
Maine,2022,10,671215,58.0,650306,56.2,20909,3.1
Maryland,2022,10,3167557,64.8,3064659,62.7,102898,3.2
Massachusetts,2022,10,3729779,64.8,3588553,62.3,141226,3.8
Michigan,2022,10,4833672,59.8,4621946,57.1,211726,4.4
Minnesota,2022,10,3085467,68.2,2994204,66.1,91263,3.0
Mississippi,2022,10,1241648,54.4,1191311,52.2,50337,4.1
Missouri,2022,10,3067829,62.7,2984679,61.0,83150,2.7
Montana,2022,10,569696,62.9,554505,61.2,15191,2.7
Nebraska,2022,10,1059890,69.6,1031311,67.7,28579,2.7
Nevada,2022,10,1568077,61.6,1481151,58.2,86926,5.5
New Hampshire,2022,10,769275,66.1,746924,64.2,22351,2.9
New Jersey,2022,10,4764810,64.1,4606149,62.0,158661,3.3
New Mexico,2022,10,943372,56.2,910165,54.2,33207,3.5
New York,2022,10,9612141,60.3,9213145,57.8,398996,4.2
New York city,2022,10,4097792,60.9,3885847,57.7,211945,5.2
North Carolina,2022,10,5162674,60.7,4960151,58.3,202523,3.9
North Dakota,2022,10,413980,69.0,405102,67.6,8878,2.1
Ohio,2022,10,5717761,61.2,5480261,58.6,237500,4.2
Oklahoma,2022,10,1889725,60.9,1829044,58.9,60681,3.2
Oregon,2022,10,2184456,63.0,2078934,59.9,105522,4.8
Pennsylvania,2022,10,6478553,61.7,6196359,59.0,282194,4.4
Rhode Island,2022,10,567243,63.0,548066,60.9,19177,3.4
South Carolina,2022,10,2371183,56.0,2293109,54.2,78074,3.3
South Dakota,2022,10,474966,67.8,464508,66.3,10458,2.2
Tennessee,2022,10,3321574,59.1,3205596,57.0,115978,3.5
Texas,2022,10,14708526,63.7,14140748,61.2,567778,3.9
Utah,2022,10,1753811,68.7,1710992,67.0,42819,2.4
Vermont,2022,10,343054,63.2,332526,61.3,10528,3.1
Virginia,2022,10,4457720,65.0,4317964,63.0,139756,3.1
Washington,2022,10,4014624,64.3,3831541,61.4,183083,4.6
West Virginia,2022,10,784125,54.6,751868,52.4,32257,4.1
Wisconsin,2022,10,3068518,64.6,2975060,62.6,93458,3.0
Wyoming,2022,10,293528,63.9,282076,61.4,11452,3.9
Alabama,2022,11,2283339,56.7,2223170,55.2,60169,2.6
Alaska,2022,11,356294,65.1,342950,62.6,13344,3.7
Arizona,2022,11,3641219,61.7,3494496,59.2,146723,4.0
Arkansas,2022,11,1372224,57.4,1324548,55.4,47676,3.5
California,2022,11,19282095,62.0,18484393,59.4,797702,4.1
Los Angeles County,2022,11,4951228,62.9,4720653,59.9,230575,4.7
Colorado,2022,11,3197064,68.0,3106973,66.1,90091,2.8
Connecticut,2022,11,1913666,64.8,1837109,62.2,76557,4.0
Delaware,2022,11,495372,59.9,472262,57.1,23110,4.7
District of Columbia,2022,11,387879,70.3,371498,67.4,16381,4.2
Florida,2022,11,10840492,59.3,10546434,57.6,294058,2.7
Georgia,2022,11,5233554,61.1,5071494,59.2,162060,3.1
Hawaii,2022,11,679811,60.5,654524,58.2,25287,3.7
Idaho,2022,11,954855,62.8,928316,61.0,26539,2.8
Illinois,2022,11,6462501,64.5,6163614,61.5,298887,4.6
Indiana,2022,11,3409841,63.5,3301949,61.5,107892,3.2
Iowa,2022,11,1721092,68.2,1668241,66.1,52851,3.1
Kansas,2022,11,1505608,66.3,1461421,64.3,44187,2.9
Kentucky,2022,11,2039487,57.5,1959234,55.2,80253,3.9
Louisiana,2022,11,2082792,58.6,2008332,56.5,74460,3.6
Maine,2022,11,671490,58.0,650690,56.2,20800,3.1
Maryland,2022,11,3165445,64.7,3066213,62.7,99232,3.1
Massachusetts,2022,11,3727848,64.8,3588270,62.3,139578,3.7
Michigan,2022,11,4832878,59.7,4622468,57.1,210410,4.4
Minnesota,2022,11,3085509,68.1,2994030,66.1,91479,3.0
Mississippi,2022,11,1241659,54.4,1191357,52.2,50302,4.1
Missouri,2022,11,3068371,62.7,2985368,61.0,83003,2.7
Montana,2022,11,569563,62.8,554467,61.1,15096,2.7
Nebraska,2022,11,1059937,69.6,1031527,67.7,28410,2.7
Nevada,2022,11,1568117,61.5,1481255,58.1,86862,5.5
New Hampshire,2022,11,769184,66.1,746940,64.2,22244,2.9
New Jersey,2022,11,4764624,64.1,4605955,62.0,158669,3.3
New Mexico,2022,11,944194,56.2,911172,54.2,33022,3.5
New York,2022,11,9618640,60.3,9220195,57.8,398445,4.1
New York city,2022,11,4105656,61.0,3893473,57.9,212183,5.2
North Carolina,2022,11,5160546,60.5,4960690,58.2,199856,3.9
North Dakota,2022,11,414337,69.1,405440,67.6,8897,2.1
Ohio,2022,11,5718061,61.2,5481278,58.6,236783,4.1
Oklahoma,2022,11,1889935,60.8,1829886,58.9,60049,3.2
Oregon,2022,11,2184318,63.0,2079019,59.9,105299,4.8
Pennsylvania,2022,11,6480356,61.7,6198240,59.1,282116,4.4
Rhode Island,2022,11,566518,62.9,547889,60.9,18629,3.3
South Carolina,2022,11,2371107,55.9,2293650,54.1,77457,3.3
South Dakota,2022,11,475026,67.7,464634,66.2,10392,2.2
Tennessee,2022,11,3320504,59.0,3204445,56.9,116059,3.5
Texas,2022,11,14708011,63.5,14143418,61.1,564593,3.8
Utah,2022,11,1754094,68.6,1711360,66.9,42734,2.4
Vermont,2022,11,343549,63.3,333046,61.4,10503,3.1
Virginia,2022,11,4465650,65.1,4324760,63.1,140890,3.2
Washington,2022,11,4016453,64.3,3832817,61.3,183636,4.6
West Virginia,2022,11,784180,54.6,752180,52.4,32000,4.1
Wisconsin,2022,11,3067945,64.6,2975583,62.6,92362,3.0
Wyoming,2022,11,293573,63.9,282151,61.4,11422,3.9
Alabama,2022,12,2283890,56.7,2223904,55.2,59986,2.6
Alaska,2022,12,356433,65.1,343184,62.7,13249,3.7
Arizona,2022,12,3640559,61.6,3494698,59.1,145861,4.0
Arkansas,2022,12,1373033,57.4,1325681,55.4,47352,3.4
California,2022,12,19272358,61.9,18482096,59.4,790262,4.1
Los Angeles County,2022,12,4949290,62.9,4720794,60.0,228496,4.6
Colorado,2022,12,3198338,68.0,3109208,66.1,89130,2.8
Connecticut,2022,12,1914328,64.8,1838121,62.2,76207,4.0
Delaware,2022,12,495435,59.8,472405,57.0,23030,4.6
District of Columbia,2022,12,388214,70.4,371865,67.4,16349,4.2
Florida,2022,12,10839794,59.1,10548993,57.5,290801,2.7
Georgia,2022,12,5233716,61.0,5072255,59.1,161461,3.1
Hawaii,2022,12,679695,60.5,654504,58.2,25191,3.7
Idaho,2022,12,954796,62.7,928419,60.9,26377,2.8
Illinois,2022,12,6469544,64.5,6172284,61.6,297260,4.6
Indiana,2022,12,3410069,63.4,3302670,61.4,107399,3.1
Iowa,2022,12,1722709,68.2,1670360,66.1,52349,3.0
Kansas,2022,12,1505800,66.3,1461932,64.3,43868,2.9
Kentucky,2022,12,2039859,57.5,1959793,55.2,80066,3.9
Louisiana,2022,12,2083547,58.6,2010011,56.5,73536,3.5
Maine,2022,12,671868,58.0,651351,56.2,20517,3.1
Maryland,2022,12,3161834,64.6,3065836,62.7,95998,3.0
Massachusetts,2022,12,3726395,64.7,3589568,62.3,136827,3.7
Michigan,2022,12,4833347,59.7,4624276,57.2,209071,4.3
Minnesota,2022,12,3085863,68.1,2994939,66.1,90924,2.9
Mississippi,2022,12,1242067,54.4,1191961,52.2,50106,4.0
Missouri,2022,12,3067527,62.7,2985562,61.0,81965,2.7
Montana,2022,12,569549,62.6,554476,61.0,15073,2.6
Nebraska,2022,12,1060024,69.5,1031843,67.7,28181,2.7
Nevada,2022,12,1568319,61.5,1481776,58.1,86543,5.5
New Hampshire,2022,12,769222,66.0,747186,64.1,22036,2.9
New Jersey,2022,12,4764691,64.1,4607487,62.0,157204,3.3
New Mexico,2022,12,944992,56.2,912207,54.3,32785,3.5
New York,2022,12,9626379,60.4,9230918,57.9,395461,4.1
New York city,2022,12,4112579,61.2,3902643,58.1,209936,5.1
North Carolina,2022,12,5160268,60.5,4962225,58.1,198043,3.8
North Dakota,2022,12,414630,69.1,405780,67.6,8850,2.1
Ohio,2022,12,5720233,61.2,5484487,58.6,235746,4.1
Oklahoma,2022,12,1890029,60.7,1830370,58.8,59659,3.2
Oregon,2022,12,2183610,62.9,2079467,59.9,104143,4.8
Pennsylvania,2022,12,6481162,61.7,6199715,59.1,281447,4.3
Rhode Island,2022,12,566352,62.9,548195,60.9,18157,3.2
South Carolina,2022,12,2371550,55.8,2294391,54.0,77159,3.3
South Dakota,2022,12,475056,67.6,464710,66.1,10346,2.2
Tennessee,2022,12,3322094,58.9,3206501,56.9,115593,3.5
Texas,2022,12,14706480,63.4,14145551,61.0,560929,3.8
Utah,2022,12,1753994,68.5,1711427,66.8,42567,2.4
Vermont,2022,12,343969,63.4,333591,61.5,10378,3.0
Virginia,2022,12,4470272,65.1,4330531,63.1,139741,3.1
Washington,2022,12,4015286,64.2,3832769,61.3,182517,4.5
West Virginia,2022,12,784323,54.7,752464,52.4,31859,4.1
Wisconsin,2022,12,3068610,64.6,2976670,62.6,91940,3.0
Wyoming,2022,12,293595,63.8,282247,61.3,11348,3.9
